Thành phố	市町村
Fray	弗赖
Thuê	僦
Những con gà	雞
vanadium	釩
chất rắn	固体
Renault	雷诺
cảm thấy	覺
tốt	嫽
nhìn thoáng qua	睒
Titan	泰坦
Tấn	浔
Shui	涫
Ba màu	三色
bánh mỳ	面包
kỷ	世紀
Bis	比斯
phần phía sau	豢
cua	蟹
quân đoàn	兵团
xuất hiện	出現
Sihe	四合
Lỗi	断层
Nên	應該
Yao	瑤
Cuba	古巴
đào sâu	加深
Tham dự	参赛
Afghanistan	阿富汗
Li	椬
phi	丟
đa phương tiện	多媒体
thực tế	實際
Thung lũng	溪谷
Manchukuo	滿洲國
khác thường	異常
lừa dối	朦
túi	兜
Sông Ấn	印度河
mười	十
Trung Hoa Dân quốc sớm	民初
Lưỡi liềm	銍
Xuất hiện ban đầu	原貌
Ma Kết	羯
Adelaide	阿德莱德
Vương triều Habsburg	哈布斯堡王朝
Miles	哩
Mặt bích	法兰
nỏ	弩
Miếng	枚
nói	讲
Thành phố bị cấm	故宮
Điểm cao	高點
Vài	为数不多
Học viện khoa học	科學院
Thanh tra	督察
Phát triển quốc gia	國開
Yoshito	義與
giao diện	界面
ma thuật	魔法
Kinh kịch Quảng Đông	粵劇
Mọi người	人们
con cú	鸺
vận chuyển nhẹ	輶
thị trấn	城镇
Dạy	敎
cồng	鑼
Sẽ	就會
Shao	枹
Khuyến khích	励
đứa trẻ	小孩子
phong cảnh	風景
chính quyền	政府
phong cảnh	风景
Kun	锟
Trong cốc	杯中
lượng mưa	雨量
Katakana	片假名
gây chết người	致死
Qi	屧
lịch	曆
biểu bì	表皮
Giáo viên	師長
Trong đôi mắt	眼中
Nit	尼特
Hee	煕
Đảo và	島及
cũ	旧
quá	过于
Đại học	本科
Fleur	夫勒
Trẻ	年幼
Cá xuyên tâm	輻鰭魚綱
Trung Quốc	中國
Viết	撰文
Yên tĩnh	硨
cá ngừ	鮪
Clan	族
Quận He	河县
Cá non	幼魚
Hợp lý	逻辑
Khu vực phía Tây	西域
gánh nặng	負擔
Bọng đái	賔
Đính kèm	附
mộc qua	桲
cơ bắp	肌
gãy xương	骨折
Bác sĩ	大夫
Vòng đầu tiên	首輪
Âm	虦
Ngốc nghếch	臈
Chengdu	成都
Thống nhất	合一
nhân nhượng	安撫
Với Wu	與吳
Thành phố bị cấm	紫禁城
Người chơi	球員
Chia sẻ	股份
đình công	罢工
Giải quyết	求解
Thuế	税
Chế độ nô lệ	奴役
giảm bớt	還原
Vứt bỏ	處置
bể bơi	水池
chuyên gia tư vấn	顧問
Địa điểm	处
Trong không khí	空中
Khu vực vịnh	灣區
Thiêu	焚烧
gớm ghiếc	猙
Đối với người Anh	為英
Su	夙
Fenghua	奉化
Ye	晿
đất đai	陆地
Câu lạc bộ ngựa	馬會
điều khiển	统制
City God Temple	城隍庙
nấm	蘑菇
giờ	小时
Thiên nhiên	天性
Sa thải	裁者
Đứa trẻ	小子
mặt trời	蓀
Đến	要將
Rong	嶸
Shiba	芝
Điều	事情
đồi núi	希爾
nhấn	按察使
Americium	镅
thật	確實
Không vui	怤
trái cam	橘子
vua rồng	龙王
Ford	福德
Hubble	哈伯
em gái	姊姊
đừng	別
Tongan	同安
Jin	衿
Wa	漥
chi phí	支出
hiện hành	當前
khoa học	科學
Giờ sinh	生时
sinh đôi	双胞胎
Cây kê	黍
Đúng	右侧
Hoàng đế La mã	罗马皇帝
dạy	传授
bệnh sốt rét	瘧
Qi	騏
viết	书写
có thể	五月
Thường được sử dụng	常用
trường học	學校
Bướng bỉnh	碸
cho đến khi	直到
Quyền lực	次方
Tát	肈
Tốt nghiệp từ	畢業於
khảo cổ học	考古学
Nâng cao	進發
Borg	博格
Liuyang	浏阳
Quận là	區為
Hua Dan	花旦
Hu	睺
sân cỏ	音高
Yi	佾
Gió nhiệt đới	熱帶風
Quận Giang	江县
giải trí	暇
lực lượng	强行
Bắc Băng Dương	北冰洋
Con số	號則
Bị kích thích	兴奋
toán học	数学
Bài giảng	布道
Quốc gia	國第
Tê liệt	痪
bộ lọc	过滤
tốt	佳
trong	于
Daohui	道會
toàn bộ	合计
Thổi	吹襲
xoáy	渦
Hoa serrano	花鮨
đi bộ	行走
Theo giai đoạn	上演
cây sồi	栎
Lo Wu	羅湖
mê cung	迷宮
Giang Tô	江蘇
Bộ điều khiển	控制器
Và xinh đẹp	與美
Phenyl	苯基
Tình dục và	性與
xe lăn	輪椅
Bất khả chiến bại	无敌
Đối với Châu Âu	為歐
khuôn mặt	臉
Chi tiết	詳情
Ming	漺
bàn luận	讨
Vạch phổ	譜線
Xi	浃
Duyên dáng	媚
Yate	亚特
Nhà giáo dục	教育家
Liền kề	毗鄰
rên rỉ đau đớn	痌
Tainan	台南
Âm	繦
Wei	崳
Chính phủ quân sự	軍政府
Ứng dụng	申請
Chengyu	成渝
tiếp xúc	聯繫
Tần	靲
Daniel	丹尼爾
ướt	湿
Xác suất	機率
gali	鎵
độ cao	標高
từ điển	词典
khu vực	面積
đãi	對待
rượu	釀
Bỏ lỡ	无缘
Phía trong	館內
cánh diều	鸢
về nhì	亚军
xung quanh	圍繞
tên thật	真名
Cành cây	茻
Sioux	蘇省
Phiên họp	屆
Liu Biao	劉表
tổ chức	主辦
chuyên gia	專家
Sư đoàn	個師
Kazakhstan	哈萨克斯坦
Người giữ	持有人
Akane	蒨
Khấu trừ	演绎
Dwight	德怀
Ảnh hưởng	影響力
Xiao	蓭
đất đá	磽
khóa	鎖定
Điều khiển	行車
Trung Quốc ở nước ngoài	華僑
Zhao	釗
Jining	济宁
bỏ tù	下獄
từ ngữ	話
thức ăn nhanh	快餐
Tang Yingnian	唐英年
đơn giản	简单
Động kinh	癲
đại sảnh	大廳
Bán kết	準決賽
Hảo	颢
Tấn công bằng phi cơ	空袭
Tỉnh Liêu Ninh	辽宁省
Thẳng thừng	直言
trơn tru	暢
Gai cứng của vây lưng	背鰭硬棘
Nader	納德
Thị trấn Vịnh	湾镇
Đây	蒞
trận chiến	堞
Hàng ngàn	上万
một cách tạm thời	暫
tay trống	鼓手
Bao che	占地
Sân chơi	娛樂場
ứng dụng	敷
Thay thế	取而代
bạc	白银
Florida	佛州
Gậy hockey	曲棍
Phòng ban	部门
Đàn bà	媦
Tuân thủ	遵从
lái xe	驱
đánh	擊
hiệp ước	条约
Phòng kỹ thuật	工程局
Tòa nhà mới	新馆
đến	来到
Mai táng	下葬
Trung tướng	中將
Chu State	楚國
đô thị	大都会
Khuyến khích	提升
ngôi đền	庙宇
nỗi sợ	惧
Của hai	的兩
Chung kết cúp	盃決賽
Calcutta	加尔各答
thanh lịch	優雅
Diễn viên đóng thế	女配角
túi treo từ thắt lưng	褳
Giọng nói của	之音
đầu hàng	投降
Yi	泿
Conscript	徵召
Hobbit	哈比人
trơn tru	平稳
Barcelo	巴塞罗
Khai mạc	开幕
người Tây Ban Nha	西班牙语
xôn xao	蟠
Chiến tranh	战乱
Ý nghĩa	含意
Nhà máy sắt	铁厂
Shan	硜
Thủ tướng	总理
nhớ bạn	想
Seattle	西雅图
làm	辦
Nấu ăn	庫克
Mát mẻ	爽
Con gái	女童
Gửi	發時
săn bắt	揵
Ôn Công	文公
Tài liệu	文档
Chỉ huy	统领
Hãy xem	看看
Wow	嘩
trước	之前
kết thúc	结局
Zhang Ge	張個
Tình dục	發性
giáo viên	教师
Lo	囖
Ở Trung Quốc	中國內
Rắn độc	蝮
cái	棋子
một mình	獨自
Đá phạt	点球
mô phỏng	模拟
Tiêu điểm	專注
xẻng	剷
Xi	郗
Kết án	判处
Cuộn	辊
Lên	暸
ẩn giấu	隱藏
Vượt qua	通牒
Trung thành	教友
Gongsun	公孙
Enhe	恩河
Phì nhiêu	肥沃
Brunei	汶萊
Khó xử	踔
Armenia	亞美尼亞
Tỉnh Lô	洛特省
Có thể	能將
Nelson	納爾遜
giàu có	富
Sự công bình	义上
Yu	聿
Hộ khẩu thường trú	常住
Gan	灨
dán	貼
Ốc sên	蜗
bộ lọc	篩選
sự hoang mang	混乱
Hydrazone	腙
Thượng hải	上海市
Và	並對
khởi động	啟動
Fermi	费米
Det	底特
Thêm vào	添加
Võ thuật	武功
Juan	襈
Kiểm tra thị trấn	乡试
Tang	腲
chất nhờn	漦
chất rắn	固
Mùa giải đầu tiên	首季
thay đổi	改變
Yong	顒
Tấn	荙
Cổng vòm	牌坊
Xiulian	秀蓮
Lei	的黎
Khi nào	時是
xuất sắc	矔
Đấu tranh giai cấp	阶级斗争
Quy định	條例
Yun	鋶
Quốc gia	各國
Kitakyushu	北九州
Những người khác	别人
Kẻ xâm nhập	入侵者
Mali	馬里
Pennsylvania	宾夕法尼亚州
kết thúc	末尾
Vương miện vua	冠王
Huaxi	华西
May thay	倖
Nâng cao	筹
Khởi đầu	起始
hành động	行徑
đường huyết	血糖
Bồ nông	鹈
Làng	该村
Cục	侷
Ru	汝
tốc độ	速
theo dõi	追踪
Sự cố	伊斯
Giá trị	器重
Công ty trách nhiệm hữu hạn	有限公司
dậy thì	青春期
thú y	獸醫
Hành động	行事
phẫu thuật	外科
Vịnh Nam	南灣
Giám đốc	司长
Khoa học	理学
Debon	德邦
may	緄
Bo	簙
Zhe	躧
phúc lợi	福利
chỉ huy	指揮官
giới hạn	限度
Ci	蛓
Phá dỡ	拆迁
Thánh	的聖
Bún	礶
cú hat trick	帽子戲法
thêm vào	加成
Senna	塞纳
pít tông	活塞
ngân hàng phía đông	东岸
Si	泗
Đó	那里
Phố cổ	古镇
Mở	旷
rượu lu	醁
Kẻ thách thức	挑戰者
Jiuzhi	久之
đủ	够
môn Địa lý	地理
Tiểu hành tinh	小行星
tuyên bố	陈述
Bỏ trống	空置
Áo choàng	袈
rút lui	撤走
halogen	卤
Spitfire	喷火
nhiều hơn hoặc ít hơn	或多或少
Lên	高達
lưu trữ	存儲
Nga	俄羅
Knots	節度
Thần Châu	神州
Có thể gọi là	堪稱
Trở thành	变为
theo	跟從
Cọ rửa	淘
Đóng quân	駐紮
Hạt Miaoli	苗栗縣
vụ đánh bom	爆炸案
thành viên	构件
Trung tâm quốc gia	國立中央
chắc chắn	坚定
Sway	撟
Nhiệm vụ đặc biệt	特命
Chó rừng	豺
Đúng	對當
chiều rộng	寬
Ren	仛
Ella	埃拉
Kho lưu trữ	档案馆
Wai	喎
Cái đầu	團長
Daan	大安
đưa vào một	放入
Jiao	滘
tình hình	情
căng thẳng	張力
Riêng biệt	相距
chứng cớ	證據
Theo dõi	轨迹
vồ lấy	搶
Viết	行文
Sâu răng	龋
lựa chọn	擇
Wu	邬
ma thuật	魔術
tương thích	兼容
con hổ	虎
Mọi người	民
A.D.	公元
rượu	酒精
người cầu nguyện	禱
Án Lệnh	政令
công viên	停放
giao hưởng	交響曲
con quạ	乌鸦
giai cấp vô sản	无产阶级
Ta	澾
Harry	哈利
Hinterland	腹地
Nhiệt động lực học	热力学
gió lốc	猋
mangan	锰
Xây dựng vốn	建都
Yue	玥
tấm màn	帘
Chuẩn bị	預科
nói chung	大體
Gan tiếng Trung	贛語
Bayeux	巴约
ngôi sao	恆星
Cử đi	出動
đồn trú	守備
sửa	修復
hình chiếu	投射
Đi ra ngoài	出外
boong tàu	甲板
tấn công	攻
Và nhận ra	並認
vượt quá	躐
Chuyển tới	移到
đổ vỏ	棚
cẩn thận	仔細
Bo	渤
Thô	麤
bàn luận	讨论
ở lại	騃
hái	挑
mờ dần	淡出
Tài khoản	賬
Mở	開來
viết	編寫
Đổi lấy	擔當
Thành Cát Tư Hãn	成吉思汗
dao động	振荡
tà ác	惡
Hình dạng bên	边形
Giang Châu	江州
hang	洞穴
Tốt nghiệp	結業
bổ đề	引理
Lào	嶗
Cứu giúp	佑
Đảng dân chủ	民黨
Tỉnh Du	杜省
tỷ lệ phiếu bầu	投票率
Angular	角形
Zhang	餦
Bắt đầu	開賽
Qi	鐪
định lượng	的數量
Tranh luận	论证
cesium	铯
Theo sắc lệnh	下诏
Bom nguyên tử	原子弹
Chia	整除
người lái xe	司机
thịt	肉體
văn Phong	票房
thích nghi	容納
Auckland	奧克蘭
Bị đánh bại	戰敗
nén	壓縮
Ling	玲
kiêu ngạo	訑
Mét	仪表
Quả cầu	球體
Dây sắt	鐵線
Đi	出站
Thường xanh	長榮
Luật mới	新法
sự ô nhiễm	污染
nhà cung cấp	供应商
đồ gốm	陶
Zheng Yuee	鄭月娥
Diễn viên	伶
Họ hàng bên trong	內親
Tăng cường	加剧
Sách	本书
Tu	屠
Hải quân	海军
Hoàn thành công việc	全集
Chỉnh sửa	整顿
luận tội	弹劾
Yu	彧
Vòng xoáy	鲪
Bảng nhỏ	小板
số sê-ri	编号
chất béo trong ruột	膋
lựa chọn	择
bằng cấp	文凭
Jersey	澤西
nhìn yêu cầu	睨
Tỉnh	地级
Họ đào	桃科
Thành phần	配料
Quân nổi dậy	起义军
con ếch	蛙
Bạn bè	巴迪
Ste	施特
cái nhíp	鑷
vu khống	謷
giai đoạn = Stage	时期
nhiệt	暑
Yan	兖
một lần nữa	再度
đo lường	測量
xác nhận	确认
Ngôi sao chính	主星
Xie	禼
cổ xưa	古
Phòng thương mại	商会
Tiết kiệm	储蓄
Bài hát phương nam	南宋
thăng trầm	热潮
hộp cung	韣
Du lịch	巡演
người Trung Quốc	華人
Di	棌
túi	囊
Tốc độ	時速
chủ ngân hàng	银行家
Fen	摉
học giả	学者
Sản xuất tại	作在
Lên ngôi	登基
Lòng tin	信托
Khai mạc	开馆
Bị đánh bại bởi	敗於
Bailey	贝利
Xuanhua	宣化
Bán hàng	銷量
Sẽ xuất hiện	會出現
màn	銀幕
rut	轍
Taikang	太康
Pell	佩爾
Tầm quan trọng	量级
đồng hành	伴星
kháng cáo	上訴
Phủ Điền	莆田
Gloucester	告士打
Netizen	网友
Trú ngụ	栖息于
Chile	智利
Weng	翁
Cử nhân	大学士
nạn đói	飢餓
Đã không	並未
Xuan Wang	宣王
xa hoa	奢
Vượt qua	軼
máy móc	机器
Cai trị	裁定
sân bóng đá	足球場
Wanhua	萬華
dài hạn	常任
Xấu	糟
Được làm bởi	所製
Sự khỏe khoắn	健身
Bật mí	揭幕
đa dạng hóa	多样化
Ariège	阿列日省
Chen	陳
Tương lai	未來
Thở khò khè	哮
Dani	達尼
Gây hiểu lầm	誤導
Tình cờ gặp	蹕
đánh	揕
Xưng	坦承
Luân	滦
sách giáo khoa	教科书
Họ và tên	全稱
ngọn lửa	煚
Sophie	索菲
Gangwon	江原
Dian	丶
Gì	麽
Có khả năng	才能
Ning Yuan	宁远
Với	是與
Nhìn qua	眺望
Bệnh	氏症
chất lượng	质量
rụng răng sữa	齠
Cá chép răng gang	綱鯉齒
Chung	總領
Ưu tú	精銳
tích lũy	积累
Sân chơi	遊樂場
linh hồn	醑
Bỏ tù	監禁
Cộng hòa Dominica	多明尼加
Khó xử	拃
Mặt cầu	桥面
Hướng dẫn viên du lịch	导员
Đưa cho	賦予
Swa	斯沃
chuyến thăm	拜訪
Xem xét	谂
Bướng bỉnh	熘
Những năm gần đây	近年来
Tấm bia	石碑
Woo	呜
Có thể kết hợp với	可與
Sẽ chuyển	會轉
Kết thúc	逾
Hơn	多可
Nhà Hán	漢代
Đóng	辺
Maddie	麦迪
Lê và	樂與
Nhậm chức	出任
hiện có	现有
Bao gồm	纳入
Bảo vệ	安保
Occlude	闭塞
Nguyên	本物
Ga xe lửa Tây Bắc Kinh	北京西站
Phần phía bắc	北段
xinh đẹp	秀丽
Háng	砯
Xi	郖
đường phố	大街
Oss	俄斯
dọn dẹp	清洁
Và tạo	並創
Sonata	奏曲
Thủ tướng	宰相
bánh xe	车轮
Dài	兞
Vội vàng	涏
màu sắc	綵
Sôi lên	癘
Dajiaxi	大甲溪
cốt lõi	核心
cuối cùng	终于
Lưu huỳnh	磺
Nghề nghiệp	职业
Diễn viên điện ảnh	電影演員
Jiaodong	胶东
nền tảng	地基
Wang	仼
khung	框架
Hittite	赫梯
Ngoài cốc	盃外
Lương Sơn	梁山
hafnium	铪
Phụ lục	吞併
Hành dương	衡阳
Thần sấm	托尔
George	乔治
Học cao hơn	進修
Phát sinh	导数
Inch	寸
Abu	阿布
một chút	一點
rác	垃
bắt giữ	拘捕
về cơ bản	基础上
Ba nghìn	三千
Khu vực thực địa	田區
Hoàng đế	皇上
khoe khoang	炫耀
Tianjia	田家
đấu tay đôi	決鬥
xây dựng	建
Thành phố đặc biệt	特市
Lồn	儱
nhà hàng	饭店
Lập trường	表態
Ke	珂
Chiên	弗萊
đứa trẻ	孩子
câu lạc bộ đêm	夜總會
điêu khắc	雕塑
Calvados	卡尔瓦多斯省
Chìa khóa	钥匙
Nhân Viên	员工
bầu cử dân chủ	民選
Có thể làm việc với	能與
Được	而獲
từ	自
chú ý	關注
Đại học Thanh Hoa	清华
Giờ sinh	生時
Đề cập nhỏ	小提
Chết	圆寂
Cảnh báo	預警
Xa lánh	阓
Jia	賈
Zao	簉
sự hiểu biết	掫
tinh ranh	陧
cải cách	維新
Dỡ hàng	卸
Qian	汘
mơ hồ	矓
Rượu Hennessy	軒尼詩
Tong	佀
Thuế	税务
Hoàn thiện	定案
cùng tồn tại	并存
Yan	拠
Lữ đoàn	大隊
Nhà nguyên	元代
Seleu	塞琉
khu vực đô thị	都市圈
phương tiện	車輛
Năm	年來
Caledo mới	新喀里多
Con người với	人與
Ouyang	欧阳
neodymium	钕
Rocky	岩礁
Người Hồng Kông	香港人
Quá trình lây truyền	傳學
Philip	腓力
nhân vật chính	主角
Yi	贒
uy tín	聲譽
chiều dài	长度
thuyền	小船
hợp xướng	合唱团
Tát	跍
Taishi	台市
Ra mắt	出道
Uỷ ban	委托
Cây phong	槭
Mishi	御史
gây tê	麻醉
triển khai thực hiện	贯彻
Dàn nhạc	管弦
phụ lưu	支流
Loren	洛伦
Tang	潽
hành vi	行為
đất ngập nước	湿地
Nói dối	跰
Trách nhiệm cấp tỉnh	省負責
Chính phủ nhà Thanh	清政府
phía đông	東方
Sức ép	壓
Xung đột dân sự	內亂
brôm	溴
Suối	溪水
Hạ Môn	廈門
Hoàng đế Guangxu	光绪帝
phẫn nộ	慍
Qing Bing	清兵
Nguyên nhân thời gian	時因
lăn ra	推出
bảo tồn	餞
Người lính ưu tú	精兵
Ngăn cản	失速
món ăn	碟
đường ống	管道
Pan	潘
Mogo	魔苟
Kiên trì	毅
Augu	奧古
Có thể	戛
Bikini	比基尼
Qichao	启超
Tôi	亇
Thay đổi	嫦娥
Khách mời	客座
lừa dối	诓
Shuji	書紀
la kêt quả của	後果
Chủ đề	為主題
Thế giới	世界上
viết tắt	縮寫
màu sắc	彩色
thẳng	直
gái điếm	婊
Gốc	原属
vết loét	瘍
chương	章
Phi cơ	飛行器
một là	一個是
Dâng trào	湧
từ	離
Caen	卡昂
Ba	仈
ve sầu	蟬
Vienna	维也纳
nghiên cứu	研
Hợp nhất	巩固
Ra trận	出戰
hợp kim	合金
Angstrom	埃
móng tay	釘
khoe khoang	夸
hắt hơi	嚏
Hoàng đế	帝君
Gongsun	公孫
Bà ấy	歙
Giống hệt nhau	形同
Họ ngôn ngữBình luận viên	语系論者
buồn	悲伤
Di tích lịch sử	史迹
Khử trùng bằng clo	氯化
kỉ lục thế giới	世界纪录
Năm lúc	年於
Hợp chất	大院
khiếp sợ	虩
khai thác mỏ	矿业
Dư luận	舆
Thành phố Đào Viên	桃園市
Mạch	电路
vùng cốt lõi	核心区
Khổng lồ	巨型
Tổng số thức ăn	全食
Lai	臘語
cá đuối	鲼
ở giữa	正中
Xie	邔
nhiếp chính	摄政
europium	銪
làm ngập	泅
kinh nghiệm	经历
Yan	摈
Xiao	箫
Jie	労
Yếu	弱
Lễ hội	祭典
Bữa tiệc lớn	大黨
Cyprinidae	鲤科
Xuân	璇
Cảnh sát trưởng	郡主
Đồ thủ công	工艺品
ngày	日子
thuật ngữ	术语
Giá trị gia tăng	增值
được	给定
Anh ấy đến từ	他從
Lille	里爾
Bouy	布依
Odo	奥多
Con rùa	賫
Min	闽
tin đồn	谣言
không thể giải mã	漶
Tuấn	抟
cửa hàng bách hóa	百貨
Mô-men xoắn	力矩
Văn bản	字眼
Khai thác mỏ	開採
Thành phố quảng châu	广州市
Tao là	道為
Băng nhóm	硏
đổi	互換
yttrium	釔
Chúa tể	藩主
Yong	瀜
Kéo	揪
Tốc độ ánh sáng	光速
giá trị sản phẩm đầu ra	产值
Bồ nông	鵜
Lo lắng	忄
Tin tức neo	新聞主播
Đến để giúp đỡ	來幫
con lừa	驢
Kimoto	旗本
Sống ở	生存於
sự trùng hợp	聚合
Galvanic	流电
Sai lầm	不對
Lạm dụng	濫
Qi	羮
thanh John	聖約翰
Ghim	蟯
đường hô hấp	呼吸道
Phỏng vấn	專訪
bóng rổ	篮球
Tấn	洵
đói bụng	饿
chủ quan	主觀
Onishi	大西
Quang phổ	頻譜
Chẩn đoán	诊
mát mẻ	涼
Chen Chao	陳朝
xem	看見
Tuần tra	巡防
Các vấn đề pháp lý	法務
không khí	大氣
Tạp chất	杂质
chơi trò hề	揶
Nhà ga nhỏ	小站
Đảo giữa	中途島
ve sầu	蜩
Sushi	苏轼
Yongjia	永嘉
Kaoru	薫
Lý do	為由
Farah	法拉
Daxing	大興
Meier	美爾
Sau đó thì không	則沒
miễn phí	免費
Ở phía Đông	於東
Spielberg	斯皮尔伯格
trong	中
cây con	苗
tương tác	互动
Inkstone	砚
Trong lòng đất	地中
nữ hoàng	國後
Và từ	而從
Quận	爾縣
Li	靱
Chính phủ liên minh	联合政府
cung điện Quốc gia	國立故宮
Tong	骢
Zizhen	子镇
Cái đó không phải là	那不
Ming	铭
Quận Tuen Mun	屯門區
Vì thế	瑟
cá đuối	鰩
Thương số	商
Vấn đề	发放
tràn ra	溢
vỏ trái đất	地殼
bùng binh	迂迴
Pingpu	平埔
Yan	滟
quý ngài	長官
Mei	嵋
Minnesu	明尼苏
Shao	鱮
Ping	蓎
Sơn đông	山東
Triều đình	朝廷
kéo dài	肸
nguyên nhân	事業
kinh doanh	商業
axit cacboxylic	羧酸
Nào	加油
Seoul	首尔
Qi	汈
Với quan điểm	以期
Chiếm	所佔
Răng cưa	鋸齒
công chúa	王妃
Những người bình thường	普通人
Zhu	炷
Huyết tương	等离子
Zhou Jie	周杰
Taki	瀧
khối	擋
nhàn rỗi	闲
Đỉnh Victoria	太平山
hiện hành	现时
Hãn quốc	汗国
Rhineland Palatinate	莱茵兰普法尔茨
Ping	坪
một bài kiểm tra	检查
Khủng long bạo chúa	暴龍
Bằng cấp	資歷
thờ cúng tổ tiên	祔
biên kịch	编剧
Yi	鎰
đồng cỏ	牧場
Không có gì	毫无
Verdun	凡尔登
Cùng một mẹ	同母
Pixel	像素
Gọi	唤
Khó xử	澔
Tát	蹹
Tổ chức	體質
Tin đồn	傳言
Yongsan	泳三
Năng lượng mặt trời	陽能
Yi	乹
Bươm bướm	蝶屬
Rafi	拉斐
Fushun	抚顺
phần mềm	軟件
Jingkang	靖康
Đậu	停泊
Flycatcher	鶲
mua tín dụng	赊
mặt trời sắp mọc	曈
hư hại	损害
Sau thất bại	敗後
Sức mạnh và	力及
Thất bại để	輸給
Mạng lưới	络
Do Thái	犹太
rạp hát	劇院
Hart	哈特
Số lượng nhỏ	小量
riêng tư	私立
Diễn dịch	绎
Khi tôi lớn lên	長大後
ruthenium	釕
mua, tựa vào, bám vào	采购
vu khống	謗
Trường học	辦學
nóng nảy	躁
Với Su	與蘇
chỉ có	只有
binh biến	兵變
Khen ngợi	褮
lời tiên tri	預言
Tìm kiếm	搜寻
Trì trệ	滞
Amiens	亚眠
lí trí	头脑
Trừng phạt	普宁
Trong khoảng	約於
cối xay	砻
Orlois	厄尔卢瓦
Người Duy Ngô Nhĩ	維吾
Thiết lập trường	場設
Ngồi xổm	聸
tốt	善
Cắt	琢
Độc thân	单个
cắt	斩
sỏi	石頭
Nước phát triển	发达国家
Văn hóa và Giáo dục	文教
tối	暝
Lu	鮊
Thổ cẩm	錦
Cần thiết	不可或缺
Tiêu chuẩn quốc gia	国家标准
Khác với	異於
Thành phố và Quận	市县
Ashikaga Yoshi	足利義
Suo	荘
Con muỗi	蚊子
song phương	双边
chỉ có	唯一
nhỏ	小
Whig	辉格
Tunisia	突尼西亞
Sáu bộ	六盘
Được	待
sẽ là	會是
lúc đầu	起先
xiên	斜
Quảng tây	廣西
điện dung	电容
chốc lát	瞬間
Căn giữa	居中
Thời gian	时称
Nhóm nữ	少女組
bán thời gian	兼职
Số hai mươi bảy	第二十七
Chẳng để lam gi	為無
Nói dối	利耶
nịnh nọt	谀
Đào tạo	培
nữ hoàng	皇女
Shilong	氏龍
Lính	兵士
Tiếng ba tư	波斯语
hồi sinh	復興
Từ	起
Kanaga	寬永
nói lại	重复
Hu	眧
Phó	副手
Nước	食水
Tan	膼
Nhồi máu cơ tim	心肌梗
GBP	英鎊
bộ ký tự	字符集
mũi tiêm	喷射
Châu Á	亚
marathon	马拉松
Âm	纇
Lăng mộ	陵区
Thống đốc	刺史
cân nặng	重量
nghiêm trọng	严重
không xác định	不詳
Blog	網誌
nửa chừng	中途
tấm ảnh	照片
Ngược lại	相反地
Công việc của chính phủ	政务
Gọi là	记作
cây	槾
nhà phê bình	批评家
Đá	蹬
thị trường đường phố	街市
Doanh trại	军营
Hani	哈尼
ánh sáng mặt trời	日光
xe hơi	车厢
Ngoài	出
Đồng nghiệp	同鄉
Cảm giác sâu sắc	深感
tình cờ	偶然
gió	风
Yan	栄
quặng	矿石
đốt cháy	烧
Jair	睚
Thật trùng hợp	恰巧
Nội tạng	內臟
Biên niên sử	紀年
Somme	索姆省
Sắc nét	酥
sau đó	于是
ôm	摟
Làm mẹ	母舰
Tròn	雔
Tất cả các loại	種種
Đánh bại	大败
Tao	韬
Ting	霆
hàng xóm	邻居
Điều	東西
trả	賠
Dakko	达科
Giá trị thị trường	市值
Công bằng	股權
Bài viết trên blog	博文
Yan	擯
Da	岦
Phân vùng	區劃
khuôn mặt	面對
Lỗ rò	瘺
Chan	锾
Địa điểm	站点
món ăn	糧食
Tòa nhà chọc trời	摩天大樓
Tương thích	相容
kỷ	百年
Lin	蔏
Nước Phổ	普鲁士
Si	埮
ánh sáng	轻
Reims	兰斯
cấp dưới	部屬
Xiao	骁
lệnh cấm	禁令
Đã ghi vào	錄於
Cận nhiệt đới	亞熱帶
Đầu tiên	首個
Thiết bị âm thanh	音器
Marne	马恩省
Buộc tội	指责
cùng với nhau	一同
Ga xe lửa phía Đông	東站
không thường xuyên	儳
Yumoto	行本
Kho	倉
Trang web cũ	旧址
mục tiêu	目标
thù lao	報酬
Dược sĩ	藥師
nghèo nàn	貧窮
cuộc tranh cãi	争吵
Fu	褾
Bang	朂
sức mạnh quốc gia	国力
Bảo vệ đất nước	護國
Thời gian này	該次
Anzai	安西
Hiroshima	廣島
Trong tầm kiểm soát	控制下
Thành phố cảng	港市
Hệ thống cổ đông	股份制
Giữ	舉辦
Mời bạn đến	請來
Watts	瓦兹
Tang	趍
Tồn tại trong	存在于
Đồng ý	笃
đến cuối cùng	為此
Li	廇
thú vật	的動物
Đánh nhau	交手
Mặt công cộng	公方
Hiện	露面
Sức gió	風力
thành phần	元素
Giai đoạn	相位
Erha	尔哈
Cuối triều đại nhà Thanh	清末
phá bỏ	拆除
TV nhân dân	民視
Ngày đầu tiên	首日
Bố trí	佈置
Miếng	片段
Guoxue	国学
Đàm thoại	談會
Tiu Keng Ling	調景嶺
Với Anh	與英國
Chu	濹
Maha	馬哈
Đẩy về phía	推向
Số không	為零
Miền Trung và Miền Tây	中西
Đẩy lùi	排斥
Yi	彜
Nhập cảnh	入境
hiện đại	现代
Zhenguan	貞觀
ghi lại	録
trái cam	橘色
Cassini	卡西尼
Vội vàng	闯
đắt	貴
Cuộc cách mạng vĩ đại	大革命
chất bán dẫn	半导体
nhà viết kịch	剧作家
qui định	規則
Nhặt lên	皮卡
Hải cảng	端口
ổn định	稳定性
Thám tử cảnh sát	警探
Kẻ ngốc	讕
Xe đạp	自行車
Lực lượng vũ trang	武装部队
Thành ủy	市委
Bang	昋
Chứng thư	事蹟
diễn viên	男演员
Thông minh	智慧型
năng lượng	能量
Thành phố	該市
Ming	溋
Thạch tín	栒
xanh đậm	靛
dịch vụ	服役
Phun	噏
Hiragana	平假名
Ở lại Mỹ	留美
Tari	塔里
vết trầy	刮
nhà kinh tế học	经济学家
tấm ảnh	相片
Nói chuyện	講談
Vạn lý trường thành	长城
thịt heo	豬肉
thường xuyên	频繁
Yên Đài	烟台
Jiang Guo	將國
tấm thảm	毹
tự sát	自殺
Cole	柯尔
yếu đuối	弱點
Mm	毫米
Lịch sử quốc gia	國史
Hoạt động	营运
Lý thuyết tập hợp	集合论
say	湎
Công bố	刊行
hóa thân ma thuật	氤
xà lan	堎
Solstice	至日
nở hoa	開花
Joseph	若瑟
Liszt	李斯特
Cơ sở hạ tầng	礎設
da	革
Phim và truyền hình	影視
cộng đồng	群落
dư thừa	之餘
làm phiền	煩
Ủy ban pháp luật	法委
nhà thờ Công giáo	天主堂
Zhu	杼
bóng	阴影
Thay đổi kinh sách	改經
Alice	爱丽
Ooh	嚯
Ghi lại	紀錄
Bằng gỗ	木造
thở dài	叹
Mang	運載
Mỗi lần	每逢
Đôi	双打
Takahashi	高桥
sự phân chia	除法
động đất	地震
Đối với	為阿
với	龢
Tory	托利
theo	跟随
Nhấn mạnh	影射
Tang sau	后唐
quả thận	肾
Ki	淇
rộng rãi	广为
Fourier	傅里叶
Lu	璐
chòm sao Kim Ngưu	金牛
Khám phá	探讨
Nebras	內布拉斯
Triệu	萬
đàn piano	钢琴
Hạng A	甲等
Tuck	掖
thang máy	電梯
Hoàn thành	完
cơ thể con người	人體
xúc phạm	貶
Khai thác mỏ	开采
phía đông	東部
Gợi lại	回想
Tongzhou	通州
Lagrangian	拉氏
nạn nhân	受害者
ngành công nghiệp	工業
Chuyển đến	迁入
Diễu hành dài	长征
Thêm	新加
Thông tin liên lạc	互通
Tận hưởng cuộc sống	享壽
văn phòng	办事处
Jing	涇
Treo	吊
Geer	格爾
thành công	接替
Tấn	語氣
bóng chày	蛩
Mozart	莫札特
Quan trọng	至关
Heng	亨
Bố	生父
Jia	稼
Trong tay	手里
Phát triển	開發
Mạnh	强力
Valerian	纈
Xu	許
Brin	布林
cái nhìn	睐
Muộn	後期
mạch đập	脈
đầu trước	前端
Vịt Bắc Kinh	鸳
Dap xe	遊騎
bông tuyết	雪花
Nước đá	冰
Thần tượng	神像
Hát	燶
Con mèo	猫
Nam Ninh	南宁
Massachusetts	马萨诸塞州
Dân quận	縣人
Ming	蔇
hậu môn	肛
biểu ngữ thêu	綮
Hội trường đại học	大学堂
Chaoshan	潮汕
Bu Li	卜力
Báo cáo	上报
tạo thành	捏造
người tiền nhiệm	前任
Đồ đá cũ	旧石器
Phải	鬚
Midtown	中城
Li	銭
Cấp độ	水平
Ủy ban Khoa học và Công nghệ	科委
phòng thủ	捍卫
trường hợp	事例
Xindian	新店
cùng tồn tại	共存
Hợp tác	配合
Tháng mười một	十一月
Chỉ trích	儣
muốn	欲
Pseudo	贗
nhượng bộ	让步
Quá nhiều	太過
Màu xanh da trời	蘭
Hành tinh	星球
Một ngày	一日
Ủy ban huyện	区委
cờ	旂
Mức độ nghiêm trọng	轻重
dơ bẩn	涴
Lu	鲁
Văn hóa và Triết học	文哲
Chiếm giữ	淪陷
Đàn bà	婦女
Theo	遵照
Lợi ích	受惠
hòa giải	和解
Dong	棟
Lankai	兰开
Raiders	攻略
Chen	谌
chương	章節
Tiếng Phạn	梵文
Linkou	林口
chà xát	蹭
Lời phàn nàn	控诉
Tổ chức	籌辦
Gurley	格利
Cổng thành	城门
Cho cả đội	為球隊
người chồng	婿
Si	霶
Kai	凱
vỡ	破裂
Lin Li	林立
Thời gian dài	多時
Thanh lịch	典雅
Hor	荷尔
đã sửa	固定
Khu họp	會選區
Hình dạng của nó	其形
Di	棣
thành phố San Diego	聖地牙哥
Độc nhất	特有
giới hạn	限制
đà điểu	鸵
Âm	釖
ấm áp	熱烈
Bậc thầy	高手
khu vực thiên tai	災區
Sumer	苏美尔
Trao giải thưởng	獲頒
Tran	特蘭
Angie	安琪
Căng ra	抺
Celestial Sphere	天球
họ	他们
Olympi	奧林匹
Shen	瀋
dây điện	絲
Ur	乌尔
khí thải	发射
Chân đồi	山麓
lý do	理智
Zygomatic	颧
Titanic	鐵達尼號
lữ đoàn	准將
đồng hành	陪
Quay lại	囬
mùa xuân	彈簧
Thảo luận và	論與
Pan	槃
Thỏa mãn	满足
Chi nhánh	分馆
Tù nhân	囚犯
Neil	尼爾
Sau đó	後便
Học cao hơn	进修
Bắt buộc	必修
núi	山
Định lượng	数量
Ở trên	之上
Bị giết trong hành động	陣亡
Nhận định	辨識
Tổng cục	總局
Âm	枛
Thiêu	焚燒
Castel	卡斯泰尔
Ye	谔
Tao	涛
Xây dựng	构筑
Đặt tên	冠名
Tìm kiếm	探勘
Nghịch ngợm	兎
con kênh	渠
Trước mặt	锋
Hảo	灏
Cờ vua	棋類
Yan	勄
Mooney	慕尼
Nam Triều Tiên	南韓
tiểu bang	態
Di	翟
Làm	订立
Bạn cùng lớp	同学
Đối với Đài Loan	為台
hiện nay	今天
Jefferson	杰斐逊
Khởi nghĩa Vũ Xương	武昌起义
sự thất bại	失敗
Tháp chùa	寺塔
Vở ballet	芭蕾
Máy khoan	钎
Đào tạo trẻ	青訓
Baida	百大
Toàn bộ hòn đảo	全島
M	獁
Nâng cao	进
Tang	漅
Trước trận đấu	賽前
Ban hành	頒布
Nobunaga	信長
Como	科莫
nhãn khoa	眼科
tỉ lệ tăng trưởng	增长率
Gar	噶爾
Quê nhà	籍貫
Huyền phù	悬浮
Xing	邢
quốc huy	國徽
Puli	埔里
Chu	蜌
chương	章节
Tuyến Yamanote	山手線
mong manh	袅
phóng	发动
Yu	虸
Phân khu	细分
Huyền Thành	宣城
Quan hệ tình dục qua đường hậu môn	肛交
Hiện vật	实物
Yu Dang	於當
thiên văn học	天文学
vắc xin	疫苗
Salo	萨洛
Đơn vị thiên văn	天文單位
Cho có	為是
chilblains	瘃
Những người bạn tốt	交好
Đảng Tiến bộ Dân chủ	民進黨
thang máy	电梯
So sánh	有較
Kế hoạch	普朗
Midi	美第
Nửa trên	上半部
Huang Xing	黄兴
làm	做
đói bụng	餒
Hướng dẫn này	這導
hồi phục	复苏
quần vợt	网球
Crewe	克鲁
đỉnh cao	巅峰
thiếu	缺乏
Hiện tại	呈現
Mông Cổ	蒙大
Đại học	本科生
Bệnh tâm thần	精神病
Weishui	渭水
Góc nhìn cá nhân	視角
Zhi	陟
Chơi bài	出牌
Hu	禟
chuột	老鼠
Andrew	安德魯
Yan	籣
Chuan	川
âm thanh thì thầm	嘁
phóng khoáng	自由派
bệ phóng	發射器
nghẹt thở	呛
Trái bóng	夫球
glycerin	甘油
sau đó	當年
lấy	拏
Luo	漯
chỉ	剛剛
Mở ra	展开
Allah	真主
và yêu cầu	並要求
Sau khi chết	去世後
xe tải	卡车
Zhu	篿
Tạm biệt	氎
dè dặt	谨慎
Chiếu xạ	照射
gia vị	香料
thở của lợn	豷
Taihe	泰和
CPPCC	政協
đi học	上学
Quận Hồ	湖区
Đương nhiệm	任者
Lớp con	亞綱
Fontaine	方丹
Chức năng	職能
mục đích	確定
Sống sót	活著
nhảy	蹦
thế hệ	輩
Jinta	金塔
đứa bé	婴儿
trận chiến quyết định	决战
Để theo dõi	為繼
Bắt cóc	綁架
mộ	圹
nhẫn	環
Đúng	也對
Ye	烨
Kỹ năng	技
bánh ngọt	餅
Hai	兩座
Và Đài Loan	與臺
Vĩnh hằng	永恆
Anh ta	衪
bất cứ lúc nào	随时
Beech	比奇
Franklin	富兰克林
Vùng nước	水区
Đôi khi	時沒
Tong	曨
thợ săn	獵人
Đi	多哥
Người chơi	球员
Đối với	用以
Ghét	痛恨
Whig	輝格
Ma trận	基质
Viện kỹ thuật	工程院
Cắt ra	剴
Gân	筋
khóa học	課程
không đủ	不足
Danh mục	清单
dịch vụ	維修
Khách hàng	客户端
Toàn diện	綜
Họ đậu xanh	毛茛科
chap	皲
Sản xuất	出品
bọt	沫
Anh ta	踨
huyền thoại	传说
khối Rubik	魔方
vì thế	这么
Kịch	话剧
Thung lũng	谷地
Bệnh tiểu đường	糖尿病
gien	基因
Chuyến thăm	造訪
cắn	咬
tăng lên	漲
Tsushima	對馬
Krypton	檰
Trong văn phòng	在任
Nươc Nha	本国
Grand Slam	大满贯
trò chuyện	聊
Einsteinium	锿
mũ sắt của lính	盔
Mọi người	者們
Dương	阳
Xuân	煑
Hạt	個縣
vòm	拱
Hạt	各县
cây thương	槊
Trang phục	裈
Cole	科爾
may chăn	衾
săn bắt	追殺
Thời Tây Hán	西汉
Tình nguyện viên	自愿
tự phát	自發
Derain	德蘭
Việc làm	就业
Tang lễ	陪葬
Hai mươi bốn	廿四
Gần	將近
Harada	原田
Thế vận hội mùa đông	冬奥会
rẻ tiền	亷
Ngôn ngữ tao nhã	雅語
Tần Châu	秦州
Từ điển Khang Hy	康熙字典
Giữ	控股
tham	饞
Tiếng Khmer	高棉
Ăn cỏ	草食性
Cổng vào	出入口
thulium	铥
Đã chọn	选定
chết tiệt	紩
Hecta	公頃
Bình thường	寻常
Guanglu	光祿
Tiến quân	軍進
Nước mắt	涕
lực lượng	迫
Bạo loạn	防暴
Lipai	力派
Quang phổ	谱
tarsus	跗
Quận Tân Trúc	新竹縣
Rau mùi	獽
trở ngại	障碍
Ryan	瑞安
Tấn công	出擊
Montenegro	黑山
Bốn hàng đầu	四強
Billy	比利
Bản sửa đổi	改版
Làm	造
sự phán xét	判决
quán ba	酒吧
Nyon	尼翁
Tao Xing	道行
Đặc điểm	特质
Đổi tay	易手
nghệ thuật	艺术
Dầu diesel	柴油
ga tàu	枱
Băng dán	杇
Lương Châu	凉州
Nhúng	浸
đường cát	砂糖
Máy bay trực thăng	直升機
hàng đầu	頂
Quốc gia	國度
Nhà khoa học	學家
Tuổi tác	泭
Chèn	挿
Chảo	镬
Ngũ phúc	五福
Những người khác	其他人
Điều khiển	行车
Ở đâu	凡
BBC	英國廣播公司
Hu	鬍
Nhập khẩu	導入
Quá cảnhKiểu	过境型態
Zhu	陹
Ak	阿克
Ngành và	業及
dãy núi	嵎
Tiềm năng	勢
Chăn nuôi gia súc	牧
huy chương đồng	铜牌
Tháng sáu	桚
tiếng Đức	德式
ngăn xếp thư viện	宬
Xuân	禆
Ku	巋
thịt cừu	膶
Cán bộ điều hành	执行官
bữa ăn	膳食
Bucharest	布加勒斯特
Kiện tụng	讼
Chen Jiongming	陈炯明
Tuyên bố	语句
Số một	頭號
đau khổ	遭受
Sâu	蠄
Rối	掂
Đến	來
Tamil Nadu	泰米尔纳德邦
thông minh	智能
Li	躞
Trung thành với ai	忠于
Kho	仓
iridium	铱
Âm	覔
tiêu đề	頭銜
Yu Ren	於人
Tổ chức	立宪
Đổi	交易所
Ya	鞒
Phá vỡ	击破
cái chết của một hoàng tử	薨
dần dần	漸
nhìn yêu cầu	睥
Những ngọn đồi	山丘
tĩnh mạch	静脉
Cái	块
Tháng 11	诺夫
Tin tức	聞報
khó khăn	艰
Để gửi	來發
Nao	瑙
cấp	发行
chuỗi	鏈
Sơ bộ	预赛
Chiến thắng	戰果
mã lực	馬力
Sau đó có	則有
tử cung	子宫
sẽ	遺囑
bismuth	铋
Socrates	苏格拉底
Bởi	期以
Quân đội chiến tranh	戰軍
Sau khi di chuyển	動後
Đồng tính	同态
Vật nuôi	宠
kỷ luật	纪
Dưới	底下
chuyển khoản	轉乘
Bùng nổ	嘣
hậu môn	肛門
dặm	英里
nâng cấp	升级
Hiện hành	电流
Ye	楴
rượu trong	泲
sự chỉ rõ	規範
Mẫu	紋
quà tặng	礼物
trở về	回归
Số là	號為
bờm	髳
nhìn nhận	认
thợ rèn	史密斯
Chạy xuyên qua	贯穿
lái xe	驅動
Nheo mắt	蜯
kéo	拖拉
Đa quốc gia	多國
săn bắt	大通
Còng	桎
tiềm năng	潜力
điện tử	电子
Lang	阆
cây	植物
Thuộc địa	殖民者
rất nhiều	非常
mạnh	釅
nhà hóa học	化學家
tuổi tác	年纪
Nằm trong	在於
răng	牙齿
Lisi	麗絲
Diễn xuất	演技
Bãi hàng hóa	货场
Kích hoạt	引发
tấm thảm len	氍
Xu	戌
Tổ chức lại	重整
Maine	美因
ngoại trừ	除了
màn	扆
dựa vào	依靠
Mario	马里奥
Ngoài khơi	近海
helium	氦
bánh bao	饺
Xinhui	新會
đập phá	堰
Rình rập	薷
cũng thế	還
Các ngày trong tuần	平日
Dàn nhạc	樂團
Đùi	腂
Hu	扵
Đài phun nước	噴泉
đọc	閲
năm mươi mốt	五十一
Sẽ là tất cả	將所有
sách	图书
nhiệt	熱力
Sắp tới sẽ	來將
dịch vụ phà	轮渡
Sway	淂
bó	綑
Đứng	常务
Ủi đồ	熨
Wanshi	莞市
Tắm	沐浴
điện lực	电力
nhìn nhận	認
muộn	遲
Tấn	勳
trên đó	叵
dân chủ	民主
Zhang Zuolin	张作霖
Giới thiệu	简介
Luân	黦
Đất và	地與
Chôn vùi trong	葬于
pháo binh	炮兵
Đảo Ke	克島
Kết hôn	成家
Châu Mỹ	美利坚
đáng yêu	可爱
riêng tư	私人
Liangjiang	两江
Cheng	骋
Nujiang	怒江
Nhìn bao quát	瞰
viết	執筆
đơn giản	单纯
Guyana	圭亚那
Khao khát	意欲
Sự đối lập	對立
Nước Iceland	冰島
Toàn bộ	佔總
khác	其它
địa hình	地势
Cá	魚屬
cung cấp	供应
cha	爸
Ông chủ	頭目
Ma	魎
Xương bánh chè	諌
phước lành	禠
Jiaxu	甲戌
Nếu và chỉ nếu	当且仅当
Tới vì	來為
Buồn	難過
Tên	名義
trong nước	国内
kẹp	撱
Chỉ	公映
thay thế	更换
Thông minh	优异
Ana	阿纳
oát	瓦
Hàn Quốc	韓
York	約州
Nói cách khác	換句
Qi	钁
Xấp xỉ số	數約
tà ác	孽
Nhạc Opera	越剧
Thế giới	界
Quân Hồ Nam	湘军
Kinh dị	幌
nước muối	鹽水
Chiếm lấy	擄
Sóng	海浪
khắc	鏤
Buồng lái	艤
năng suất	让
Tianxiang	天祥
Đất liền	内地
Hookup	联播
Bị ám sát	遇刺
ngôn ngữ học	語言學
Quark	夸克
cá voi	鯨
Tai hổ	虎耳
Thương hàn	傷寒
Trong luc đo	其間
Nói cách khác	也就是说
tuyến giáp	甲状
Châu Á	亞裔
Phương tiện truyền thông	媒
đánh	击中
Màu be	弴
vàng	金币
trạng thái	地位
Quyến rũ	魅
Hạt	縣市
Trích xuất	萃
Xây dựng	建设
nghi ngờ	疑慮
U ám	郁
Yu	琤
trang viên	封地
Lanka	蘭卡
cá nhân	個體
Chữ thập đỏ	红十字
Dace	鲮
Malacca	马六甲
Hội chợ	博览会
Dơ bẩn	龊
mặt trời mặt trăng	日月
Lu	魯
Tự hành	自走
Lối vào chính	正门
Ngọc bích	礐
kim loại	金属
kết hôn	嫁
Cành cây	薜
Anh trai	弟兄
镈	镈
địa hình	地勢
Xây dựng	砌
Lí trí	心目
Trả	薾
đô thị	大都會
Phá vỡ lớn	大破
sưng lên	臌
Cả hai	兼具
Người thừa kế	嗣
Bang Louisiana	路易斯安那州
Kowski	可夫斯基
Chúng tôi sẽ	們將
nở	孵
chơi	遊玩
Đảng công dân	公民黨
Yi Fu	藝復
Gian lận	诈
Nhà sử học	历史学家
màn	屏幕
Đứng trên	站於
Sẽ	將與
Đối với điều này	為這
Ku	岿
sân vận động	體育館
Khí ga	燃氣
Liu Jin	劉瑾
phát xít Đức	納粹德國
Bạn gái	女友
Leeds	利兹
Quận Giang	江縣
Quay phim	摄制
Đây	這裡
cột tóc	丱
toàn bộ	縂
Shimin	世民
Bạn có thể	則可以
Cơ đốc giáo	基督徒
nghĩ	思想
Nổ	爆出
Kentucky	肯塔基
HNA	海航
Monte	蒙特
nâng cao	先進
Người sống sót	存者
kinh doanh	生意
Nas	纳斯
Katerina	卡捷琳娜
Bạn	悠
liên quan	有關
Dagon	袞
Trẻ	揚
Trường hợp này	这种
Giải đấu	屆賽
Lăng mộ	墓群
Gui	珪
Mười ngày	十日
Bật	開啟
Vây hậu môn	臀鰭
Ủy ban Olympic	奥委会
Lá thư	上書
Sẽ ở	會在
Chiến thắng lớn	大勝
chiến tranh Hàn Quốc	韓戰
Bướng bỉnh	匄
Tiêu cực	阴性
Dòng chữ	铭文
cơ quan báo chí	通讯社
Daigo	醍醐
light novel	輕小說
đồng hành	伴侶
Hơn nữa	再者
Thị trấn quan trọng	重鎮
mang	携
Bài học	講座
có thai	娠
Wairo	外郎
tạo nên	締造
đếm được	可数
gấp đôi	双
Cỏ	格拉斯
nguyên đơn	原告
Tương đương	等同
Giống	似的
Đếm được	有數
tai	穗
đặt hàng	順序
Amazon	亚马逊
kết hôn	结婚
tăng sức mạnh	通电
Quán ba	捥
Sdorf	斯多夫
Genoa	热那亚
Quyết định gần như	準決
Ngoan đạo	虔誠
cười	笑
Yi	嶧
do thám	侦察
Kỹ sư	工兵
Phổ biến	人气
Taoyuan	桃源
Để lộ ra	露出
Tác giả gốc	原作者
viền bếp	陘
trò chuyện với	聊天
Giáo sư thỉnh giảng	客座教授
Duyên dáng	頲
yêu tinh núi	魑
Phân loại	分级
xây dựng	筑
nắm bắt	捽
Phiên này	該屆
Kana	神奈
Vội vàng	藺
dư thừa	過量
Vì đó	為有
nhọn	急剧
Giải thưởng Emmy	艾美獎
ngay	马上
Yi	佹
Hướng tây	西行
đọc hiểu	讀書
Chiếm khoảng	佔地約
khủng khiếp	可怕
vấn đề	難題
Shao	鸏
Danh mục	名录
Hai chiều	二路
Chơi chữ	鋹
dạy	教導
Thành phố cấp quận	县级市
Ile	伊勒
Cassie	卡西
mạng tinh thể	櫺
cho ăn	饲
Vô cùng	极为
Lễ	大典
diễn đàn	论坛
Đối xử như	當作
súng cầm tay	枪支
tiếng Nhật	倭
bách khoa toàn thư	百科全书
Phát thanh truyền hình	广电
Pefu	佩孚
Seoul	首爾
Sẽ vào	會進
đỏ tươi	緋
Dõi theo	看管
Rình rập	薞
Tây An	岘
Và phải	和對
Zongnan	宗南
Khán giả	全场
Nướng	焗
Phiền muộn	瞓
Nhà giám sát	監察院
Dortmund	多特蒙德
Khu vực đá ngầm	礁區
trước mặt	陣線
Luo	珞
Chuyển tới	迁至
Mozambique	莫桑比克
vài ngàn	几千
Nghiêm nghị	艶
căn bệnh ngoài da	癩
Xe buýt đưa đón	班车
Lấp lánh	粼
Heisei	平成
Quê nhà	回鄉
cây cột	柱子
nhượng bộ	讓步
Gao Huan	高欢
Thông thoáng	清澈
không vâng lời	忤
Kết thúc	告一段落
mứt	蕷
Fu	弗
Đảng nhân dân	人民党
rừng	林木
Bốn chiều	四维
Hồi giáo	伊斯蘭
Được xây dựng	建成
đẩy lùi	擊退
trông mong	期待
Hạ xuống	世系
Ngân Xuyên	银川
Vòng	袐
thông minh	優秀
phần	部件
Hét lên	嗱
Sui	蘞
Đội đại diện	代表隊
Liền kề	鄰近
Ngớ ngẩn	俆
thiết bị hạ cánh	起落架
bơ biển phia Băc	北岸
kỳ hạn	用語
Động kinh	癫
mùa đông	冬天
Giám đốc	所長
Celtic	凯尔特
Tro	骨灰
thiếu niên	青少年
Liên đoàn châu Âu	歐洲聯賽
Nicea	尼西亞
nước và đất	水陆
Không khí	愛爾
Đi ngang qua	掠過
Thành phố Côn Minh	昆明市
Truyền lại	传世
Qinling	秦岭
Suncheon	顺天
Hạt Ping	平縣
bay hơi	蒸发
lụa trắng	纨
gồ ghề	岖
giật mình	骇
xe điện ngầm	地鐵
Bắc Thiểm Tây	陕北
Yi	侅
100 triệu	一億
mắc kẹt	擱淺
Máy bán vé	售票機
Kan	崁
Ai	璦
cày	犁
Bazaar	市集
Ming	樚
mộ	墓
Kẻ thù	敵方
chủ nghĩa bảo thủ	保守主義
Phấn đấu	爭取
lạc đà	驼
Và quyết định	並決
phim hài	喜劇
Đầu ra	输出
Hengchun	恆春
viết	泐
rượu mùi	酒
ý tưởng	主意
chủ tịch	总统
hình học	幾何
Giờ công	人時
Tât cả mọi mặt	四面
Thuộc về lý thuyết	學術
đến	嚮
Con rắn	蛇屬
Siêu thực	超现实
Nếm thử	口感
Fra	夫拉
Internet	互联网
Trong xe	车内
uống	暍
Văn phòng ủy viên	专员公署
Chữa cháy	消防
bộ sưu tập	廊
Tất cả	遍及
Hội họp	場館
năm mươi hai	五十二
Kế tiếp	接連
Stewart	斯图尔特
Dong	硴
Bình luận viên	卡斯特
Cây lau	竘
Xuất hiện	現出
phù phiếm	恌
Aristotle	亚里士多德
đội	隊
bão nhiệt đới	級颱風
Ling	垻
Đi qua	行經
mua sắm	購物
sau đó	而後
Kế hoạch	筹划
Giả vờ	扮
Nước Anh	大英
Cách mạng Tân Hợi	辛亥革命
mái nhà	屋頂
ngành công nghiệp	产业
Yan	繄
Bọ cánh cứng	蠳
Kính trọng	尊称
Giữ lấy	挟
Tổng binh	总兵
Liên kết	綴
Con rắn lớn	大蛇
Cỡ chữ	字号
rực rỡ	煃
Alaska	阿拉斯加州
miền Nam	南
ông già	叟
sự vi phạm	愆
Sản xuất thử nghiệm	试制
Chu	菹
Hungary	匈
Tỷ lệ trúng	打擊率
Tăng lên	興起
quả bóng nhỏ	小球
bận	碌
Sené	塞内
xe buýt	客车
Yilian	憶蓮
bất chấp	不顾
Ling	蔊
Cơ đốc giáo	克里斯蒂安
axit	酸
Ôn	玟
di cảo	追赠
cú pháp	句法
tự nhiên	天然
sắc đẹp, vẻ đẹp	美容
nhấn mạnh	應力
Trong một hàng	一連
phép màu	奇蹟
Yong	鵕
Hai đội quân	兩軍
Đa nền tảng	跨平台
Quay lại	迴
Chính quyền	官府
kè	堤
Dựa vào	凭
khai báo	申报
Huân	湴
Nữ ca sĩ	女歌手
Tham gia	从事
hăng hái	熱情
ngôi đền	廟
Sol	索爾
mangan	錳
Reel	辶
Thành phố Tây	市西
Thành phố Lạc Dương	洛阳市
lên đường	出發
Hoặc ít hơn	或少
Trận bóng đá	足球赛
Bãi đậu xe	车场
Quận Yuen Long	元朗區
Huân	涣
steroid	甾
Sự tôn trọng	尊
Ủy ban Thường trực	常委会
Wallace	华莱
chủ đề	题材
giám đốc	经理
Nhà phát triển	开发者
Chôn cất chung	合葬
Cơn	布特
bình phục	收复
đôla Hong Kong	港幣
loquat	枇
Công thức	制订
cửa tiệm	鋪
bộ phim	电影
đê	码头
Nợ phải trả	負債
Vây lưng	背鰭
cái rổ	篮
Brest	布雷斯特
Chuyển hướng	改道
Gánh nặng	担
Vast	廣大
Bị kích thích	興奮
dịch vụ bắt buộc	徭
CPPCC	政协
Cấp bậc quân sự	軍銜
Mao	墭
trong	里
Vắt kiệt	抌
Quận Haidian	海淀区
Có thể canh tác	苩
Shao	苪
người sử dụng	用戶
Sự ăn thịt	掠食
Tai Gong	太公
thử	嘗試
gia sư	导师
con khỉ	猱
Đường Gloucester	告士打道
cái thước	矱
vẫn	仍然
Thần đạo	神道
đoạn văn	款
nhà thờ	教堂
Nhân loại	為人
Hóa thân	化身
Uruguay	烏拉圭
con kiến	螞
Ba Lan	波兰人
Đài	无线电
Trưởng nhóm	組長
hăng hái	热情
con ngựa mạnh mẽ	駔
Mis	米斯
Abe	阿部
Lewis	刘易
quân đội	軍事
Cao	驁
thanh thản	愔
Yêu và quý	熱愛
cày	犂
Philip	菲利普
đa số	大部份
chống lại	反
sách	簿
không kiên quyết	徬
Phía bắc	北側
Pha trộn	糅
rộng	阔
Xuyên qua	透过
bị ràng buộc trong một giải đấu	綣
Một nửa	塞米
tập tin	锉
đàn organ	机关
Tây An	暆
người vợ	妻
Cho	給出
Chi	箎
khịt mũi	歔
Cột	縱隊
nghi ngờ	疑問
cộng đồng	共同体
Tái sản xuất	重現
Thành phố mới	新市
phó tế	執事
Slack	苢
bất cứ khi nào	每當
nhảy	趵
Đá hoa cương	花岗
Yawan	亞灣
Di chuyển	感動
Amo	阿莫
Giám sát	监管
Sai Yu	賽於
Nhà công nghiệp	实业家
sơ tán	疏散
Ji	姬
Ủy ban	委会
Chỉnh sửa	整治
Hành vi tình dục	性行為
Pojiang	波江
nhiều hơn	多于
gián tiếp	間開
Gạo nếp	醸
Sui	睢
Ghế	座椅
nam tước	男爵
Đừng	甭
Cá chép diếc	鯽
nhà vua	国王
Roche	羅氏
Kyoto	京都市
Qi	秶
Bọ cánh cứng	蠪
Hum	嗡
giải pháp	解
Tuyền Châu	泉州
Tấn công	袭
núi	大山
Hỏi thăm	查询
dền	莧
Lục địa	洲
thúc giục	敦促
Tael	両
Trung Quốc	华
Yongzheng	雍正
nhẫn	环状
Tốc độ âm thanh	音速
giấy phép	执照
Thở dài	儖
Học hỏi	学习
Coi như	看成
Chỉ trích	批斗
quanh co	邐
Công tố viên	察官
chuyển	娩
Đến	徫
Ám sát	暗杀
Yi	侂
sẽ	將
Times	时报
Âm	猇
cỏ dại	耪
Lạch nhỏ	谿
trận chiến quyết định	決戰
Yehe	耶和
Xem xét	考量
Microsoft	微软
sa tanh	緞
tia hồng ngoại	紅外線
sân trong	庭院
Số Pi	埨
người Trung Quốc	汉语
Trạm kiểm soát	關卡
Jing	璒
hoạt động	动作
Thiên Hà	天和
Tấm	钣
Zhe	険
lót	裌
Sẽ là	會被
Đã sử dụng	用過
Xuất tinh	兼
Sẽ tham dự	會參
Cho ăn	饋
Qi	郾
Khởi động xe	运载火箭
Ngốc nghếch	泆
đặc biệt	尢
Xô	憓
ảo	虚拟
Đảm nhận	接管
Hu	喣
Kong	崆
thô	糙
giấy phép	執照
đảo ngược	逆转
Xi	硊
Súng chính	主砲
Huyện	該區
Của	的的
học phí	费
bánh mì sandwich	三明治
Hải nam	海南省
cả đời	一生
Dọc theo dòng	沿线
thanh toán	付款
Không thu được	未獲
Tháo rời	拆解
May thay	所幸
chi tiết	詳盡
Yemen	也门
Sông Hoàng Phố	黄浦江
Tochigi	栃木
chiều sâu	深度
Đỉnh	最高峰
Ert	尔特
Chùa Zen	禅寺
ba trăm	三百
Nhãn hiệu đầy đủ	滿分
gần đúng	近似
đỏ	红
Hoạt hình	動畫
tưởng tượng	幻
Nói chung	一般来说
gặp	遇见
Hu	瓛
điều này sẽ	這會
Mọi người	民眾
Nơi cũ	前所
bóng	陰影
Ánh sáng	軽
Đã được	在過
cướp biển	海盗
Zhu	雺
Địa điểm quan tâm	名胜
Sẽ thay đổi	會變
Nintendo	任天堂
Bao nhiêu	多少
Thị trấn Minzu	民族乡
nhân chứng	见证人
Shan	輏
Cho quả bóng	為球
nhiễm sắc thể	染色體
công việc nội bộ	內政
Trung Hoa cổ đại	古文
Biên dịch	編撰
gậy	杆
bản thảo	手稿
Xu	徐
Cả gia đinh	全家
Đá	磯
Giám sát	監視
dinh tổng thống	總統府
trong nước	國內
nói nhảm	唠
Số tiền	金额
Lịch sử	历史学
Estonia	爱沙尼亚
xương sống	膂
Cây bách	桧
bắn tỉa	鹬
mùi thơm	馝
Mái hiên đôi	重檐
Nhìn chằm chằm	觌
Xiangtan	湘潭
Tiết kiệm	儉
văn hóa Trung Quốc	中國文化
biểu tượng	徽
Fang Wei	方為
Tôn Trung Sơn	孫中山
gián điệp	狙
Có mùi	冶
Mao Ze	毛澤
những giọt nước mắt	泪
Đang đợi sách	等書
Chiếm đoạt	篡位
Nhựa dẻo	塑
Ulu	烏魯
Biết cách học	會學
Giả mạo	膺
Zhu	篼
Sau đại học	研究生
Ở Trung Quốc	驻华
Trại	坎普
Đảng Cộng hòa	共和党
Roman	罗曼
Thống trị	支配
săn bắt	蹑
Chuyển ngữ	音譯
Nóng bức	炎热
Giảm giá	優惠
chiếm lấy	捕获
Trang Chủ	家园
Y học Trung Quốc	中醫
chuyển khoản	轉投
chuộc lỗi	赎
nguyên	原来
nguồn	源头
Kar	喀尔
Nhân với	乘以
gián điệp	覘
mật	癭
Hát	凐
Đàn vi ô lông	提琴
Tỉnh	诺省
Shao	麆
chỉ có	唯
thẻ tín dụng	信用卡
Yi	乪
điều này	这项
nhiệt độ cao	高溫
Jiangdong	江东
nhà thờ	教会
cột	欄
Vòng loại trực tiếp	后赛
Indica	秈
Sâu	蠙
Bảo tàng Ju	館舉
xứ sở thần tiên	仙境
Nam TP.	南市
thắt lại	戋
nguồn gốc	根
Nghịch lý	誖
Chia tay	漎
dọc theo	沿
Cathay Pacific	國泰
cựu chiến binh	老兵
Glycoside	苷
Thơ	偈
thịt cừu	膉
piebald	騅
Lifu	立夫
Mẹ và con	母子
Xa lánh	鮾
nước mắt	撕
Đáp lại	回覆
súng cầm tay	火器
Tảo	藻
Mét vuông	平方米
Zhu	袿
nghiện rượu	酗酒
Thành phần hình ảnh	構內圖
Siwa	西瓦
vé	車票
giết chết	杀人
lồng	籠
Phân nhóm	分组
Al	阿尔
Người la mã	一個羅馬
Haba	哈巴
Xu Guan	許冠
hồi sinh	復活
Xinhan	新罕
Hậu cung	后宮
Cuối cùng	最后
Bảo vệ	警衛
phần lớn	多數
Cơ tim	心肌
Tiếp xúc	交往
ngái ngủ	睏
Pingshi	平氏
Xứng đáng	堪
Chen	鴃
Chúng ta	烏斯
Tổng quát hóa	概括
Devin	德温
Carolina	卡罗来纳州
Yan	塉
Dự án	專案
Xuất hiện trong	出現於
Washington	華盛頓
Sachsen	萨克森
tiệc	宴
Sau khi bị	後被
Dịu đi	紓
Qiao	礄
Độc thân	的單
Cân	稱
Theo	後隨
rào chắn	屏障
Hulunbuir	呼伦贝尔
Gặp gỡ	會經
Sản phẩm là	積為
Nitro	硝基
đường glucose	葡萄糖
Ống kính	镜头
chăn thảsông Mekong	放牧湄公河
Điều này	這款
Pha trộn	掺
Nao	崞
Douglas	道格拉斯
chuông	铃
Đổ	慿
Háu ăn	餍
Beijiao	北郊
Xi	岟
Máy ảnh	照相机
Baptist	浸會
Số năm	年号
Một mới	一個新
mở rộng	延長
Lá mùa thu	秋葉
Nông cạn	浅
chữa lành	医治
Vào âm thanh	入声
Basel	巴塞尔
Lá rụng	落叶
Dou Ling	兜铃
General Motors	通用汽車
Phôi thai	胚
Dưới	在下
khỏa thân	裸體
Buồn bã	竦
Sách về	之書
Thời gian họp	會時
ham muốn	媟
Ngọn lửa	火灾
Shaowu	邵武
Hồi giáo	伊斯兰
chớm nở	蕻
Nguyên nhân	事由
Krahow	克拉荷
chèo	帆
Lan	蘭語
Ghế trên	上座
xa xôi	遙遠
Xi	慭
nền tảng	平台
Hui	慧
Tiếp tục	續劇
Palatinate	普法尔茨
Nhà tù	關押
Đảo nhỏ	小島
Phù hợp	合乎
tủy sống	脊髓
Luisian	路易斯安
Đức hạnh	德行
sự độc quyền	垄断
đi	走
Maria	馬利亞
Còn lại	遗存
đảo chính	政变
Ngày hội thông tin	資訊節
Poplite	膕
Thượng nghị viện	元老院
Qi	遒
Thơ	诗文
Cái cày	畊
ồn ào	吵
khiêu khích	惹
quân đoàn	兵團
Đường đôi	复线
Lớp là	級為
Năm đó	該年
Cho sau này	為後
tỷ lệ tử vong	死亡率
cái rổ	畚
Nhìn chằm chằm	瞐
Sting	蟄
Rizong	理宗
Từ đơn	單字
Miệng núi lửa	火山口
người yêu	情人
Mộng thịt	胬
lừa dối	诖
Tiệc	鸤
tiêu đề	称号
trục	軸
Văn phòng công cộng	公职
Gabon	加蓬
Đa chủng tộc	多族
Thiết bị đầu cuối	航站
Ba phần tư	四分之三
Đo lường	量度
Uỷ ban	委託
Tiết kiệm	攒
giun đất	蚯
Jinjiang	锦江
sang trọng	奢侈
Tia	提亞
Nghĩ này	認為這
Yanzhou	兖州
Cắt bụng	切腹
Do chấn thương	因傷
Ren	丏
Huyền Tông	玄宗
Tục tĩu	褻
bào tử	孢子
Thủ công	手动
Bun Xiu	文秀
Giảm giá	塞爾
Tình cờ gặp	跸
Pasha	帕夏
Zhu	麢
chính trị	政治犯
Đi vào	入
vượt qua	十字架
nấu nướng	烹
Nava	纳瓦
Công nhân và nông dân	工农
nhà chứa máy bay	機庫
Nội suy	插值
Của hàng thực phẩm	食店
hói	秃
Tất cả mọi người	眾人
Thân hình	躯
tiếng súng	炮火
có thể nhìn thấy	可見
sự bức xạ	放射
Hoa vang	金花
Đặt dưới	劃歸
Minnesu	明尼蘇
Từ lâu	早就
Sống động	活潑
Phía bắc	北邊
Peter	彼特
Yi	羿
không khí	大气
ghi âm	记录
Sinh viên quốc tế	留学生
đĩa DVD	影碟
Quốc tịch Yao	瑶族
Người lần	人次
Nanzheng	南征
tóc	髮
vi khuẩn	細菌
Trận đánh	格鬥
Bưu chính viễn thông	邮电
tối	黑暗
Nam Xương	南昌市
đã sử dụng	慣
Linyi	临沂
chạy không tải	颟
Chân động vật	獸腳
hấp thụ	吸收
pháp luật	法則
Cùng kỳ	同期
cho tình yêu	為愛
đường sắt	鐵路
khen ngợi	称赞
Nếu và chỉ	当且仅
Xe cộ	車種
tỷ lệ	比重
Dài	昣
chức năng	函数
Vốn dòng	線資
Fang Jian	坊間
Seoul	汉城
màn	篩
Trận đấu	賽事
Mạnh	強勁
Làm lại	重拍
Gọi	致電
Lou	蒌
lãnh đạo	领导人
Khởi chạy trang web	发射场
nhà nguyện	礼拜堂
đờm	痰
Tai nạn trên không	空难
Dốc	坡地
tàn sát	宰
Một	其一
Âm	剦
phong cảnh	景觀
bia	啤
Thêm vào	加設
Nếu vậy	若以
Shitamachi	下町
Kỹ sư trưởng	总工程师
Ngoại ô	郊外
khối u	瘤
Khuyến khích	囑
Toma	托馬
Tàu điện ngầm Cao Hùng	高雄捷運
cái cằm	頦
Cao	高架
Được gán cho	归于
Cực kỳ cao	極高
Bắn	枪杀
ít nhất	至少
Tokuyu	德裕
thở dài	惋
Allen	艾伦
Thay thế bằng	換成
Vé	门票
Instein	因斯坦
Nét chữ	字形
nước Anh	英格兰
Nhanh chóng	捷
Hen	襀
sông Ngọc	珠江
Dịch vụ ưu tú	功勋
Dai	埵
Minh châu	明州
Tai nạn	意外
Mississippi	密西西
nhọn	锐
Wei	潿
Cheng	鋮
Linh hồn	心靈
vật lý	物理學
Danh sách các từ	字表
Jue	珌
nguyên	原先
lính	士兵
Tầm nhìn	視野
Áp đặt	施以
Trung học phổ thông	高中部
Bao	葆
Béo phì	膆
Tây Bengal	西孟加拉邦
đặt	放
Turin	都靈
Jesus	稣
Quận trưởng	知府
Sống sót	生還
Pan	殚
Thú y	獸科
nút thắt	纥
Rình rập	薸
Can đảm	勇敢
Được	結為
Ghi lại	录制
Sơn	彩繪
trưởng khoa	院长
đồ sứ	瓷器
Đến	遡
khoa trương	嘐
So sánh	在較
cắt	斷絕
chuyển khoản	移交
Quân đội và	軍及
sơ yếu lý lịch	簡歷
Tiến lên	動於
một số	好几
ban đầu	本来
Trước khi chết	死前
Hoang tàn	棤
Vĩ đại nhất	最偉
Luo	洦
Khu vực quản lý	管理区
chiếc phà	船
tiếng ồn	譟
Ủng hộ	人情
khỉ	猕
Ji	畿
Cây ăn quả	果树
ẩn giấu	藏匿
Địa từ học	地磁
Loài	种
Gạo nếp	榞
West End	西区
Leby	萊比
Guangdi	光帝
phân tán	頖
Grin	咧
Lực lượng liên minh	联军
Xoắn	扭
Reagan	里根
Một phần	局部
và nhiều thứ khác nữa	等等
Cùng cha	同父
huyết áp	血压
Phun	舤
tường lâu đài	城垣
Howard	霍華德
chốt	閂
Trú ngụ	棲息於
chỉ có	僅僅
Ryan	瑞恩
Mãi mãi	永
Bảo vệ	護衛
Mở ra	闢
Tỉnh đặc biệt	特省
Để làm cho	來作
ném bom	轟炸
Sững sờ	懍
Yi	鞥
Vị trí	選址
Lower Saxony	下萨克森州
trò đùa	玩笑
Quán ba	楎
Đồng	青铜器
yêu cầu	宣称
cái cốc	觯
chiếm	占据
Hoàng đế	天子
sớm	早
Đường đi bộ	行道
Làm lơ	忽視
CUHK	中大
Công bố	发表
Giang Tô	江苏
Neptunus	鎸
kẻ thù	敵人
Trường di chuyển	動場
Yikuni	義國
bất động sản	产权
Di chuyển	動裝
Gao Jia	高加
Ngáp	儹
Kích động	風潮
đẻ trứng	产卵
Chơi	發揮
Yun	赟
Thuê	租用
fomanđehit	甲醛
Chức vụ	立场
Chuỗi	字符串
Bỏ cuộc	作罷
Cấp dưới	屬下
Sri	斯里
địa ốc	房地產
con bò cạp	虿
gia tinh	魍
Lăng mộ	陵寝
Ying	瓔
Rang	穰
Hát	淴
Mozart	莫扎特
kỷ nguyên	時代
Được	取得
Phát triển, xây dựng	衍
Massachusetts	麻省
Phiền muộn	坳
Catkin	袑
Esperanto	世界语
hữu nghị	友情
Đường sắt nhẹ	輕軌
nồi	壶
ngay tức khắc	即時
Thập tự chinh	討伐
kết thúc	終點
Ngày 26	二十六日
da	皮革
Như	作爲
Qiong	邛
Ling	廴
Kasuga	春日
tương tự	一样
Bolsh	布尔什
Yu	萹
Dongpo	东坡
Ngôn ngữ Tây Tạng	藏语
Trưởng	首長
Pai	貃
Tên Cu	舊名
đàm phán	談判
ngựa để chuyển tiếp công văn	馹
Nền tảng bên	側式月台
Nhập cảnh	入关
con chuồn chuồn	蛵
Cheng	丞
từ chức	辞职
chuyển khoản	传递
lỗ hổng	缺口
cô	姨
Vịnh nhà	家湾
cai trị	裁决
đặc tính	特徵
gặp	會合
Văn phòng chi nhánh	分公司
Thế giới ngầm	冥界
rơi vãi	落
Thoát khỏi	除掉
Trở lại	背部
Đảng Dân chủ Tự do	自民黨
Tât nhiên	咄
Ngỗng	鵝
Kushiro	釧
Yu Wang	於網
tiết kiệm	拯
Đã chứng minh	探明
Tuyển dụng	用人
Bang	擖
Mảng bám	匾额
chung	普
bộ xương	骼
Parkinson	帕金森
khí ga	氣體
Phúc kiến	福建
nhựa dẻo	塑膠
buổi sáng	早上
lòng bàn tay	榔
Bấm vào	点击
cadimi	鎘
chạm đến	伤口
citron	櫞
Cá	鳯
Tỉnh Osaka	大阪府
dựa trên	基于
trứng kiến	蚳
màu xanh da trời	藍
Asahi	旭
Tổng quat	概况
vô hiệu hóa	中和
Thành phố	该城
Hoắc	霍
Nhúng	沾
Jin	缙
Gan	赣
sao Thổ	土星
sấm sét	悺
Loach	鰍
Quận Đá	石區
Học	就讀
năng suất	讓
Phun trào	噴發
chuyên gia	知识
Chữ ký	簽名
Hal	哈爾
Crystal Palace	水晶宮
Gdan	格但
con bò cạp	獦
tiếng xì xì	嘶
triều đại nhà Thanh	清朝
tranh luận	论点
Thiểm Tây	陝西
từ vựng	词汇
Lập bản đồ	映射
thủy ngân	水星
Timor	帝汶
Rãnh	凹槽
Nhà tổ tiên	祖籍
Công việc mới	新作
Con voi	大象
Mussolini	墨索里尼
Yi	埱
Hồng Kông và Ma Cao	港澳
Chính quyền nhân dân	人民政府
Ngành công nghiệp	實業
Vôn	電壓
Vatican	梵蒂冈
Qua eo biển	两岸
Lời bài hát	作詞
nhà văn	作家
liên hiệp	联
Trận chiến	會戰
phần lớn	多半
Học viện	學府
Annan	安南
Cộng hòa	共和國
Giỏi về	擅長
Yenching	燕京
rung chuyển	晃
khóa	扣
Giáo sư	教授
Utah	犹他州
Yale	耶魯
sự thông báo	公告
Ani	阿尼
Con nai	獛
Chống sửa chữa	反修
cá đối	鯔
tối	暗
Tan	晘
Homer	荷马
Chi nhánh	分店
gọi	喊
sự nối tiếp	序列
Thứ chín	九世
chế độ độc tài	獨裁
Chúng tôi nhập	們進
Quận Gu	古县
Tiếp thị	行銷
quặng sắt	铁矿
sao lùn trắng	白矮星
Tát	肄
tranh luận	辯論
Cứu giúp	帮助
dịch bệnh	病
Video	錄影
Đồng hành	伴
Bingxu	丙戌
tai họa	鼠疫
Nhân Viên	職員
Zhen	軫
Beidou	北斗
Đồng	金文
Nhật Bản và Nga	日俄
Đimetyl	二甲基
động vật có xương sống	脊椎動物
đảng cộng sản	共產黨
Wai	嗼
Là	的是
Kublai	忽必烈
Lang	崀
Quách Công	国公
Nét chữ	字體
Đường sắt nhẹ	輕鐵
đào	掏
kho báu quốc gia	國寶
tinh trùng	精子
khăn xếp	鞨
bờ Nam	南侧
Burt	伯特
sắp xếp lại	重排
Công nghiệp hạng ba	第三产业
Vây quanh	围
kịch	戲劇
bao la	浩大
nguyên tử	原子
Zhu	朘
Thẻ giải trí	悠遊卡
Đóng lên	拢
kiểm tra	检验
Jiangdao	江道
Âm	埿
Peng	鵬
Outfield	外野
Chung tay	聯手
Thứ năm	五世
Ston	斯頓
Rong	鎦
Đạo đức	德
Người Hán	汉人
Cản trở	檃
cây lau	蘆
Tôpô	拓扑
Murray	莫瑞
Luo	鸊
Hậu hiện đại	后现代
cứu sinh	救生
Ying	頏
Wow	妗
nheo mắt	瞇
Hội trường chính phủ	政厅
thân cỏ	莛
Chuyến bay	班機
Weiwei	為維
Không cho phép	不容
Diễn tả	描
thứ mười tám	第十八
Nhạy cảm	敏
Dung môi	溶剂
Học hỏi từ	學於
Ống cực	极管
Wade	涉
điền vào	窴
Tỉnh Sơn Đông	山东省
Thảm khốc	浩劫
Ngây thơ	天真
Sha Tin	沙田
Chiến tranh Thế giới II	二戰
Mora	莫拉
Holmes	福尔摩斯
bột	粉
Bao gồm trong	收錄於
Cuộc họp cũ	老会
twitter	喳
Họ cá	魚科
Thơ	詩詞
lộ trình	路綫
nứt	呖
Buenos Aires	布宜诺斯艾利斯
Ủy viên Hội đồng Quận	區議員
Hal	哈尔
Buồn phiền	娑
dấu	标记
Những sản phẩm nông nghiệp	農產
đồng	青銅
guanidine	胍
năm đó	那年
Cú	鸮
Dòng chữ	碑文
Trẻ	扬
người sưu tầm	收藏家
Trường đua ngựa Sha Tin	沙田馬場
Thiếu sót	欠缺
Thông và cây bách	松柏
Dichotoma	萁
Jianshan	尖山
học phí	学费
Môn số học	算术
người quen	相識
Jianghan	江汉
Khai Phong	开封
Ontology	本體
Chính trị	政教
theo dõi	追蹤
Suy sụp	垮台
Hợp lý	有由
hoàn thành	完備
buổi tiệc	当事人
Và	與第
Yu Minguo	於民國
phụ âm	輔音
Trông giống như	样子
Người làm	人造
Cặp quân nhân	軍對
Lốp xe	泰爾
do dự	踌
Yao	仾
Tu nhân của chiên tranh	战俘
tiên phong	先驱
Tianzhu	天竺
Miệng nước	水口
thỏi	錁
khéo léo	儇
nó hoạt động	有用
Đến	逥
bên cạnh	旁
Ti	垪
Giáo viên	師資
Thương tiếc	慬
Phụ thuộc vào	視
Kế hoạch bài học	教案
Bực bội	愻
Naha	那霸
hạn chế	約束
Gai cứng	硬棘
Được rồi	莱特
Congzhong	丛中
Sống ở	居住于
Sông Tiền Đường	钱塘江
Garrison	屯兵
Marlene	马列
nịnh nọt	妩
Thế giới	人世
Khả năng lãnh đạo	领导层
Vật rất nhỏ	颗粒
Tong	彤
Năng lực	才華
Đứng trên	立於
Để tránh	為免
chiếm lấy	跴
người đàn ông tốt nhất	儐
Lu	瀘
Thời trang	時裝
Bắc và Nam	南北
Sinh ra	天生
phòng bếp	竈
bằng cấp	文憑
hiếu thảo	孝
ngọc bích	琭
Âm	猔
màu xanh lá	绿色
Công nhân và Nông dân Hồng quân	工农红军
Cấp độ đầu tiên	首級
Cathay Pacific	國泰航空
Đặt hàng cá	魚目
Xi	钖
Williams	威廉斯
chuyển	输送
kiều mạch	蕎
Leah	利亚州
Nhóm bàn	表團
Shunji	顺治
Bôi trơn	抹黑
Trồng cây	种植
Đội tàu kết hợp	聯合艦隊
Tam giác	三角形
Hy vọng tốt	好望
Bệnh tiểu đường	糖尿
Âm	龝
Biển nội địa	內海
Người máy	器人
Giỏi về	擅
John	翰
Sâu	蝘
hẹp	狭
biên độ	振幅
Đánh nhau	争
nỗi sợ	恐懼
bộ lịch	砑
Bing	鴂
hạn chế	有限
Khớp nối xương	髁
Xianbei	鮮卑
phổ cập	普遍
đến	抵达
Ngư dân	渔民
Lấy được	派生
Phong cách mới	新式
Huh	寗
Tỷ lệ sử dụng	用率
Du kích	游擊
Giành chính quyền	夺权
Tấn	郇
Chuo	綽
Pipi	騹
ấu trùng	蝤
báo cáo	汇报
Rwanda	卢旺达
túi treo từ thắt lưng	裢
tâm trạng	情緒
Độc quyền	专属
đứa bé	宝贝
Zeng Guo	曾国
Tang	蔤
cửa	门
Không thay đổi	康斯坦
Âm	堦
Trường Cao đẳng	高校
thiên tai	眚
kỹ lưỡng	徹底
cacbonyl	羰
Ante	安特
Gan	肝
Xuân	烜
bảng điểm	抄本
khác thường	异常
đó là	就是说
Hiệp sỹ	騎士
Kiếm sống	為生
sử dụng	用
Tặng kem	奖金
Colombia	哥倫比亞
nhà ở	议院
Nhưng đối với	但為
Berea	伯利亞
Sau chiến tranh	戰後
Hua Hua	花花
Kuwait	科威特
Uruguay	乌拉圭
Ontario	安省
vấn đề	事项
Còng	枎
ném vào sự nhầm lẫn	攘
Zuozong	左宗
Như	当做
chính quyền	国民政府
Rác rưởi	圾
Siyu	斯於
Văn phòng	務處
Tugu	吐谷
hủy hoại	摧毀
Chia đều	平分
Chịu	担负
Ủy ban Thường trực	常务委员会
Nhập tịch	入籍
đối ứng	倒数
Ban hành	颁布
thay đổi	变更
Sẽ mang	會帶
Nền tảng	站台
mục đích	瞄准
Hạt Xie	潟縣
Hoàng tử	普林斯
Ngăn	廂
bảo vệ	警备
Phụ	洘
Thực lực	實權
bạc	銀
Định nghĩa	定义
Lộ ra	曝
Xây dựng Tổ quốc Dân chủ	民建
Đại hội thể thao châu Á	亞運會
bản ballad	民谣
Đội	隊隊
Hiền nhân	耊
sói	狼隊
Chi	啽
ngày thứ ba	第三
Jianmin	建民
Tổn thương	病變
biên giới quốc gia	国界
Bligh	布莱
Cây ngang	襣
Tự lập	自創
Taji	塔吉
Thượng Thư	尚书
Phần trên	上部
Tháng sáu	峻
Daewoo	大宇
Ủng hộ	扶持
Đại hội	總會
Quê nhà	回乡
làn đường	巷
Cygnus	天鵝座
Anh hùng	英雄傳
Bị lây nhiễm	感染者
Ao	嶴
Collins	柯林斯
bình đẳng	平等
Truyền hình vệ tinh	卫视
dữ dội	劇烈
mỗi	各
Bắc	北部
Đàn Trung Hồ cầm	大提琴
Ne	訥
Ô cửa	門口
Coro	科罗
điều khiển	控制
Tiệc	鳲
Sông nước	水河
Thành phố Tế Nam	济南市
Jim	吉姆
đi hành hương	朝聖
Nhóm tiệc	黨組
tỷ lệ	率
vai trò hỗ trợ	配角
phi	丢
tây nam	西南
quan hệ	親戚
Ito Hirobumi	伊藤博文
giỏ trái cây	笾
Sự vụ	事务
Re	重新
R & D	研发
Mặt tiền	前列
Tát	燵
Kỉ niệm	回忆
ngày Quốc khánh	国庆
Được coi là	算是
Huân	嬛
Học hỏi	學及
xenon	氙
Cục khí tượng	氣象局
Co giật	璵
vàng da	疸
giống	雷同
vách đá	峭壁
vùng ôn đới	溫帶
Xiao	蕭
Công nghiệp nặng	重工
loại bỏ	消除
quý bà	夫人
hơi thở	气息
soái ca	元帅
lớp học	班
cây tre	竹子
Truyện	艋舺
Xã hội	社
Ít hơn	減
Emperor Yan	炎帝
North Rhine West	北莱茵威斯特
trường đại học	大學
Nian	鷇
quyền con người	人权
Ling	菱
Tám mươi	八十年代
thư viện	圖書館
Fengtian	奉天
con trai của	之子
hàng tuần	週刊
Thông thoáng	清晰
phụ âm	子音
Jian	阇
Hướng ngoaị	出线
Pan	葃
Hỗ trợ	辅佐
Trong cuốn sách	書中
Bộ trưởng bộ quôc phong	国防部长
Bắc Kinh	北京市
Xueliang	学良
Trục xuất	開除
Truyện tranh	漫画
Dòng đầu tiên	一線
Khóa	龅
Nanyue	南岳
Giao hàng	送交
Ý nghĩa	含义
Số tiền là	額為
trường cũ	母校
Nao	垴
phước lành	福
sự tái tạo	再生
rượu ủ hai lần	醾
đại sảnh	大厅
Yun	耘
lãnh thổ	領土
tiêu đề	稱號
Xilin	西林
Đen	黭
Uptrack	上溯
nhân	乘
tà ác	奸
Boston	波士頓
Kera	蝼
Kanda	神田
Các tổ chức học cao hơn	高等院校
Yi	伹
Che	封面
Lỗ	腔
sợ	怕
người Pháp	法式
Cây thông	枞
thù địch	敵對
tối	阴暗
Ghi chú du lịch	遊記
đau đầu	头痛
Dinh thự	豪宅
từ	以來
Torres	托雷斯
Taoyuan	桃園
tạo ra	生成
Một loại	一種
Di sản	继承权
Giác ngộ	啟示
Muối	鹽
Lịch sử đảng	党史
Sunan	苏南
Min	珉
Lên dốc	上山
đảng phái	黨人
ngôi đền	圣殿
video	視頻
Lo lắng về	榃
Uganda	乌干达
Phía dưới	低於
tức thì	瞬
gấp ba	三重
Rượu sâm banh	香槟
quyền lực	大权
Alan	阿兰
Xấu hổ	淏
giấy	论文
Cải bắp	菘
Shi	眡
Thực hành	實務
Và phía bắc	與北
Có thể	能為
Daoguang	道光
Turin	都灵
đỉnh núi	山顶
Hãn quốc	汗國
vết sẹo	疤
Dẫn điện	傳導
Mô hình xe hơiKiệu	型车轿
côn trùng	昆虫
rực rỡ	華麗
Mạnh	彊
Hẹn một lịch khám	了約
Những vị khách mời	客人
Yêu cầu	主张
Mông Cổ	蒙古人
Yi	詒
ven sông	河沿
Thiếu oxy	缺氧
Bộ Công an	公安厅
Các biến thể	变体
Deserter	荒者
giết chết	僇
Nhà xác	殮
Tiền giấy	紙幣
Lãnh thổ mới phía đông	新界東
Hộp số	变速箱
Khả năng chạy	行性
muốn	通緝
Thẩm quyền	權限
Biển Đông	南海
Oran	奥兰
Netizen	網友
sợi chỉ	緖
vĩ độ	纬
Hu	豿
Bunker	碉堡
bí mật	秘密
Bulbul	鵯
ngột ngạt	悶
Phản công	反攻
toán học	數學
khí hậu	气候
thích hợp	適
Nét chữ	體字
Leon	利昂
Đẩy lên	撆
Quần lót	褡
Qi	秾
Đồng nghiệp	会士
Nitta	新田
tai Chi	太極
bảng	闆
lớp học	類
sẵn lòng	愿意
Toma	托马
bẻ cong	拗
lý do	缘故
Cái đó	那個
Cơ động	机动
Fred	腓特
Lu	渌
Pu	鶖
Đi xuống	下来
do dự	踟
Dân số gram	克人口
Ga thị trấn	町站
ghê tai	濇
Hàng triệu	数百万
vườn	園
Bạn diễn	合演
Ye Liu Shuyi	葉劉淑儀
nhung	絨
Pal	帕爾
nguyên nhân	引起
nỗi sợ	恐惧
Át chủ	埃斯
Trở về nhà	返航
viết	编写
Nâng cao	进会
đậu xanh	豌豆
Sau khi chết	過世後
dinh tổng thống	总统府
Tangjiang	塘江
gà tây	土耳
lẻn vào	潛入
Khu dân cư	住宅
huy chương	獎章
Johnson	约翰逊
Hoàng Phố	黄浦
sợ hãi	猲
Qi	継
Hát	飮
sáng kiến	主动
thỏ rừng	野兔
trước mặt	前线
Bắn cung	射箭
Dương	汸
giết người	謀殺
Monta	蒙塔
Quân đội Kwantung	关东军
Nghệ sĩ guitar	吉他手
Ký ức	記憶體
cảnh sát	警
Sau đó	後則
Số ba	三位
Ban giám đốc	董事局
xe	马车
dạy	誨
sau đó	接著
tạm thời	临时
Sogdian	粟特
hệ thống	体系
Zhan	杘
Áp dụng cho	應用於
Lời thú tội	宧
xà lan	駁
Khu rừng	林区
quí	珍貴
Renhe	仁和
Tốt	贐
lũ lụt	洪
hạt giống	籽
Phong chinh	正室
Các mặt hàng	貨品
Thắng kiện	勝訴
Cà vạt	逹
ở phía sau	在後
sân	院落
xà gồ	檩
Ủy ban quân sự	军委
Yong	剢
bài đăng	邮报
Gunsan	群山
Bắt vít	伯苓
vườn bách thú	动物园
lũ lụt	汛
xoay	转
Rào	闒
Sa mạc	荒漠
Bắt đầu chụp	開拍
Ở New York	在紐
cánh tay	臂
Tầng hầm	地庫
một lát sau	往後
Zurich	苏黎
Bưc tượng Phật lớn	大佛
Đây	此處
Cạn kiệt	耗盡
tiềm năng	潛在
nhà máy rượu	酒厂
Di chuyển	動會
đặc ân	特權
Lông	海爾
Yoga	瑜伽
sự tương thích	兼容性
Bị đánh bại	战败
lông vũ	羽
Trân trọng	敬
Y khoa	毉
khoa học đời sống	生命科学
Mất đi	失传
Bún	饃
trái cây	果实
Kho	倉庫
Các lực lượng đặc biệt	特種部隊
Nhóm quân	集团军
Essex	艾塞克斯
Nhân viên xã hội	社工
giải cứu	營救
cho	对于
Tiao	灄
cán cung	弣
Cháu trai	甁
Cập nhật	更新
Đầy tham vọng	有志
Trên tàu	船上
Ngoài khơi	外海
biên giới	边境
Khi nào	時獲
yên tâm	放心
cá nhân	单人
cấp	等級
Fernan	费尔南
Danh lam thắng cảnh	景点
kiểm tra	試
bài đăng	哨
Bo Xilai	薄熙来
Người israel	以色列人
Trung Quốc ở nước ngoài	华侨
Nhiều	地段
Phức tạp	复合体
Dép xăng đan	屨
Dòng sông màu vàng	黃河
bắn	開槍
Khách mời	嘉宾
Sting	韲
Tải về	裝
hẻm núi	峡
Và sẽ	並會
Viêm màng não	膜炎
thallium	铊
nhà ở	豪斯
đầu lâu	顱
đồ lặt vặt	脞
tích lũy	堆积
Beihe	北河
Tổng quát hóa	广义
Zheng	蜧
chuyển khoản	转移
Bảng điểm	謄
Qi	綕
Yong	凟
Trình độ	度使
Whit	惠特
Ca sĩ	歌星
Giết chết	弑
đèn neon	氖
Impatiens	凤仙花
xuất sắc	卓越
tình hình	現況
Ina	稲
Núi và sông	山川
Truy tố	檢察
Phân phát	散发
Cao cấp	耆
Tên quận	县名
Volo	沃洛
học viện	学术界
kéo	拖
tài giỏi	巧妙
Giàu có	里奇
Hu	禇
Phong cách	风格
Shigechen	重臣
Antonio	安东尼奥
du lịch	旅遊
trẻ	年青
Để sử dụng	以用
Kêu la	嚷
Tài khoản	账
Wei	韡
van xin	乞
Chọn	寀
một nửa	半数
khác thường	畸
Sina	新浪
Gad	加德
Kowloon	九龍
Curie	居里
kẻ trộm	贼
Giả sử	為設
trẻ	年輕
Nếp	胋
chuột	鼠
Phổ biến	走紅
lựa chọn	選擇
Báo cáo	报道
mật	瘿
Li	楩
Qian Yan	前燕
thành phần	組成
Doanh nghiệp	企
Phát thanh	播出
Chương trình	綱領
Weimar	魏玛
ao	池塘
Âm	餠
Chuỗi cửa hàng	連鎖店
Hoàng Phố	黄埔
hội nghị thượng đỉnh	首腦
Nước nóng	热水
Ổn định	落户
Hình nón	錐
Gui	桂
Jiang Jie	蔣介
suy nghĩ	以為
Hơn	比的
Kinase	激酶
xác minh	驗證
Quyền lực	权势
Nhưng hai	但兩
viết	写
Sẽ được bởi	將由
Quân đội	军军
FireWire	火線
Hạt Pu	浦县
chùm tia	粱
Quận Đông	東區
ảnh hưởng	影响
Phi hành đoàn	剧组
Sự an toàn	安全
chuyên gia	专家
sức mạnh	實力
Abutilon	檾
bao cao su	避孕套
Thỏa thuận	成交
Ý tưởng	概念
đêm	夜
Kinh Aham	阿含經
Ủng hộ	青睐
xé xác	稊
Rini	里尼
NATO	北约
Đảo hải nam	海南岛
Đắc thắng	凯旋
Olympic	奧林匹克
Nơi sinh	发源地
khởi đầu	起动
Trụ sở chính	本社
Nửa tươi	鮮半
Lu	禄
tốt nghiệp	毕业
Tham gia	並參
Drôme	德龙省
chống lại	針對
đói bụng	饑
vỏ sò	貝
súng lục	手枪
Huy hiệu	纹章
Jin Dai	金代
Bún	麕
Một bên	一侧
Chuyến bay thử nghiệm	试飞
Cố gắng lên	尽量
đào	挖
Joseph	约瑟夫
Tứ xuyên	四川
chế độ ăn	飲食
móc câu	钩
trường học	校
nổi danh	有名
Saibai	塞拜
Lưng ngựa	驎
Vicchi	维奇
Chín mươi	九十年代
đáy	底部
Núi Wutai	五台山
Sau chiến tranh	戰爭後
Sắc lệnh	詔
Thắng lợi	崬
kết thúc	完結
Giám đốc	理人
cơ chế	机制
pha trộn	糁
con chuồn chuồn	蜓
bàn luận	商討
mối mọt	白蟻
Núi đá	山岩
Giám sát	督
sự suy luận	推论
hư mất	淪
Lắc	莎士
Trận đấu	際賽
Phương thức nhập cảnh	入法
Thay đổi đồ thị	变化图
Axolotl	螈
Văn học dân gian	民俗
Lá mầm	子叶
Cuộc điều tra	侦查
nhãn	標籤
dày	垕
Số ba	三條
chỉ	甫
Yêu cầu	自称
trang mạng	网站
vừa lòng	衎
áo lót	胸罩
New England	新英格蘭
Khoa Văn học	文系
Cũng thế	也會
kênh	航道
Tình dục hóa	性化
qua lại	來回
xí nghiệp	企業
Đầy tham vọng	心勃勃
vitamin	維他命
Jian	鑒
Mạnh mẽ hơn	較強
Khai báo	宣示
sản xuất	出产
niêm phong	缄
phát ban	疹
Cân bằng	扳平
chậm	緩慢
Hiệp sỹ	封爵
Họ Caryophyllaceae	石竹科
Abo	阿博
Tong	伉
Ý nghĩa	内涵
con tem	戳
Ngủ	睡眠
bao gồm	包括
Mùa thường xuyên	常规赛
Bình Nhưỡng	平壤
Rối	逎
Phương tiện truyền thông	传媒
Sức ép	施壓
chinh no	本身
tình hình	形勢
sờ nắn	悸
Zhu	潴
mua chuộc	赂
Phần này	該節
khoe khoang	詡
Tiểu bang	邦国
Tuyến quận	區專線
chim cốc	鸕
Tìm thấy một trường học	創校
Xưởng đóng tàu	造船厂
Ur	烏爾
ẩn	隐
phanh	闸
Bất lực	無奈
Tát	跐
rực rỡ	燡
Đô đốc	上將
Căn cứ	基座
thợ mộc	木匠
hàng rào	笆
Ngày mai	明天
Dài với	長與
Zhang	仉
Cornell	康奈尔
Lặp lại	迭代
khớp nối	耦合
Noru	諾魯
Nhiều mưa	多雨
Đường biển	海路
Tàu	舰
Nate	内特
Vắt kiệt	摋
Chúa tể	勳爵
Trận chiến	会战
Giảm đáng kể	大減
Đính kèm	附設
nhập cảnh	条目
khá	頗
Trung học phổ thông	高一
Alp	阿尔卑
bàn là	鐵
Chun	圳
quay lại	回来
Vũ Hán	武汉市
tôi yêu	我愛
Người qua đường	路人
Chào	哎
Akane	茜
Bộ	置
Dmitry	德米特里
cái ghế	椅
Âm	釴
Đảo chính	本島
Đổi	皈依
Luzon	呂宋
Hoàng đế nhà Hán	汉武帝
Don	丼
giả mạo	流氓
trị vì	在位
Glycoside	甙
màu vàng	黃
Chính quyền quận	縣政府
Phiên bản mới	新编
săn bắt	追封
Nimes	尼姆
Chào	樋
xinh đẹp	优美
Bảo vệ	警卫
Cũng được biết đến như là	亦稱
Bằng ngôn ngữ	語中
bộ sưu tập	汇集
Đại Luân Đôn	大倫敦
luồng không khí	氣流
Wisconsin	威斯康辛
Mục tiêu	入球
Jinpu	津浦
Lisan	利桑
Ngọc bích	稑
Tổ chức	寄主
scandium	鈧
Artemisia	蒿属
trường trung học cơ sở	初中
bát	椀
Giàu có	里希
Người ta nói rằng	据说
Brahma	婆罗
bệnh lao	痨
thành phố	城池
Nam tới	南至
pháp luật	法则
chặt	斲
cây tre	箂
Cập bến	停靠
Chân thành	诚
Nhát	腼
Mellon	麥隆
Bian	洤
Lou	娄
Chất thải	廢
mũ sắt của lính	胄
Tòa nhà chính	主楼
lấy trộm	竊
Jian	鑑
Chi	個屬
Tham quan	來訪
Bộ lạc	支派
bờ biển	沙灘
hạn hán	旱
N: Xứng đáng	功績
Christopher	克里斯托弗
Xiaomi	小米
Gasgar	加斯加
Quyết toán	定居点
tàu chiến	军舰
Âm	颎
nhóm	组
Đền thờ Khổng Tử	孔庙
Ston	士頓
Điều khiển	對照
Submode	子模
Môn học	主旨
Dingdu	定都
ma sát	摩擦力
Ông già	老人
Hiệp hội	協
Chứa đựng	所載
Shi	浉
Quay	旋
Micron	微米
dơ bẩn	骯
Xấu hổ	尷
Tiền giấy	纸币
Pyridine	嘧
Nghiệp	噶瑪
Trang sức	珠寶
thông thường	平常
Khinh bỉ	謔
Cá bơn	鲆
Bulbul	鎹
Twips	缇
Xu	美分
Đạt được	已達
tiếng Nga	俄語
cuộc nổi dậy	起義
Triều đại Qin	秦代
Mặc xuống	下穿
Bóng đá nữ	女足
Tro choi	該賽
Điểm nổi bật	花絮
bỏ trốn	遁
Đột nhiên	骤
Yu	魋
Chúng tôi	阿雷
Shao	曺
lỗi	纰
duy trì	維持
Mặc dù	縱使
học thuyết	教义
tời gió	轳
Đau khổ	受到
tổ tiên	祖先
Được lưu	得救
nhà gỗ	平房
Tệp mạnh	强档
khó khăn	困難
Cháu trai	姪
Hải quân	水師
Sao chép	山寨
Kỳ nghỉ	休假
Xuantong	宣统
Với	附有
Nga	俄國
Nhà sư	修士
Toàn bộ cuốn sách	全書
máy lạnh	空調
súng cầm tay	槍械
Binh thương	休闲
Thầy tu	神父
Solomon	所罗门
Bali	巴利
Sansong	桑松
Yu	萫
góc	陬
Bão nhiệt đới	為熱帶風暴
Đường Zhongshan	中山路
Cảng cá	漁港
Tấm	鈑
Tây tạng	藏族
Trung đội trưởng	排长
nghĩa vụ quân sự	兵役
Đề cập đến mọi người	指人
cái thước	统治者
Tàu ngầm hạt nhân	核潜艇
Hoạt động	活动
Nói dối	臥
Trước nhà Nguyên	元前
yêu cầu	宣稱
Xizhimen	西直门
Lực lượng vũ trang	武装力量
viền	轮廓
Bayan	巴彦
hố	穴
Nông cạn	淺
Shikoku	四國
mở và làm sạch	刲
Xuân	犮
Zang	臮
Tổ chức	憲法
Xe buýt	公交
biển	海
Qiao	谯
Kashi	樫
Kubi	忽必
hệ thống	繋
Bắn cao	高射
Quanh co	蜿蜒
áo choàng ngoài	褂
Bucky	巴基
hẹp	隘
Sợ hãi	害怕
Kamchatka	堪察加
cơ chế	機制
người Trung Quốc	华语
Ngày làm việc	工作日
bánh ngọt	餑
Thừa kế	承
Nội dung	内容
cám	麸
Hào hiệp	俠
Và suy nghĩ	並認為
Titan	土卫
Rong	鋺
cảm thấy	覺得
in lại	再版
bán đấu giá	拍賣
Tai'an	泰安
Lun	侖
Tưởng	蔣
giả định	假定
Cher	切尔
nhiếp ảnh	攝影
nghiên cứu	考證
thối rữa	爛
Sui	蔍
Cả hai mặt	兩邊
Ngọc nữ	玉女
đột ngột	忽
Điều này	這支
đồ gốm	缶
giẫm đạp	跫
Chương trình	程式
Wu Zong	武宗
tấn công	抨擊
Chúng ta	乌斯
Vệ Đà	吠陀
hơn	更
Thành viên nhóm	組員
nhà tù	牢
Xử lý	應付
Songhu	淞沪
Tan	栌
Codney	蠒
tuyên bố	陳述
chuồng lợn	圊
Heshuo	和硕
Sykes	塞克斯
Halle	哈雷
Perot	佩罗
Kwai Chung	葵涌
Đa dạng	各項
bẩn thỉu	齷
Chủ tịch	委員長
tim	内心
Kirk	柯克
Với cái này	以此
động vật có vú	哺乳动物
Sử dụng	动用
Starbucks	星巴克
ổ đĩa cứng	硬盘
tiểu	小便
Sini	锡尼
Tổng biên tập	主編
Được nhúng	嵌
bán	出賣
Mục tiêu	進球
vượt qua	傳
Cốc	盞
Mạnh	坚
người tị nạn	难民
Mạnh	強力
Giải tích	演算
Shao	岉
thang máy	擡
Thích Ca	釋迦
bệnh sốt rét	疟疾
cua	蜅
Lang thang	流落
Lini	利尼
đề nghị	提案
Băng sơn	貝格
Tiao	楲
Hồng quân	紅軍
Què	跬
chụp	射擊
kỹ năng	技能
Phục vụ như	担任
Quay	旋轉
Biao	彪
Mùa	賽季
hợp thời	及时
viết	寫
cà tím	茄
Nồi hơi	锅炉
áp suất cao	高压
Độ ẩm	水份
Các mặt hàng	货
thay đổi	更改
Thế hệ thứ hai	二代
Lịch sử	史學
Chính phủ lưu vong	流亡政府
cây rìu	钺
dày	稠
Đuôi	尾翼
Khoa học Phổ Thông	科普
Chu	褚
Xiao	暭
Viết tắt	簡稱
nói cách khác	换句话说
Hoàn thành	达到
Công trình dân dụng	土木
Heo con	豵
Hawaii	夏威夷州
Kẻ ngốc	諝
Tang	軆
Xlô-va-ki-a	斯洛伐克
Văn phòng quản lý	管理处
Liên minh	结盟
Keshan	克山
Cao răng	韃靼
mục tiêu trong bắn cung	堋
Tasmania	塔省
biến đổi	变型
Virginia	弗吉尼亚州
Tin tặc	黑客
nhảy qua	隃
Cánh đồng	埸
So sánh số	數較
Hu	聝
Qu	瞿
phương hướng	指向
Đương nhiệm	现任
Hirayama	平山
Les	勒斯
Chuột	小鼠
Đá vôi	石灰岩
Thuyết giáo	宣揚
ngụy trang	偽裝
Kera	螻
tiến lên	前进
Chi	螭
Tenjin	天神
Đang chơi	在劇
Nhà Thống đốc	家督
phổ cập	普世
Zuo	皥
bướm đêm	蛾
sàn nhà	樓
Tỉnh vân nam	云南省
Thong thả	蓄意
Điều khiển	防治
Ecuador	厄瓜
bạch huyết	淋巴
Nhà máy dược phẩm	藥廠
Báo chí	報業
Được	鑒於
Shizuoka	靜岡
Toàn quyền	全权
Chuyến thăm	到访
quyền lực	力量
Ling	泠
ngôi đền	寺廟
bản nháp	稿
Huyện	區的
Dạy	任教
Takeda	武田
Nước thải	污水
tước đoạt	剥夺
Reese	里斯
Có sẵn	可獲
sân khấu	舞台
Chuo	绰
Vấn đề chính trị	政事
James	詹姆士
Người đàn ông giàu có	富翁
Áo choàng	幔
huy động	动员
Ban cho	授予
Ý nghĩa	意涵
Nổi bật	脫穎
Yi	羾
Xuyên tâm	橈
Về công việc	在职
Buồn phiền	匁
Acenaphthene	苊
Cộng sự	伙
Liên minh	結盟
Được biết như	号称
nhà thờ Công giáo	天主教會
uranium	鈾
Nam việt nam	南越国
Hukou	户口
Áo	奧地利
chuyến thăm	看望
Alex	亚历
thiết kế	設計
Bầu cử dài	長選
vất vả	矻
khả năng	可能性
giáo viên	教員
Khu công nghiệp	工业区
sự sụp đổ	倒塌
Shi	轐
cái bụng	胃
Yu Da	於大
nông trại	畈
Nai	扙
đá ngầm	礁石
Bác sĩ	醫師
gia tài	遗产
khó khăn	靭
Quân đoàn	總隊
Puerto Rico	波多黎
Biển số xe	車牌
Người ta nói rằng	聽說
Tỉnh	行省
Chu	餻
Kế hoạch	籌劃
con hổ	老虎
học phí	費
bạch cầu hạt	粒细胞
Cặp đôi	儕
câu trả lời	解答
Điều	事物
Val	瓦爾
Đuôi ngắn	短尾
Lanz	兰茨
Tais	泰斯
Yu	宇
Sờ vào	感人
Thị trấn	该镇
vũ khí	兵器
tên nick	別稱
Kiel	基尔
phần thưởng	奖励
Haidian	海淀
Pusen	普森
cỏ nhuộm màu đỏ	韎
Đại tá	大校
nhẹ nhàng	略
sự phỉ báng	诽谤
Nhà bán lẻ	零售商
Durres	都拉斯
Neptunium	鎕
giám đốc	經理
Sự phẫn nộ	嗔
Tỉnh	外省
Sự suy giảm	除役
lý do	緣故
Cao	骜
Bai Xue	白雪
Dort	多特
Daphnia	水蚤
Henney	軒尼
Dresden	德累斯顿
Ranh giới	界线
Đến	迀
Pyrenees	比利牛斯大区
Alps	阿尔卑斯山
Kali	钾
Cấp dưới	属下
Gợi lại	憶
Theo	西奥
Cộng hòa	共和国
Victoria	维多利亚
chính tả	拼法
Yên tĩnh	悄
Người sáng lập	创始人
Trường tư thục	私塾
kiếm	赚
Lừa dối	棅
Khá	頗為
Kinh độ đông	东经
Đến	逬
Hạ cánh thất bại	迫降
Hết năm	年末
Ya	泬
hình trái xoan	橢
Kami	卡米
Và mới	與新
Thể loại	類學
Đánh chặn	拦截
Yong	颙
điên hơn	藘
Nhìn chằm chằm	罝
Luo	宀
Trang bị thêm	加装
Đàm phán	商議
nàng tiên	仙女
Yuyuan	愉園
Máy ảnh	照相機
Tuyệt vời	妙
Buzz	嘹
Pori	波里
Mali	马里
đầu tư	投资
Chuyển tới	遷到
bất tận	无穷
cỏ dại	荑
Xấu hổ	褷
hói	禿
Tao và	道與
Tamilna	泰米尔纳
diệc	鸶
văn chương	文献
bạn bè	朋友
Tiết tấu	毆
Băng nhóm	滆
hợp đồng	承包
Vùng biển	海域
Cơ thể và	體與
Sassafras	檫
Bằng lời	言中
Phong cách	樣式
Dài hơn	長於
Chung	全科
Năm sau	隔年
Giải mã	解密
cái cằm	颏
liếc mắt	瞟
cụm	星团
Tổ chức	主機
Chức vụ	職務
Ibis	鹮
Mở	开通
Xung quanh	遶
Chao	恙
Làm sao	怎
Áo khoác	襖
Giữa	間裡
săn bắn	狩猎
Đã loại bỏChia tay	淘汰分手
Nhận vào	入讀
Pokémon	寶可夢
Cha đẻ	國父
Căn hộ, chung cư	公寓
tự hào	傲
Cổ áo	铤
quần áo tã cho trẻ con	襁
Chi Li	赤鱲
đường phố	街
băng	碰
Phố núi	山城
hydro	氢
Chim	鹸
Xử lý	办理
Castilla la mancha	卡斯蒂利亚拉曼恰
sốt	發燒
Cổ phần	利害
báo	豹
Xã hội đen	黑帮
marmot	鼫
Đột biến	變異
Đặt tỉnh	書省
Toàn cầu	全球性
lấy	拿
Hinata	阳平
Kinh tế kế hoạch	计划经济
thiên đường	天堂
Yonghe	永和
lề đường	路边
Tỷ lệ việc làm	业率
cắt cạnh	前沿
Đã bắt đầu	起家
đi vào	进入
Uống	飲品
Bay lên	飆
đáng ngờ	可疑
Carnegie	卡内基
Nata	娜塔
lan can	栏杆
Hoạt động	營運
người sử dụng	用户
Văn bia	墓志
Quán tính	動量
chạm	摸
Sau khi nghỉ hưu	退役後
Đã vượt qua	傳到
ghét	討厭
Đường chính	正街
ngôi đền	祠
Giữa kỳ	期中
Khiêu dâm	情色
Tấn	埙
tình nhân	情婦
Pavilion	展馆
nằm	坐落
Đánh giá phim	影評
Áo choàng ngoài	褁
đá lửa	砮
Con bọ có mùi khó chịu	蝽
người Hungary	匈牙利语
Lưu trữ	遏制
Perseus	英仙座
Yan	晏
tóc	头发
Luo	罗
Háu ăn	飣
Cảnh sát	警員
Qua đó	過該
hủy hoại	隳
Chiếc phà	费利
Ngập	淹
Vì ý chí	為將
hoại thư	疽
St. Louis	圣路易斯
Ở giữa	於中
Mác	马克思
con kiến	蟻
Ze	泽
Sớm	濩
Đấu thầu	競標
Daifuku	大福
giao phối	交配
khu vực	地区
Ming	鳴
Một số	若干
phi chính phủ	非政府
mối hàn	焊
Quy định	规
Mã nguồn	源代码
chim ác là	鹊
văn xuôi	散文
molypden	钼
Tang	莃
di chuyển	挪
vu khống	谤
Người Kurd	库尔德
Bàn giao	交予
Hạn chế	局限
Shu	沭
con châu chấu	蝈
Cư dân	驻
tiêu chuẩn hóa	标准化
Ngày càng	日趋
cây thương	戣
Chia	多尔
Yali	耶利
Francis	方济各
Khó chịu	刺激性
bạch ngọc đeo trên thắt lưng	珶
Cái đó	彼
Ôm	肕
thành phố Manhattan	曼哈頓
đơn giản	简易
chỉ có	才
Lấy được	推導
Tất	襪隊
hiếm hoi	稀少
mạng lưới	浄
Trên dân số	论人口
dao găm	匕首
Hui	暉
nhiệt độ	温度
Viết	写入
lái xe	驅
góc phố	街口
Hậu duệ	後人
Xi	閗
Golden State	金州
H	犩
Có nguồn gốc từ	发源于
bản quyền	版权
chuyến du lịch	遊覽
sự quyết tâm	決心
Đánh thức	激起
Yun	蕓
Phổ biến	當紅
Chúc mừng	贺
Ghi lại	錄製
Cầu	大桥
Cô gái trẻ	少女
Guanghua	光华
Penang	槟
Bồn rửa	击沉
khoảng cách	间距
Yi	幐
Chức vô địch	锦赛
bởi	靠
Dòng số	號線
quân đội của chúng ta	美軍
Biểu tượng	象徵
Bệnh viện	该院
Xây dựng	构建
cái bình hoa	甒
Nói chung đề cập đến	一般指
sinh tại	出生于
Sơn	油漆
hữu nghị	友誼
hội trường tổ tiên	祧
cá nhân	親自
Lisa	麗莎
kỹ lưỡng	彻底
Cảnh sát trưởng	郡王
quy mô	秤
Thùng rác	彬
Tát	玴
Quận Ke	克縣
Porphyr	卟
gầy	瘦
Ming	銘
tháng	月間
Chấp hành	行署
Gaza	加沙
Sinh ra	生而
cái tát	摑
Hung ác	冷酷
Tách rời	另立
Tsim Sha	尖沙
có ảnh hưởng	伾
chắc chắn rồi	肯定
Đánh nhau	交戰
Cối xay	磨坊
Hạt Xing	興縣
khay giỏ phẳng	笸
Changshu	常熟
hình trái xoan	橢圓
Văn phòng chính thức	官署
Làm cho đồng bộ	同步
Họ Rubiaceae	茜草科
thành phố Kowloon	九龍城
vượt qua	序曲
phe phái	派别
Shenlong	神龍
Thùng rác	缤
Đại học Shan Dong	山东大学
hydro	氢气
Rồng khổng lồ	巨龍
Đi	东乡
Axit sulfonic	磺酸
nhẫn tâm	趼
Mông Cổ	蒙古
Guojun	國軍
Đại học Quốc gia Đài Loan	台大
Nhật Bản tuyệt vời	大日本
cao quý	貴族
Thưởng thức	享用
người kế vị	继任者
Sư đoàn bọc thép	裝甲師
Sự công nhận	表彰
Quân đội mới	新軍
Bay	湾
Thiên kiến	偏見
Nhận biết	结识
Thất bại để	负于
Người giải trí	藝員
Grate	毦
Như	做為
Yasha	夜叉
Triều Châu	潮州
đồng	青铜
Không giúp được	不禁
thỏa hiệp	妥協
ngoại ô	市郊
Sega	世嘉
Trung bình	介質
Thời gian	時稱
bóng bàn	乒乓
niết bàn	湼
Chết của	死於
Nahe	納河
Pleiades	昴
Chan	鉶
Tử vong	病故
thật	的確
Chơi	耍
Bắc	北面
khuyên nhủ	谏
Chính quyền trung ương	中央政府
Gro	格罗
Tai nạn xe hơi	車禍
Hỗ trợ	互为
Máng	低谷
Anh quốc	烏克
Thói quen	习性
hệ thần kinh	神经系统
mật khẩu	密码
cổ đông	股東
ghi âm	記錄
đỉnh núi	嵝
Trụ trì	方丈
tài chính	金融
Đầu phía bắc	北端
Công	巩
cho	為
Buồn cười	搞笑
Jianning	建宁
Trạm xe bus	巴士總站
Chỉ có thể	只能
Ji Lu	冀鲁
Tấn công	出击
Giữa	介於
áo choàng	海角
Không ổn định	不穩
ách	轭
công ty mẹ	母公司
bãi bỏ	廢除
Võ thuật	武打
Rộng	寛
Nhà điều hành	运营商
song song, tương đông	骈
Yar	亚尔
Và bởi vì	並因
nó được dùng để	是為
quá trình	进程
Đào tẩu	倒戈
Đối với	為應
dẫn đầu	主导
Nhập khẩu	导入
nhà ăn	食堂
Thuyết giáo	宣扬
một tám	一八
một mặt	一方面
Tiếng lóng	俚
Shou	守
Nội dung	争夺
Tấn công	攻取
Học	学业
ngập nước	湮
lãnh thổ	疆域
Liên kết	缀
Mẫu giáo	幼儿园
tài khoản	帐
Hinder	妨礙
cái đầu	頭部
Đức phật	佛
Chiếm lấy	撷
Háu ăn	鋦
TGM	总主教
Miệng núi lửa	陨石坑
鳒	鰜
Người nước ngoài	洋人
Du lịch	游客
Tỉnh Kyoto	京都府
ghi chép lại	纪事
Mét dài	米長
y học cổ truyền Trung Quốc	中药
nghệ thuật tự do	文科
Bán vé	售票
ruột	腸
Trường học	學堂
Giếng sâu	深井
Ami	阿米
Đầu tiên	乍
hệ thống	制
Bảo vệ	衛隊
Đáp lại	批复
Rui Zong	睿宗
nhà giam	入狱
đình công	罷工
Pingtung	屏東
bán cầu	半球
Canoization	册封
Kedah	吉打
chuyến bay	飞行
Hút thuốc	四平
yết hầu	嚥
hủy hoại	譭
Castanopsis	栲
Quan thoại	官话
Reel	輘
Toàn cầu	全局
Từng bước một	逐步
bia mộ	墓碑
nồi	锅
Lei	磊
ria mép	偲
sẽ sử dụng	会用
dưới nước	水下
giữa	之間的
Mắt cá chân	安康
Tiếng Turkic	突厥
Poseidon	海神
hạt	粒子
Quảng đông	粤
Akka	阿卡
than cốc	可樂
Tấn	瑮
nổ	爆炸
Không bao giờ	從來
Ủy ban tỉnh	地委
Núi	山岳
nêm đá	磹
chậm rãi	慢慢
đá mài	砥
Cái xô	巴克
Bo	亳
sự trừng phạt	惩罚
Điện lực	電
đố kỵ	羡
Cục Nội vụ	民政局
bộ trưởng, mục sư	部将
Hanshu	漢書
hoang dã	野
Hồ đông	东湖
Đã vào	所進
hùng biện	佞
Nhìn chằm chằm	瞠
Zhu	昚
lớp học	課
kẻ thù	敵
định tuyến	路由
phát triển	进展
Với Nhật Bản	與日本
chuông	貝爾
Dài	茖
Trang Chủ	家後
Posterity	后主
Cây bách	檜
Anwar	安华
vĩ độ bắc	北纬
Kinh phí	經費
Họ Gramineae	禾本科
Sẽ gửi	將發
chậm lại	減速
Tự nhiên	本機
chưa quyết định	蹰
chòm sao Đại Hùng	大熊座
Đảo và	島與
thuyết phục	說服
lên án	谴责
Chính quyền dân sự	民政府
ngoại ngữ	外語
Đột phá	突圍
Cicero	西塞罗
Châu âu	歐語
tự động	自动
Hố	孴
đàn ông và đàn bà	男女
Stephen	斯蒂芬
Thịt	葷
nhỏ bé	謏
Nối	剪接
Trương Gia Khẩu	张家口
cấp	軍階
Thích hợp	合適
Vắt kiệt	圑
Với cơn gió	飄
Bán	販售
nang	蓇
nắm lấy	捕
càng sớm càng tốt	尽快
Tất cả mọi người	众人
Nhà Đường	唐朝
Sờ nắn	扪
Pu	斦
Đóng	閫
Hậu duệ	后裔
dòng nhanh	快線
sự nối tiếp	序
đặc biệt	格外
Neon	霓
bộ xử lý	处理器
Gan	玕
Giám đốc	總監
Takeda Shingen	武田信玄
Để cái này	讓這
Feld	费尔德
Bầu	选入
Tuyệt vời	精彩
phụ gia	添加剂
quan hệ	亲戚
Eric	埃里克
con số	數目
bảng	板
đảng cộng sản	共产党
Thực hiện	做成
Xyanua	氰
Cuộc thi giáo viên	師賽
lãnh thổ	領地
Tottenham	熱刺
Hành khách và vận chuyển hàng hóa	客货运
Adolf	阿道夫
Rải rác	散落
Châu phi	非洲
Nếp gấp	褶
Dato	拿督
Nói	話說
TV	电视
nhà hàng	餐館
Giam	拘禁
Trưng bày	施展
Nghiêm nghị	艴
Nagasaki	長崎
gấu trúc	大熊猫
Nương náu	避难
B	乙
Phiến quân	義軍
Khép kín	自成
Bốn năm	四年
Ngày 20	二十日
mùa xuân	泉水
Được chọn	獲選
giỏ để bẫy cá	笱
Sóng từ	磁波
thay đổi	变迁
phổ cập	普及
Tốc độ là	速為
tưởng tượng	虚构
Giun đũa	蛔
Illinois	伊利诺伊
thứ hai	國中
Một chương trình	独秀
Và với	而與
Các triều đại Tùy và Đường	隋唐
giảm	縮減
cô	思念
bóng râm	荫
quyền tự do ngôn luận	言論自由
Phí chuyển nhượng	轉會費
Phượng Hoàng	陯
Times	倍
Tương đối tổng quát	廣義相對
cơ khí	機械
Strasbourg	斯特拉斯堡
Sẽ đúng	將對
Ở đâu	之處
nơi cư trú	居所
Với	附帶
nặng	沉重
Kui	奎
giáo viên	老師
Wharton	華頓
Nguyên nhân	造成
Engels	恩格斯
khỏe	精美
Phong trào xã hội	社會運動
Sự vi phạm	违规
Sau việc làm	職後
Áo khoác	袄
Diễn dịch	詮釋
kỹ thuật	工程学
độc lập	独立
thua	損失
Đầu mùa	季初
Huanggang	黄冈
đó là ai	是誰
Lỗ rốn	臍
nách	肐
Tạm thời	暂行
Lăn qua	輾
Xiu	洫
Đảm nhận	接手
Đăng ký	存器
Đối với các tác phẩm kinh điển	為經
Giá trị	數值
Oklahoma	奧克拉荷
hẹp	仄
con kênh	运河
Cây	卉
kỹ năng	技艺
Erzhou	尔州
xấu	不良
Số và	號與
Carolina	卡罗来
Suy sụp	棔
căng ra	繃
Nhọt	痖
Trưởng	首长
Dạy	讲授
Loiret	卢瓦雷省
nguyền rủa	駡
tập đoàn	法團
động cơ	引擎
Quan thoại	普通話
tham	騖
Loài	種說
Quảng tây	广西
Dương	旸
Đóng góp vào	促成
Picardy	皮卡第
Phát thanh	放送
sinh nhật	诞辰
Cộng sự	夥
Tê liệt	瘓
Đất liền	內地
Nói cái này	說這
hái	镐
Đồng hồ đeo tay	观赏
Cửa hàng thức ăn ngon	德利
Trở về nhà	歸國
Trưởng phòng	头人
lung lay	蕩
máy gia tốc	加速器
trao đổi công bằng	公平貿易
Trong một khoảng thời gian dài	长期以来
hành động như	充當
mối hàn	銲
Pharaoh	法老
cơ bắp	肌肉
Cứu trợ	浮雕
Sông Yalu	鸭绿江
Đến	饀
Cấp độ 2	二級
Quận tự trị	自治州
tiêu đề	稱謂
Sâu	蜚
nơi cư trú	住處
Jones	瓊斯
Tantali	鉭
Kodo	科多
Ủng hộ	託
Vì thế	索
Trong ngày	天內
Vật	对象
vật trang trí	鋃
nếm thử	啗
Tình hình	處境
Tên gọi chung	俗稱
Vội vàng	濵
Trung Hoa Dân Quốc	民國
Nagqu	那曲
ngân hà	銀河
Nibble	嗑
Luật hữu cơ	组织法
Nhà điều hành	算符
Nautilus	舡
Mỗi	每种
nguyên nhân	起因
Nhà truyền giáo	傳教
ngưỡng cửa	閾
Xiangshan	象山
Không gian	太空
Tan	昙
phát phần thưởng	送
phản đối	對手
đấu trường	競技場
Thắng hay thua	勝負
Cameroon	喀麥隆
Cao quý	贵人
Sự tiêu thụ năng lượng	功耗
Hui	薈
Hai cái này	這兩種
Phát hiện	偵測
tàn tích	废墟
Cởi	脫
Xuân	瑅
chim	胗
Từ phía đông	從東
Lụa	黬
quyền và lợi ích	權益
Người Bồ Đào Nha	葡萄牙语
Dahe	大河
Dài	漫长
làm	挵
Sự phát triển	演進
Chân thành	誠
Lushun	旅顺
phức tạp	复合
Li Cun	李存
Đa dạng	各种各样
tình nhân	情妇
Phần còn lại	殘留
Chuyển số	號班
hai trăm	二百
Huyện	區區
Diễn dịch	繹
Ả Rập	阿拉伯人
Đạo đức	惪
rau	蔬菜
ngái ngủ	困
Uống	飲料
đàn áp	压制
Yu	盺
Piłsudski	毕苏斯基
Tập thể dục	練習
Biến cố	入射
hóa thạch	化石
Người phụ nữ trẻ	媺
Cây hương bồ	鮰
hướng tới	朝
Phó Tổng Thống	副總
giao hàng	交付
Quận De	德县
Lẻ tẻ	零星
Ánh sáng	轻型
Ngày 28	二十八日
Không cần	無需
ngắt lời	打破
Lịch sử	史稱
Và có	且有
Vành	辋
quan tâm	關懷
Lựa chọn	選輯
Quân luật	戒严
Phúc lợi	福祉
Park Jung Hee	朴正熙
Nhón	龎
Cuộc cách mạng	革命
khiển trách	訶
nhạc jazz	爵士樂
Shao	鄡
Tan	郯
Âm	欀
Quá cảnh	中天
không người lái	无人
Cá tuyết	鱈
Than khóc	巗
Chụp	槍擊
Zhuzi	诸子
Kim Hoa	金华
Ngoại hối	外汇
Quyền sở hữu nhà đất	置業
Nantou	南投
ở đằng trước	向前
Đường phía đông	东路
Nhìn	来看
Độ nhớt	黏度
Yu	雗
Luo	潖
Das	达斯
Tàu	舰只
ốc sên	蝓
hùng hoàng	铼
Lan tràn	流传
Gây rắc rối	鬧
hàng quý	季度
phát sóng	转播
Anh bạn	絝
Trang bị lại	改裝
Đã đổi tên	改名
Kur	庫爾
con số	號
Stu	斯图
Caucasus	高加索
Tốt	唏
ném bom	轰炸
tưởng tượng	假想
Thời đại hưng thịnh	盛世
Đa dạng	多样性
-quán ba	巴
Tinh thần đoàn kết	声援
tỉ mỉ	細緻
con số	数目
khu vực trung tâm	中心区
Bay hơi	揮發
điều này	這項
Hướng ngoaị	傳出
Nhiều lần	迭
Bối cảnh	幕式
Zhuhai	珠海
Phụ thuộc	相依
Yan	阎
Hoài Nam	淮南
Giống nhau	同理
Bướm đêm	螆
Công chúa	殿下
Swastika	卐
đăng ký	订阅
Ke	轓
Chengdian	成殿
Qingquan	清泉
tiết kiệm	节省
Khối	街区
người chiến thắng	获奖者
Nell	內爾
Yau Ma Tei	油麻
đàn nguyệt	琵琶
các nhà cung cấp	提供者
Tập giấy	帕德
Năm	年間
CHỈ SỐ THÔNG MINH	智商
Choáng váng	愃
Bộ nhớ đệm	缓存
phần mộ	坟
Mờ nhạt	湏
Li Hongzhang	李鴻章
Trung học phổ thông	中学
Chết vì	病逝於
Mesozoi	中生代
Thấp	低廉
Bắc Trung Quốc	華北
chơi	吹奏
Nhưng không	但並
Lịch sử	史以來
Boeing	波音
Hongo	本鄉
Học viện	学社
So	对比
cổ xưa	上古
Seiko	世子
cắt cổ họng	剄
Urben	爾本
Chín	疎
suối	溪流
buổi tiệc	党
Bữa trưa	午餐
Este	埃斯特
rùa	鼈
Và giả sử	而設
bản năng	本能
Biên đạo múa	编排
kiểu	型
Trạm trước	前站
khuếch tán	擴散
Taizu	太祖
Được chọn làm	選為
Cử đi	分派
Hơn	更為
Kerman	克曼
liên minh	同盟
nhưng nó là	卻是
Phương pháp phân chia	分法
vách đá	碞
Hệ thống âm nhạc	樂製
bá Vương	霸主
phẫu thuật	手術
lưu lượng	流
Vị trí cao	高位
Gạch và gỗ	砖木
sầu muộn	愊
chiếm đoạt	篡
Người mua	買家
Mert	默尔特
Rotterdam	鹿特丹
Ngôi sao	史達
từ vựng	詞彙
Dừng lại	停站
Sau	經在
con tin	人質
Đấu cúp	杯赛
Bing	秉
Nhìn	來看
Zygomatic	墧
Thành lập	所立
cảm tạ	谢
Tôi	亠
ish	般的
Chọn	挑選
Vắt kiệt	撋
Trình độ chuyên môn	賽資格
Macky	馬其
chỉ	晒
cơ sở dữ liệu	数据库
đột tử	猝死
dữ liệu	资料
Bài hát	嵩
Bị cáo buộc	据称
tuyên bố	說法
samarium	釤
Choáng váng	愀
người cầu nguyện	禱告
Hầu hết	差點
Bất lợi	缺点
phì nhiêu	沃
Bỏ trốn	逃脱
Nước ép	汁
London	國倫敦
Cử tri	选帝侯
kỳ nhông	蝾
đầu lâu	顱骨
Phiến quân	叛军
Phổi	肺部
Tiếp đầu ngữ	前缀
châm chích	蜇
Ai Xinjue	爱新觉
bằng sáng chế	专利
Coilia	鱭
Bao vây	僎
Quá cảnh	中转
Giàu có	富含
Ống kính	朗斯
Chúng tôi	頃
Dubai	迪拜
Receptor	受體
Móc	悬钩
Cuộc xâm lăng	侵襲
Tiểu thuyết giả tưởng	奇幻小說
Tát	蹷
Lanny	蘭尼
Dài và hẹp	狭长
Kẽm	锌
Ho	嬗
Ding	燫
Chúng tôi không có	們無
sự phản chiếu	反射
Và đất nước	與國
Chơi	上场
Ngốc nghếch	佝
Okashi	岡市
phèn chua	矾
Tây tạng	藏文
lông cứng	鬃
thuốc độc	鴆
cửa sổ	窗口
Tổng binh	總兵
Hu	衚
Đại công tước	大公
Zhongfa	中發
chế độ quân chủ	帝制
Ding	丁
quái vật	怪物
Ngành kiến ​​trúc	架構
Tara	楻
Sư tử	獅隊
đọc	读
Đột phá	攻破
Vượt qua	通行证
Vồ lấy	抓
Con ngựa	驹
Đối với	為當
Horchin	科尔沁
trán	顙
Phiên bản	版
Ý tưởng	观念
Số lượng lớn	大宗
Cho đến khi	蒂尔
Agen	阿根
Jieshi	介石
muỗng, xúc	舀
Hu	粺
Albert	阿尔伯特
Thường làm	常使
Cao thấp	高低
Sapporo	札幌
Nông phu	农民
ngoại ô	近郊
Nhà máy xe	车辆厂
cô bé	妞
đài hoa	柎
tuần tra	巡邏
Arkansas	阿肯色州
Belgrade	贝尔格莱德
Hồng ngoại	红外
Đột ngột	霎
Ao	鼇
Liệu anh ấy	將他
màu xanh lá	緑
Yu	襸
Axit lactic	乳酸
Háu ăn	饤
Fu	滏
ma	幻影
Bắc	諾斯
Áo choàng ngoài	褸
đường sắt	铁路
Toàn bộ thị trấn	全镇
Giới hạn trong	限于
Rực rỡ	艳
hổ phách	珀
Hờn dỗi	匂
Giáng sinh	聖誕節
Cây	樹木
Kun	鶤
Nơi cư trú	居住地
Kích hoạt	觸發
Phụ thuộc	決於
Ở lại	留下
khởi đầu	啟
Di chuyển về phía nam	南迁
Quảng châu	廣州
Không biết xấu hổ	詷
phục vụ	献
Enol	烯醇
Người đàn ông giàu có	富豪
chậm	缓
thành nội	御
Hồi phục	康復
Tự học	自学
Đồng hành	陪同
Yi	佷
Qi	樘
Tiền bạc	款项
thành phố Manhattan	曼哈顿
Connecticut	康涅狄格州
Bộ Công nghiệp	工部
Album	影集
Tình dục	性愛
quỹAlexandre	资金亞歷山
Zhang	昞
Phần	節
Bazhou	巴州
Bản thân	自己
Quốc vương	君臣
Giữ	保留
Dong Yi	东夷
Hướng dẫn	指示
Phiền muộn	抑郁
chấp thuận	寬容
sân khấu	階段
đáng yêu	可愛
Hub	中枢
Từ	出自
Trước mặt	前段
Tiêu đề	片名
quăng	簸
Yan Xi	閻錫
quân đội của chúng ta	美军
hình trụ	筒
Bình luận	注释
Lồi	凸
Zheng Chenggong	鄭成功
Thuyết giáo	傳道
Willie	威利
Hồi ký	回忆录
xếp hàng	队列
Đứng	常務
Đô thị hóa	城市化
Tân Hoa Xã	新化
Người bảo vệ	护者
Tình dục	性地
Tiếng kêu bíp	哔
Bướng bỉnh	瞨
Xa lánh	龁
Chính thức	为官
Zhang	昃
Đàn ông	男子
Tên miền cấp cao	頂級域
vòng cung	弧形
sân bay	航空站
Trú ngụ	寓居
Yi	弌
Điều trị y tế	医疗
Dòng chảy	涌入
Nước Iceland	冰岛
Nebraska	內布拉斯加州
Yao	幺
Thích	贊
dư luận	民意
Chính ủy	政治委员
Kerr	克爾
Và trong	與中
Ichigo	一護
Riemann	黎曼
Vâng	呀
Niềm đam mê	激情
Vật phẩm này	该项
Trang sức	珠宝
mẹ	母系
Sai Sai	賽賽
Ngực	胸前
Tám trăm	八百
Cassiopeia	仙后
Pyridine	啶
Và hai	及兩
quân cảnh	憲兵
màu sắc rực rỡ	有色
Hồi hương	遣送
Phiến quân	叛軍
Theo	遵
Con trai	兒子
vô số	無數
Tháp chuông	鐘樓
Hakka	客家话
Con la	騾
phát triển	進步
bay	飞
tuần	週
Sri Lanka	斯州
Từ ngữ	字句
Hiệu suất	業績
Xe ngựa	戰車
Trong một thời gian	一陣
Lên men	发酵
Ôm	徝
Khoảng thời gian kể từ	期以來
Kantan	康坦
Từ	來自於
phe phái	派別
thép không gỉ	不锈钢
thực hành	练
Đơn vị hành chính	行政单位
Hoặc là	奧爾
Đua hỗn hợp	混血兒
ngày	白日
Linh hoạt	灵活
Kỹ thuật	工学
Sáp	腊
Cộng sản	共产党人
Nantang	南唐
Tbilisi	第比利
Người môi giới	經紀
Nanyuan	南苑
Người Duy Ngô Nhĩ	回鹘
Hạn chế	受制
hộ chiếu	签证
Rắc rối	困擾
dấu	标示
Sầu muộn	憂鬱
alkyl	烷
đèn lồng	灯笼
Mi	弥
Kiệt tác	代表作
người đọc	读者
liên kết	關連
Yu	竸
Jonah	乔纳
Cây lưu ly	苣苔
Cacbonyl	羰基
Toluene	甲苯
Zabu	扎布
Acetyl	乙酰
diễn đàn	論壇
vật chất	实质
Tang Taizong	唐太宗
Mỗi	逢
chớp cánh	扑
bão nhiệt đới	颱風
con quỷ	恶魔
chùa	佛塔
cây sào	竿
Romania	羅馬尼亞
Phấn khích	激
Sti	斯蒂
mẹ	媽媽
Âm	瀱
Điều khiển	管控
Vắt kiệt	漋
con tắc kè	蜴
Huhe	呼和
Ngày 22	二十二日
carbon	炭
Địa điểm	位点
tiểu sử	传记
danh từ	名詞
Doanh thu	漢諾威
Sẽ là	將於
Dân số	尔人口
Xingguo	興國
Địa ngục	地獄
giải phóng	發佈
Âm	埪
Amoni	銨
Doanh thu	汉诺威
Người tiên phong	首創
Birmingham	伯明翰
Phiên họp toàn thể lần thứ ba	三中全会
chán nản	鬅
Nhãn hiệu	勃兰
các Tiểu Vương Quốc Ả Rập Thống Nhất	阿联
tham	馋
Góa phụ	寡妇
Giang Tô và Chiết Giang	江浙
Một	一个
giải phóng	摴
Cưỡng bức	被迫
Gou	觏
Mềm mại	軷
Chống lại	迎战
Knotty	节性
Singh	辛格
Hơn một nửa	過半
Biên tập	編修
Buenos	布宜諾斯
bảo vệ	卫兵
Độ cao điểm	點海拔
Tung hô	海陵
Một người	一個人
Tích trữ	褀
trống đồng lớn	鼖
Nhện cua	蟹蛛
tinh thần	精神
Columbine	哥倫
Giết người	命案
áp bức	迫害
Tấn công bằng phi cơ	空襲
Biến cố	項賽
điều này sẽ	這將
có lợi	益
Gu	顾
Trang web cũ	舊址
Hồng Lâu Mộng	紅樓夢
Tàu	船舶
con gái	姑娘
suy đồi	颓
vắng mặt	缺席
Chìm	淹没
Mỗi tập	每集
màng ngăn	膈
Hướng tới	邁向
Cheng Zhi	承志
Ở giữa	間在
Bốn trăm	四百
đánh	打
Đặt nằm	奠定
xe hơi	车
vui sướng	歡樂
Taizhou	泰州
Quần áo	褈
ngữ pháp	语法
Đừng ở với	別與
Bản văn	文
Thông báo	宣佈
Sau và	後與
Congo	剛果
vây	鰭
Vượt ra ngoài	超越
Nhóm A	甲組
dám	敢
về nhì	亞軍
nhấn	报刊
đôi mắt to	大眼
gạo xay	粞
tại thời điểm này	此時
Shogi	將棋
Manstein	曼斯坦
Khai báo	宣
Nixon	尼克松
mạ	鍍
Thử nghiệm	审判
rễ cây	荄
nghiêm trọng	严肃
Reese	瑞斯
màu tím	绀
Lei	蒀
họng	喉
Frank	弗兰克
cho đến khi	为止
như thể	彷彿
Panzhi	攀枝
Phong cách âm nhạc	音樂風
Xe bọc thép	裝甲車
giáo viên	教员
Lượng mưa	析出
thứ mười bốn	第十四
Đây	莅
Sớm	提早
Shigemitsu	重光
Họ hàng	外戚
đã sử dụng	惯
bột mì	面粉
mộ	壙
Gondor	剛鐸
Công ty	会社
cái bè	筏
Zhi	酃
Đối mặt với nhau	相望
Rong	鎔
Rende	仁德
con số	号
Admonish	諼
Tây Bắc	西北
Âm	燠
Con gái	女生
tin nhắn	信使
Đa dạng	品种
con lửng	獾
Hướng dẫn	指引
Chết	殁
Buộc tội	指責
Chức vụ	司職
Đà điểu	鶓
Ban nhạc	波段
Chìa khóa	密钥
Chơi nhạc	演歌
Nadal	拿度
đảo san hô	環礁
Loire	卢瓦尔河
Tỉnh ủy	省委
mùi	气味
Tham vọng	雄心
bạo loạn	暴動
Chia sẻ	份
Tung Wah Group of Bệnh viện	東華三院
tương tự	同位
Thắng lợi	獲勝
Cây	棵
Nước	水性
Quốc đảo	島國
Chim bồ câu	鳩
mê cung	迷宫
Hội đồng quận	區議會
Alibaba	阿里巴巴
cày	耜
Đừng di chuyển	不动
Bai	佰
Suri	蘇里
chàng rể	新郎
Hệ thống quân sự	军统
Bùng nổ	咘
Myanmar	缅甸
tăng	增長
Suy nghĩ	思維
Fuji Mount	富士山
Bang	吘
Vùng có nước mưa rơi xuống	集水區
Kobe	神戶
vinh quang	荣耀
Roe	獞
Panama	巴拿马
Serre	塞雷
Fu Teng	符腾
cây sào	极
Đồng minh	同盟國
Nổi dậy	叛變
tiêu cực	消极
mở ra	开辟
đỉnh núi	山峰
Tái thiết	改扩建
Ying	嬿
Ming Taizu	明太祖
Cong	拱形
đá	踶
Li	醝
Sinh kế của người dân	民生
Đại hội nhân dân	人大
Kết nối	連繫
Chang	涘
ngồi xổm	蹲
Sáp	糯
Khác nhau	同父異
Bỏ tù	监禁
Chúa tể	尊者
Và dễ dàng	而易
bím tóc	辫
Xô	檎
quảng cáo	广告
tháng Ba	行军
bộ lọc	過濾
củng cố	增援
Stella	斯特拉
zirconium	鋯
quyết định	決策
Tường	沃尔
nơi trú ẩn	庇護
Gạo lên men	醄
đất đai	土地
tắt	關閉
ngành công nghiệp	行业
phấn	垩
Feihong	飛鴻
Nắm bắt	奪
Wanshi	萬石
trước	以前
Được thăng cấp lên	晉升為
Bán đảo Cửu Long	九龍半島
đắng	苦
Mét	公尺
Anping	安平
Erga	爾加
Xa lánh	舜
điều răn	誡
Chờ đợi	等
thời gian	时候
cái chùy	梲
săn bắt	追杀
tiềm năng	潛力
Gao	杲
Sau khi nghỉ hưu	退休後
Gia Cát	諸葛
Anh ấy nói	他說
Số hữu tỉ	理数
Phiên họp	届
Ốc sên	螺属
hài hòa	和谐
Độ phân giải	分辨率
không khí	氛
Yan	剞
Zhang Hui	張惠
năm mươi ba	五十三
tàn sát	屠殺
Nhiếp ảnh gia	攝影師
Dirac	狄拉克
Kinh tế học	经济学
Parana	巴拉那
Qian	骞
Quyên góp	捐献
mũ	帽子
Di truyền học	遗传学
đá cầu	毽
nhóm	團
Dai	醍
ngân hàng Trung Quốc	中国银行
Bỏ tù	期徒刑
lãnh đạo	领导者
Ngân hàng HSBC	滙豐
Nhưng	但卻
từ ngữ	詞
chi tiết	詳細
lực lượng	部隊
cấp dưới	部属
sinh nhật	生日
Bán kết	半决赛
Đang tìm kiếm	寻
Không hoạt động	非营
Tỉ lệ	蚧
Cùng một năm	於同年
Khuyến khích	推廣
Chịu đựng	經沒
Apple Daily	蘋果日報
Huxi	湖西
Khói	吸食
Cáo phó	鮣
Rút thăm	抽籤
Mas	馬斯
bộ phận hậu cần	后勤部
Quả ô liu	橄榄
tinh thần	磧
mastiff	獒
kéo	曳
nói	是說
Người phụ nữ của chúng tôi	圣母
Chelsea	切尔西
Quận từ	區從
Thái	泰
Cách mạng Văn hóa	文化大革命
vỏ sò	贝
Za	札
Sự đổi mới	创新
Tưởng tượng	想象
Làm	制取
Reid	雷德
Dưới cùng	谷底
Trên đầu	目上
Sina	辛那
Hui	荟
lớn	宏大
Thần sấm	雷神
Đến	來納
đoàn kịch	劇團
Không thể chịu được	不堪
dừng lại	停
sốc	震動
Đà điểu	鴯
quân đội	军
Phiên mã	转录
pha lê	晶
Chun	椿
bắn	毙
gạch	塼
siêu thị	超級市場
ho	嗽
Huyền thoại	相傳
Trong sân	院內
Thoát nước	瀝
Chiếm giữ	沦陷
Bala	巴拉
đứa trẻ	子女
bàn phím	鍵盤
Gerry	格里
kết nối	联络
Les	列斯
tranh giành	抗衡
Tát	蹳
giả thuyết	假說
Cá heo	豚
Nhón	懐
Lưu lượng dòng chảy	流速
Gui	圭
đầy	飽
Zhi	贽
Sting	螥
trong cuộc đời tôi	一生中
hào	淢
Eryu	爾於
Lohan	羅漢
Thôi miên	催眠
Sự phát triển	演變
Khoa học và Giáo dục	科教
khai thác mỏ	採礦
Nheo mắt	眝
sợi chỉ	绪
Leipzig	莱比锡
Thích hợp	一致
Lang	湦
Qi	骐
săn chắc	廱
Khu vực	该区域
câm	喑
cung điện	宫殿
đánh bóng sừng	觷
nhiệm vụ	责
Beatles	披头
Quốc tịch Hán	汉族
Thỉnh thoảng	間發
Toà thị chính	市政府
Người dẫn chuyện	旁白
Cỏ đuôi phụng	尾草
Giáo viên	師師長
lực lượng	武力
màn	幙
Chặt đầu	斬殺
Đánh vần	拚
Rung	振
Công nghệ	技术
Xâm nhập vào	滲
Sh	轪
Simon	西门
Cày cấy	墾
hoang dã	埜
Guangxu	光绪
Baroque	巴洛克
Eason Chan	陳奕迅
Chiều cao	身長
ngủ nướng	位于
trượt	滑
Nhanh	斋
Hồ nước	雷克
mũi tàu	舻
Sự thông minh	情报
Ở châu Âu	於歐洲
Vây	鰭軟條
Cấp dưới	部下
căng thẳng	緊張
bỏ đi	报废
Hàng xóm	與鄰
Xấu hổ	銾
Dieter	迪特
Liteon	建興
Đấu trường	赛场
Mặt hồ	湖面
Peter	彼得
Qi	逑
Lúc bắt đầu	當初
Zhiwei	志偉
Thành phố Tsu	津市
tổng giám mục	大主教
bệnh lao	结核
Cái vuốt	胈
Thời gian tập	劇集時
đi	赴
Phức tạp	配合物
tối ưu hóa	优化
Linh miêu	猞
và	併
lên	及至
Đặc vụ	剂
Gửi đến	派往
Thiên Môn	天门
khô	燥
Kết cấu	搆
Yu	饘
người quản lý	管理员
Đang tìm kiếm	尋
Bảo mật	保定市
Napoléon	拿破仑
Chân mày	狛
Howard	霍华德
Danh sách phổ biến	流行榜
Số Pi	陂
Thỏa hiệp	折衷
Mong Kok	旺角
Ligue của Pháp	法甲
Nổ	突发
Alfonso	阿方索
Earle	厄尔
Qi	轕
thu nhập = earnings	收入
Pterans	翅目
dịp tốt	时机
Weiss	韦斯
Karlsruhe	卡尔斯鲁厄
Zheng	鄭氏
Đăng nhập	登陸
thùng	枪管
Gul	古尔
Lượt về	之交
Xem xét	諗
Tuổi	歲的
Biểu diễn nghệ thuật	演藝
Si	禝
Xâm phạm	侵犯
nhảy vọt	踴
Sớm	旋即
tỏi	大蒜
Khiếm khuyết	叛逃
Hu	篶
đến	過來
đầy	充分
thô thiển	原油
Yun	韾
Chơi trên	劇於
Từ chức	辭去
Li	楧
Dọc theo	沿着
Nạn nhân	遇难者
Nguồn nước	水源
Xianzong	宪宗
trống	空的
Khoe khoang	展現
Áo khoác	襦
Âm	兙
đảo ngược	倒
Wu	婺
Trở về	归来
Hu	戉
Xinghui	星輝
xã hội học	社会学
Ý nghĩa	諦
người thân	亲属
Chạm tới	达
dễ thương	倢
Triệu hồi	召見
làm đẹp	美化
hình dạng	状
Bảo vệ chống lại	防備
Có liên quan	相關
kinh doanh	业务
yêu cầu	請求
Cơ sở hạ tầng	基建
chiếm lại	奪回
phát sinh	衍生物
trao đổi thư tín	对应
trận đấu nhóm	小组赛
gõ cửa	叩
cao	高大
Thả thính	橒
Mỗi	毎
Đánh nhau	轉戰
Mike	麦克
Khu kinh tế đặc biệt	经济特区
tuyến giáp	甲状腺
Tốt bụng	樣
Lei Yue Mun	鯉魚門
Hai năm sau	兩年後
giải phóng	发布
phụ trợ	掾
Lemberg	伦堡
đầu lâu	髅
xì hơi	瘪
Plantar	跖
Li	驪
Trung tính	中性
Tình cảm phổ biến	民情
ít hơn	少于
Guangxu	光緒
Nắm bắt	夺
buồng	柜
Phòng tổ chức	组织部
Điều lệ	憲章
Có tỷ lệ	有率
Charente	夏朗德省
ngũ cốc	穀物
Nước xốt	醬
để trần	袒
Luneng	鲁能
trường hợp đầu tiên	一审
đường thẳng	直線
lạ lùng	怪
Enzyme	酶
Keelung	基隆
Alen	等位基因
mông	夆
tiếng vang	呼應
Vận tải đường biển	海運
Nhà triển lãm	參展
Vật phẩm này	此項
lạ lùng	奇特
biên tập	編輯
buồn bã	煩惱
Bún	馍
yêu bạn	愛你
Han	菡
Đại học Tongji	同济大学
Chăm lo	照顾
Bốn ngày	四日
Bao gồm	納入
Lei	蝒
Ngày hôm đó	当日
Phong	馮
Mười nghìn	一萬
Mian	澠
Thần tượng	偶像劇
Chùm tia	梁
xe hơi	汽車
Cuộc phiêu lưu	探險
Kéo dài	腢
nguồn	来源
dựa vào	赖
Làm cho mọi người	令人
Ngập	淊
Luwan	卢旺
cầu thủ bóng đá	足球員
Dây sắt	鐵綫
Dài	壠
Downer	唐纳
Độc thân	单
Cho lâu dài	為長
Giới trẻ	年青人
dược phẩm	医学
Khi đến	來時
Làm lơ	忽略
Jianguo	建国
Hiệp sỹ	侠
Nhìn chằm chằm	覿
chạy	運行
Outreach	外傳
Đầu Thanh	清初
Bồn rửa	沉
Qi	秱
Đường cao tốc Tuen Mun	屯門公路
khôn ngoan	明智
Cumshot	仆射
ngoại thương	外贸
Yao	姚
Trong ngày	日內
Ye	呴
Hoàng đế Daoguang	道光帝
sôi lên	熬
Xấu hổ	湁
thật thà	清廉
Trang trí	装修
Chì	率領
thói quen	习惯
men	酵
gỗ	木头
Kết tụ đô thị	城市群
Công cụ bằng đá	石器
Luz	路斯
Chuyển giới	跨性別
Ốm yếu	多病
Thật	确
ấm trên chân	鬷
vào thứ bảy	星期六
Đi qua	穿越
Az	阿兹
Cá nóc	鲀
Gạn lọc	滗
Ông già	媏
Mira	米拉
franxi	钫
Bướng bỉnh	碜
Pang	鄀
phải	必
Cướp bóc	掠
Trong làng	村內
Thẩm phán	地方官
giao diện	接口
Tây An	歅
Basse	巴塞
Trung học phổ thông	高級中學
Muộn	下旬
triết học	哲学
sacaroza	蔗糖
Chín chín	九九
Wei	炜
giới thiệu	薦
uy tín	威望
Triều đại Qin	秦朝
con hàu	蠣
liên hiệp	工会
dạy	教导
Tiểu sử	列传
làn da	皮肤
Chống lại	對其
thuốc độc	毒
Phía đông	東側
Khen ngợi	襒
Bàn giao	交接
Giá trị	数值
Lựa chọn	选拔
Trigulation	三聚
dịch bệnh	疾
măng	箘
ghi âm	錄音
Quận Đông	东区
thảm	地毯
Trang điểm	凑
Sư Tử	利奧
Tường thuật	敍
Tang	踎
suy đồi	頹
chương trình	節目
Hạt Lin	林县
Federer	費德勒
suy nghĩ	思
của tôi	矿
Đại diện lớn	大代表
nấm	菇
Shu	淑
Giám sát	监督
Yan	灩
Hát	飃
Huf	瓪
Truman	杜魯門
Lễ hội	樂節
loạt	級數
Tỉnh lộ	省道
Bungari	保加利亚
Jingshan	景山
Dựng lên	架设
Cộng hưởng từ	磁共振
Phun	娙
Buổi họp đều đặn	常會
Polo	波罗
Cùng tên	齊名
Gây quỹ	集资
Thép	钢铁
Ngôi sao chuỗi chính	主序星
nâng cao	先进
in vivo	体内
Mm	公厘
hổ thẹn	愧
Kumamoto	熊本
Đã chạy	兰经
Peng	蓬
Ferdinand	斐迪南
Học tập	學裏
Không nên	不應
Hezhong	合众
tiêu tan	消散
Vị trí sau	位後
Để ý	通知
chim sẻ	麻雀
Ruf	魯夫
Tổng biên tập	主编
Được dùng cho	用于
Đại học Hồng Kông-Chu Hải-Macao	港珠澳大
Lee	李氏
Thượng nghị viện	參議
tiêu	胡椒
tiếng Nhật	日籍
Năm sinh	生年
Quay lại	復出
cho	對於
nước Thái Lan	泰國
Ander	安德
Bắc Nam	南北向
phòng vệ sinh	廁
chú ý	注意力
Đi đường sắt	武鐵道
Extremadura	埃斯特雷马杜
bóng chuyền	排球
Người đến	人對
khảo sát	调查
qui định	統治
Đi tay trong tay	並進
bột	粉末
Tích trữ	積約
axeton	丙酮
giai đoạn = Stage	朞
tốc biến	闪
Thua	失利
Chụp ảnh	拍照
Pyrenees	比利牛斯省
từng bước một	步步
Trói buộc	縳
hạt dẻ	慄
chịu đựng	忍受
bán	推銷
một vài	幾
Doyle	道尔
Lịch sử thế hệ	代史
Sự hiểu lầm	誤認
con vẹt	鸚鵡
Cái gọi là	所谓
huyết áp	血壓
Dấu phẩy	頓號
món ăn	粮食
axit hydrochloric	盐酸
Khách sạn	酒店
Có thể	可為
Quán cà phê	咖啡店
mục đích	目的
Cầu lông	羽球
Môi trường tự nhiên	自然环境
rung chuyển	擻
Tình trạng	病情
Wan	脘
Kiêu ngạo	惈
Cairo	開羅
Tinh tế	精致
Hội nghị hiệp thương chính trị tỉnh	省政协
RAM	内存
Tám ngày	八日
Lo lắng	惵
Đầu lớn	鳙
Được	得
mạnh	堅強
Sato	佐藤
Người Hồi	回民
Lulu	路路
Celine	席琳
Khó xử	狝
đưa ra	提出
tiêu đề	標題
Máy khoan	钻
chất bẩn	垢
Xấu hổ	匲
tối	晻
Hai năm	二年
Xuân	瑹
Chimei	契美
lụa	绸
Bella	贝拉
chim bồ câu bằng gỗ	鹁
Hu	祦
Chủ đề	线程
chia buồn	喭
và với	並與
Khó xử	祌
Sớm	及早
Tang	軄
ĐT	特尔
Khía cạnh	面體
Thứ sáu	週五
Yi	伂
Tập trung vào	矚
cốc	桮
Lễ hội quân sự	軍節
Mạng internet	网络
Var	瓦省
con ngựa mạnh mẽ	驵
Xuất hiện	出場
Bodo	博多
Trước kia	前身為
Tây tạng	藏
Đầu phía nam	南端
ghi chú	笔记
thuyền tam bản	舢
Bóng chày	蛯
nâu vàng	麑
Vichy	维希
Nhận biết	鑑定
Rong biển	海藻
Gây rắc rốisự tập trung	肇事浓度
Xin	莘
Tiêu thụ	耗
Luôn luôn	一向
San'in	山陰
Nước ngọt	汽水
sườn động vật	胠
Đảng cách mạng	革命党
song song, tương đông	并行
rừng tre	竹林
Xiao	驍
Đến	鼀
hệ thống pháp lý	法制
bậc thầy	师傅
Fu	鑅
Lấy lại	找回
Cho người dân	為民
súng trường	步槍
truyền tải	传输
Và sau	併後
và cả	还有
Mir	米尔
Cộng sự	拍檔
Han	邘
tàn sát	屠杀
Wu	鄔
Châu Á	亚细亚
Yếu	薄弱
hóc môn	激素
Phía tây	西边
Cắm vào	插件
mở	开放
Sẽ hợp nhất	會並
ống sậy	簧管
Chân thành	恳
Con trai	公子
Hướng tây	西向
Xe buýt	公車
Mẹ hoàng hậu	太后
Ra khỏi đám đông	與眾
Baptist	浸信
Shi	氏
niêm phong	密封
Một đơn	一個單
tàu chiến	軍艦
xương	骨
Chủ nghĩa tư bản	资本主义
tà ác	姦
cửa tiệm	店舖
Giải thích là	釋為
Tỉnh Hà Bắc	河北省
nhà kính	溫室
gia tộc	氏族
Đến	緻
cá nhân	個人
Chuyển hướng	分流
Quản trị	施政
Sau cuộc chơi	赛后
Cử nhân	学士
tình hình	狀況
Sau	後的
Phân họ	子科
Sao Diêm Vương	冥王星
Arden	阿登
châm cứu	砭
bực bội	恼
khá	蠻
Tát	彉
hổ thẹn	媿
trứng bọ ngựa	蟭
Âm	恁
Cạnh bên nhau	並列
Hòa hợp	谐
quai hàm	頜
cắt	砍
Mọng nước	絮
mát mẻ	凉
thích hợp	龕
Thành phố Hồng Kông	港城
Thị trấn	乡镇
thợ săn	亨特
Thẻ hoang dã	外卡
Lễ	儀式
từ chức	退位
tàu không gian	飛船
Barcelona	巴塞罗那
Dẫn tới	通往
Utada	宇多田
Máy và	機與
đất liền	大陆
Thuê	雇佣
gián tiếp	間接
số tiền	額
xúi giục	嗾
Kín	受封
Nguy cơ tuyệt chủng	瀕危
锸	锸
Con quay	主軸
Kênh	窜
khu vực	華德
châm chích	螫
Chúa Trời	有神
Sự công bình	義
viện trợ	援
Xi	隰
Phố núi	山镇
Yueshi	月氏
Chế độ nô lệ	奴隶制
Gerry	格麗
lợi ích	得益
vỏ quả	莢
thông thoáng	明朗
quý ông	紳士
Giải thưởng âm nhạc	曲獎
Phi công	试点
Quyên góp	捐款
cung cấp	补给
Đảo	岛
Chúc mừng	賀
quyền lực	勢力
Pi Su	毕苏
đơn độc	茕
Hình ảnh	映像
việc làm	工作
Được phân loại là	划为
con cú	鸱
Kai Kai	歲開
Xô	橎
mười ba	十三
Gai	呪
Lính chì	率兵
Lên bờ	上岸
Qi	俧
Khô	枯
Ganda	干達
Luo	倮
Quân đội chính phủ	政府军
thiếu trách nhiệm	疏忽
Hòa hợp	諧
Thế vận hội quốc tế	國際奧
Tên quận	縣名
Quzhou	衢州
Trưởng lão	长老会
những giọt nước mắt	淚
Cũng được biết đến như là	又稱
Nhà câu lạc bộ	會所
con mồi	捕食
Sách bài hát	詩經
khô	干燥
Xiao Bao	小寶
Trong cấu trúc	構內
Hóa học	化學
Ngày hôm đó	當天
có nghĩa	意为
cua móng ngựa	鱟
Nhìn	瞧
bơ phờ	蔫
Chiến tranh chống Nhật	抗战
Chó gấu trúc	貉
Cơ quan khí tượng	氣象廳
Nhãn hiệu đầy đủ	满分
hài hòa	和諧
Năm triều đại và mười vương quốc	五代十国
Tan	榲
Urawa	浦和
mũi tên với một streamer	矰
Bo	啵
Được đặt tên	名為
Người hâm mộ	粉丝
Dương	垟
mạnh	壮
kế vị	繼位
Tuyết rơi	降雪
đỉnh cao	高峰
Penang	檳
Nam Mỹ	南美
tà ác	邪
căn cứ	垒
Chủng viện	神学院
Starr	士打
Songhua	松花
Lee	李
Cốc thủy tinh	璃
Giữ	留存
Bondage	束缚
Nhặt lên	接
Hạn ngạch	名额
đồng hành	陪伴
Kết thúc	踰
Phần	部曲
Ji	啻
Chắc chắn	確性
Hàn Quốc	高麗
Xie	邉
đi hành hương	朝圣
Tong	驄
đê	碼頭
Steve	史蒂夫
West End	西區
nhiều lần	屡
Hai mươi ngàn	兩萬
tương tự	同样
môi	唇
Gặp	会师
Tổng cộng	总共
锱	錙
Âm	豄
Thanh lọc	淨化
Franchecon	弗朗什孔
Lực kéo	牵引
cuộc đua	賽馬
Chính phủ liên minh	聯合政府
bí ẩn	玄
di chuyển	举动
phòng ngự	防卫
Sự công bình	义
Quân đội	軍的
không chỉ	不仅
Sini	西尼
Tất cả	无不
Xinyang	信阳
xoay	轮流
sự thoải mái	安慰
kẹp	鉗
Chảy qua	流經
Lụa	绡
Uỷ ban	傭
Thích	讚
bang hội	公會
Taitung	臺東
Sự khác biệt	差
hướng Tây	以西
Nhón	搠
Đảng Lao động	工党
Khi nào	時於
thư mục	夾
Trận giao hữu	友谊赛
Tài nguyên	資源
Kẻ bắn tỉa	狙擊
góc	角度
Fukui	福井
Đảng Tiến bộ Dân chủ	民主進步黨
Nấu ăn	库克
bài tập	任務
dược phẩm	药
Bán hàng	销售额
nghiêm ngặt	严谨
nữ hoàng	人後
chim cu	鹃
Nhiều	多種
săn bắt	追
Ca sĩ chính	主唱
phần mềm	软件
sự chuẩn bị	制备
cá tầm	鰉
Lang thang	流浪
tìm ra	查出
lý tưởng	理想
Nhập tiệc	進黨
Phối hợp	結合
Đồ họa	图形
năng lượng hạt nhân	核能
Mạng lưới	絡
New Zealand	新西兰
Sơ cấp	首要
Chất thải	蹉
Nguyên nhân	引致
Yi	閕
bị hỏng	破
giáo xứ	教區
Nguyên nhân	本因
Không bao giờ	不曾
bến đỗ	泊位
đại từ	代詞
Mani	马尼
Nói ra	說出
Shiina	椎名
Drei	德累
Nguyên liệu thô	生素
Ánh sáng	光線
Giờ ô tô	車時
Sóng điện	電波
Ghi nhật ký	伐木
la Mã	罗马
đất canh tác	耕地
Yu Qi	於其
Gall	瘚
Và sử dụng	並用
vấn đề	問題
lộ trình	航线
Cá mú	石斑
điềm tĩnh	平静
vây bắt	罾
Xe nhẹ	轻车
Sản xuất hàng loạt	大量生產
Chính quyền bang	州政府
Tiểu sử quốc gia	國傳
Âm	尹
Trang bị thêm	加裝
㑩	儸
Giường	牀
Ling	珎
Bọn trẻ	少年儿童
Quả bóng vàng	金球
Ngọc bích	敥
Tuổi già	年老
bữa tối	晚餐
Smash	擏
giám sát	監控
thực vật học	植物学
Người giàu nhất	首富
ngầm	潛
lịch trình	进度
nhiễm sắc thể	染色体
Si	玶
Trinh Nữ	處女
mỏ	喙
phất cờ	旖
Tải về	裝設
Thẳng thắn	直达
Mùa	季節
Vòi	龍頭
Kai Tak	啟德
thay thế	更換
Giám sát	監督
Đầu máy điện	電力機車
Zambia	赞比亚
Mang	搭载
mẹ	娘
Khánh Tp.	慶市
Mississippi	密西西比
giẫm đạp	厹
dòng xoáy	洑
kết thúc	结尾
thành phố	城
shad	鲥
Bên kia đại dương	跨海
Đầy màu sắc	多彩
Phụ lục	附件
phần lớn	最為
Kết thúc	終結
méo mó	失真
Hành động như	動為
Yun	恽
di chuyển	挼
Gởi	所發
che	遮
Nguyên nhân lớn	偉業
kiểm tra	考验
Đáy giữa	中底層
chăm chú nhìn	眈
Suy sụp	滀
Bực bội	悾
Công cộng	公立
Lưu huỳnh đioxit	二氧化硫
Dịch vụ thời tiết miền Trung	中央氣象局
rượu ngọt	醴
buồn	淒
sự đánh giá	赏识
Lực lượng và	力與
Clinton	克林顿
Ruili	瑞丽
Tương đối	較為
rất nhiều	許多
Cả hai mặt	两边
khủng bố	怖
Lữ đoàn	大队
Tách ra	分裂
Lực lượng chính	主力
rỉ sét	锈
Anh yêu	達爾
Tìm thấy một quốc gia	開國
lộ trình	車線
thành lập ở	始建于
Phi cơ	航機
Papua New Guinea	巴布亚新几内亚
Chen Shuibian	陳水扁
tại chỗ	当场
quà tặng	禮物
lịch	歷
Thùng rác	宾
Yan	焐
Cái mới	新款
bão	飓
Trận chiến	战列
nốt ruồi	鼴
Cả hai kết thúc	两端
Sôi lên	腖
Dickson	迪生
Xuyên qua	直通
Lập kế hoạch và	計與
Lào	荖
Wendi	文帝
Và biết	而知
Suy sụp	攲
Du Fu	杜甫
cây	树
sự cô lập	隔离
con ma	幽灵
Dace	鯪
Kiểu	型式
Loài	種
Âm	縋
Kéo	拉
Ngày tiếp theo	隔日
Lờ mờ	棦
Giám đốc	处长
hơn	寧
khuyên nhủ	諫
đa dạng	諸
Âm lịch	农历
Thủ lĩnh	酋
biển	溟
giảm	削減
Ống kính	倫斯
Chỉ khi	點時
tùy viên quân sự	武官
giống	喜
Bài hát đầu tiên	頭曲
Q	郄
trung tâm	樞紐
Hoàng Phố	黃埔
Không thích	反感
Cass	卡斯
Cuối cùng	杪
biểu hiện	表情
đầu lâu	头骨
Không thua	不失
Luxembourg	盧森堡
Trường sa	长沙
Ying	璎
CIA	中情局
thùng	桶
Minnesota	明尼蘇達州
Wan	滶
Dầu nhiên liệu	燃油
Trường Khoa học	理学院
Cánh đồng băng	冰原
cảm thấy	感覺
lưỡi liềm	鎌
thuộc về	屬於
Tìm lại	追溯
Yili	伊利
Nhanh	快
A	楗
Tunisia	突尼斯
Bạn bè	友人
Wei Guo	魏国
Bướng bỉnh	攉
nếu	若是
đấu tranh	奋斗
nhàn rỗi	閑
Người dự trữ	斯德哥尔
Giá trị dương	正值
kêu vang	哒
Liverpool	利物浦
Tokaido	東海道
bệnh lao	癆
Lính hạng nặng	重兵
Chế biến	加工
hạ sĩ	下士
ngốc nghếch	懵
Một nửa	半部
Không trên	不上
Galdan	噶尔丹
Khoe khoang	展现
Loel	鳡
Hiếm hoi	珍稀
Đúng rồi	正好
Hình thức	形制
Suy nghĩ	則認為
chạy	奔跑
tĩnh mạch	靜脈
mạng lưới	网
Chiến đấu	作戰
Minnow	鯈
Đúng	是過
chữa khỏi	治癒
bạch tuộc	蛸
Keng	鏗
Âm	覎
Thái giám	太監
sàn nhà	楼
Nguyên tử	覈
Trạm Wai	圍站
Tối	暗色
Yili	伊犁
Hu	禥
Medaka	賉
Yun	鋭
đậu phụng	花生
màu vàng	黄色
Hòa hợp	睦
Thái hậu	太皇太后
Tan	覃
Chơi	发挥
Thẩm phán	判官
sự quyết tâm	决心
Chín một tám	九一八
Tăng	增高
phần	截面
Bạch tạng	阿尔比
Lun	纶
Axit nucleic	核酸
Góa phụ	賏
Yo ~	唷
Tripoli	的黎波里
hình dạng	形状
Athena	雅典娜
Tách rời	分离
đại sảnh	堂
thông suốt	順利
Tài chính	財務
Jacob	雅各
Nhà ga	站场
Rider	车手
Mười nghìn đồng	数万
Sự lúng túng	痳
Muller	穆勒
bộ	镶
đồi không có cây	屺
Wei	韋
kỷ nguyên	紀元
Băng nhóm	硦
Chironco	馳龍科
Đội chủ nhà	家隊
Chị dâu	嫂
Bộ dòng	線設
Bạn cũ	老友
Ổ đỡ trục	轴承
Kuai	蒯
chân thành	真心
Naiji	奈及
cô gái nô lệ	婢
Suy nghĩ	思義
năm trăm	五百
Tại thời điểm này	这时
tiêu đề	封號
Người sáng lập	奠基人
đi dạo	踅
Quốc gia	選國
Mẹ kiếp	肏
Seleucid	塞琉古
dysprosium	鏑
rút lui	退兵
Tăng lên	增至
mạnh mẽ	大力
mập	肥
Bảng chữ cái	字母表
Đại học Bách khoa	理工大
Trường công	公學
Người israel	以色列
pha trộn	搀
Tật nguyền	殘障
Đúng	右側
hơi nước	汽
Nhà toán học	数学家
lượt xem	景
Đi ngược lại	违背
Zhen	縝
giỏ đựng đất	簣
di động	移動
Quạt	番
carat	克拉
con vẹt	鹉
壸	壼
Thu được	增益
nhà chế tạo	生產商
Bảo vệ chống lại	防范
Đồ nội thất	家具
màu xanh da trời	蓝色
Ra trận	開戰
hiếm hoi	罕見
Fran	弗兰
điềm tĩnh	平靜
Yên tĩnh	安生
con chuồn chuồn	蜋
Fuji	富士
Cục phát triển	發展局
Quân cách mạng	革命军
Drian	德里安
Có thể đảo ngược	可逆
Bằng tiến sĩ	博士学位
sự giống nhau	類比
Roma	罗姆
chạy	跑
calabash	蠡
Nghệ thuật	藝術學
Quyền lực	力大
Hagi	萩
Kết hôn	联姻
cưỡi ngựa	蟥
ngọn lửa	爓
Kinh doanh chính thức	公務
sự suy giảm	衰减
Woo	嗚
Hunan	湖南
Đã thuê	受聘
quỳ	跪
Xixiang	西乡
Mô hình	车型
cùn	鈍
Bang	汋
Tham gia vào	参演
Dian	甸
Humboldt	洪堡
Fro	佛罗
ứng cử viên	候选人
Người trả tiền	款人
Lảm nhảm	囈
Biểu tượng	象征
Dưới độ tuổi đó	歲以下
Che mặt	蒙面
nhảy	踉
Gọi cái này	稱這
Người giúp việc	墪
Mối đe dọa	威胁
Teng	滕
hủy hoại	销毁
Wakayama	和歌山
lúa hoang	茭
Hoàng đế	帝時
quán quân	冠軍
Gửi đi	提交
tua	纓
Yi	佁
Chuông báo cháy	火警
Xưởng	工場
Wenlong	文龍
Mou	牟
Minnow	鲦
đặt hàng	次序
Croatia	克罗地亚
Mảng	阵
gian lận	舞弊
Tiệc	酦
nấu ăn	胹
Anto	安托
Hecta	公顷
trở về	重返
Cấp 3	三級
diễn tả	形容
nghe	听
chỉ có	徒
Sting	蜐
Khu vực thành thị	市区
Không	冇
Bao vây	攻城
Khiêm tốn	蹣
Môi trường sống	人居
người lập trình	程序员
Ampoule	瓿
Trong bữa tiệc	党内
đều đặn	定期
Tín hiệu	訊號
Đàm luận	话语
săn bắt	追逐
Diwa	迪瓦
Gibbs	吉布斯
Liên kết	林克
biển Baltic	波罗的海
tập tin	档案
Frederick	弗雷德里克
Tây Đức	西德
Lớp ngoài	外層
Đồng thời	當代
Từ	起于
Hội tụ	交汇
tham gia	出席
Đánh giá	评价
phốt pho	磷
Văn phòng Nội vụ	民政厅
Mag	马格
Delist	除名
Với đội	與隊
Vận hành	營辦
Giải thưởng điện ảnh	奧斯卡金像獎
nồi sắt	鍪
Nhà máy sản xuất	制造厂
Tuabin	轮机
Palma	帕尔马
do	由於
Thay trong	見於
Zhuoshuixi	濁水溪
Cây tầm ma	荨
Nhìn chằm chằm	瞂
Zhi	枀
Ed	埃德
Wenbe	聞部
đầm ấm	襛
Zhongcheng	中丞
Địa chính	地政
Yun	恚
hoa sen	菏
La mắng	訐
Daqing	大庆
quân ngụy	伪军
Màu xanh da trời	布鲁
Gặp gỡ	开会
Đốn hạ	砍伐
mùa hè	夏令
lặng lẽ	悄悄
Được chọn	获选
Phát triển, xây dựng	开展
Để làm cho	来使
chi tiết	詳
Tất cả mọi người	所有人
Maharashtra	马哈拉施特拉
đưa đón	穿梭
tế bào gốc	幹細胞
Không gian tôpô	拓扑空间
Bỏ trốn	逃出
Giữa	間的
ô	細胞
Vùng ngoại ô	郊
thể loại	範疇
hiệu ứng	效應
Hanshu	汉书
xếp hạng	排行
đồng hành	同伴
sinh học	生物學
Sẽ giảm	會減
Cúp vô địch	冠軍盃
Đồn cảnh sát	警局
hy vọng	預期
Nhân dân tệ điều hành	行政院
Người tham gia	参与者
Lượt truy cập	人次為
Hình trụ	圆柱形
Quỷ lùn	侏
Broadway	百老匯
trụ sở chính	司令部
bối cảnh	情景
Juzheng	居正
đi với	去
Ya	枒
Mike	邁克
tài liệu tham khảo	参考
Yomiuri	讀賣
Chuyên nghành	專
cũ	舊
dâu tằm	桑
âm dương	隂
Kêu la	高呼
Cá tráp	鯿
Phi đội	中队
Trái đất	地球
Tôi	吾
tự hào	驕傲
nướng	扒
Tám biểu ngữ	八旗
chi phí thời gian	用時
Đơn vị	分队
ruy-băng	绶
Thành phố rừng	林市
Đôi khi	時也會
Không	溡
Trận bóng đá	足球賽
Niết bàn	涅槃
Vòng	回路
Sting	瞫
Alonso	阿隆索
Ở đằng trước	转发
Khoảng thời gian	時段
Yi	禕
Cư dân	住戶
Chica	芝加
Bolivia	玻利維亞
Máy xới đất	蘗
ngày	日期
Vermont	佛蒙特
Để có được	來獲
Juan	娟
Quận Đào Viên	桃園縣
Tỉnh Thơ	詩省
Ah	呵
Ngoại ngữ	外国语
Ở châu Phi	於非洲
cảm giác xấu hổ	诟
Hu	祄
Bằng tiến sĩ	博士學位
chữ số	數位
tắt	关闭
Weber	韋伯
sa thạch	砂岩
sự phân chia	师团
Đang gọi	現稱
Trong hội trường	殿内
Đường Nam	南路
Anh chị em họ	堂兄
Đến với	想出
Thương vong	死伤
sinh lý	生理
Dòng vào	線進
Phải ở	須在
Bất lợi	劣势
Cái lớn	大者
Mắt trần	肉眼
sự phát triển	進化
bánh bao	餃
biên tập	社论
cù lao	坻
không hài lòng	不满
giữa	间
nhấn	報刊
ga tàu	臺
Sơ bộ	預賽
Luật chung	普通法
Nian	鎿
nhân vật phản diện	反派
Dawei	達為
Pingnan	平南
Cử nhân khoa học	学位
Bao quanh	周边
Zheng En	正恩
bảo vệ	看守
Tổng giáo phận	總教區
hôn	吻
tham mưu	諮詢
người xưa	古人
Ngôn ngữ tiếng anh	英语
Taihu	太湖
Phù hợp	配套
tế tổ tiên hoàng gia	禘
Tuyến tính	線性
Xà lách trộn	斯瓦夫
Hori	堀
ánh trăng	月光
thung lũng núi	嶰
chặt chân	刖
Theo chiều dọc	纵向
tuyển dụng	招收
Nigeria	尼日利亚
tiêu dùng	消費
Trong thị trấn	镇内
Giải thưởng	颁
ngôn ngữ học	语言学
Bất ngờ	想不到
Cora	科拉
Trong nước	海內
Năng lượng cao	高能
Hy Lạp	希腊
mở ra	开拓
Thở dài	慹
lực lượng	強迫
Và cho	並給
Jose	何塞
Ưu tú	精锐
Đây	於這
tre lá mỏng	箊
Kinh điển	典籍
Borneo	婆罗洲
Bướng bỉnh	穋
một chút	稍微
giá bán	價
Fu Jian	苻堅
Tóm tắc	提要
Thân cá	魚體
Đã được chấp nhận	公认
Đã chọn	選中
Tăng	增大
Quân đoàn	军团
Chính xác	對
bỏ trốn	逃
mối thù hận	雠
Tương lai	前途
Siêu mẫu	名模
Chiến tranh	战火
Giảng đường	安非
Okoji	鄂霍次
đời sống	壽
tỉ trọng	密度
Hàm ý	寓意
Không thay đổi	恒
buôn bán	貿
đồng nghiệp	同事
A	一顆
đã sẵn sàng	己
cô đơn	寞
Ngốc nghếch	棆
phần mềm	軟體
Sinh đôi	孪
Bộ tứ	四方
vài	少數
nhiếp ảnh	摄影
Bit và	位及
Áo-Hung	奥匈
chuỗi	連鎖
Topia	托邦
Liên tiếp	先後
Higashiyama	東山
hoàn hảo	完美
lột vỏ	剥
Chậm	為低
phòng thí nghiệm	实验室
tàu đất nung	甗
Ju	莒
Chiết giang	浙江
tang lễ	丧
hình trái xoan	椭圆形
Ding	玎
Tổng	之和
toàn bộ	总数
ngang	横
Nam trung bộ	中南部
Cronies	亲信
đầy	弸
Estonia	愛沙尼亞
hàng đầu	顶
Lu	澞
Chu	漹
Shenzong	神宗
Giới hạn phía Nam	南向
Tần	欽
Sẽ mở	會開
Biểu tượng thành phố	市徽
chùm tia	光束
Bảy ngàn	七千
Xuân	暄
dầu mỡ	油脂
Tra tấn	折磨
Quán quân	狀元
nhưng	不過
Hàm Dương	咸阳
May mắn	運
sự dao động	波動
lỗ thông hơi	泄
Wu Peifu	吴佩孚
Chọn	选用
Ye Lin	叶林
kêu	雹
Công viêc hằng ngày	套路
không thấy	不見
Oise	瓦兹省
Terry	泰利
Thời gian tháng	月時
Cá chép	鲾
anhydrit	酐
Bên ngoài	外接
Đại tá	上校
Cố vấn	慫
Máy xới đất	蘖
Giữa	間設
Ethiopia	埃塞俄比亚
vòng tròn	圈子
Reagan	雷根
bữa ăn	饍
Đừng ngại	不惜
Đôi tay	双手
dịch vụ	服务
Âm	鬛
có	具有
Henry VIII	亨利八世
Vương triều Bourbon	波旁王朝
Yun	韫
Các mặt hàng	貨物
Quấy rối	骚扰
xe lửa	火車
mong manh	脆弱
Kiêu ngạo	戧
Đốt cháy	燃
chung	将领
Choco	喬科
Jackson	傑克森
Giải đấu chính	大聯盟
Wuchen	戊辰
Mara	马拉
mứt	薯
Yueshan	月山
Cưỡi người phục vụ	騎常侍
đầy	充滿
Brachial	肱
sự định hướng	取向
củ cải	萝
Đóng cọc	枑
Phiên bản trường	場版
quả bóng bay	气球
nóng bức	燙
Tan chảy	熔融
thân hình	體
Xây dựng	大楼
Chân	腿部
nông nghiệp	农业
Pansy	堇
chất lượng	品質
Tất cả	遍佈
Nguồn gốc	根部
Ervi	爾維
Ý tưởng	构思
Hãy đếm	來計
Gia Khánh	嘉慶
cởi quần áo	裎
thứ mười bảy	第十七
Cùng ngày	同日
Hỗ trợ	助攻
Cục đường sắt	铁路局
nhiễu xạ	衍射
Nhà ở	家庄
Đáp lại	回答
Aha	艾哈
Deng Li	鄧麗
ở lại	逗留
Xe buýt Kowloon	九龍巴士
Natal	娘家
Gần với	緊鄰
Chết trong nhiệm vụ	殉職
Qi	笒
Vitamin	维生素
Sao Thiên Vương	天王星
nhân chứng	见证
Xie	燀
Cá sấu	鱷魚
Zhongnanhai	中南海
Ly thân	相隔
Độc thân	單
tiềm năng	前景
việc làm	雇用
con kiến	螞蟻
Giành được	圜
Sự nghiệp chính thức	仕途
Phân công lao động	分工
Theo sát	後續
cột đá	磉
Đánh nhau	交战
màu tím	紫
Quang phổ	譜
Chia sẻ	佔有率
Texas	克薩斯
Ba mặt hàng	三項
Văn phòng công cộng	公所
Kẻ thù	敌方
He Wentian	何文田
Đi dạo	踺
Cá đuối	魟
Akamatsu	赤松
khoáng sản	礞
biên soạn	汇编
Năm mới	新春
đại sảnh	會館
Khu vực danh lam thắng cảnh	名胜区
Rhineland	莱茵兰
Moo	檖
Đại lý du lịch	旅行社
Elizabeth	伊丽莎白
Có nghĩa	指
Aken	阿肯
chuyến đi	絆
Hát	蜄
Quân đội	軍於
Buồn phiền	倹
Tây Giang	西江
chính quyền	當局
cái mũi	鼻子
Dương	煬
Trung bình	媒介
nguyên	原文
Nhà kho	捨
Yu	禹
Xin	莿
Nấm ngoài da	癬
mồi câu	饵
con hàu	鲒
nó	它
Khuyết tật	殘疾
Chín ngày	九日
phòng thủ	辩护
Chạy xuyên qua	縱貫
Nhìn vào	燝
Quy định	規定
sư tử	狮子
thành phố	城市
kiệt tác	名著
Combiner	合器
Trang Chủ	家口
Tiền vệ	中场
Bố là	父親為
sòng bạc	賭場
Xấu hổ	熞
Fuhr	弗尔
khối lập phương	立方
㑩 Ji	儸紀
rạp hát	剧院
đã chết	死
Trung Quốc	华夏
San hô biển	珊瑚海
Từ chối	摒
Xấu xí	烗
Đây là	這就是
Ghi chép lịch sử	史记
Tấn	音色
Naginata	薙
Tỉnh bắc	北省
đội trưởng	船长
Altai	阿爾泰
thu nhỏ	微型
Gầm	嚗
hình chữ nhật	长方形
Yudong	由東
Môi trường sống	栖
pha trộn	拌
ấm lên	熱身
Vận chuyển	载体
E	峨
Liên kết	环节
rất	甚
Sau chuyến đi	行後
Ôm	坽
lỗi	紕
Sương mù	靄
đất hoang	荒地
trò chuyện	交谈
Nấu nướng	飪
Zong Xian	宗憲
Yuan Shao	袁绍
Đối với hệ thống	為製
Cái này	這顆
Blau	布劳
Đấu trường	賽場
Si	兕
nghĩa là	意味
vật lộn	跤
Max	麦克斯
Giữ	所擁
Hóa chất	化物
Dâm bụt	芙蓉
Quản thúc tại gia	軟禁
Ủy quyền	授權
Khác nhau	不一
Làn đường	莱恩
hàng quý	季刊
Viết tắt	縮寫為
Lena	萊納
sự hiểu lầm	误解
chết vì đói	莩
Dòng số	號綫
Phong	灃
Mở rộng	引申
Strath	斯特拉斯
Naruto	火影忍者
nếm thử	噉
Tìm hiểu và	學和
Sạc điện	罪名
ôxy	氧氣
Cordor	科多尔省
biểu hiện	表達
trái	向左
ba mươi	三十
ngạc nhiên	诧
Không dành cho	不為
Giá trị	價值觀
Chăm sóc sau	善後
Yi	彝
Sẽ quyết định	會決
bất kể	无论
Định tính	質學
Xiang	襄
Và thế hệ	而代
khuôn mặt	面目
liên lạc	往來
Lê	勒
đỏ	紅
Leland	利蘭
Đồng hành	伴奏
Cửa sông	出海口
Gọi là	之稱
Yêu và quý	热爱
Phía đông	的東
Ying	颍
Zhuang Gong	莊公
Yanbian	延边
Toàn diện	综合
quá	超过
Mất đi	失傳
Không khỏe	不適
dãy núi	巒
Muộn	後發
vịt trời	鳧
một lần nữa	再次
nữ thần	女神
Còng	輷
Có thể nói	可說
Juan	鄄
Tsk	茨克
Toronto	多倫多
Tối cao	至尊
Ngu độn	茂密
Tsuta	蔦
Yun	蟟
Ngôn ngữ	语言
Sở hữu toàn	全資
đôla Hong Kong	港元
Chơi chữ	誴
Orc	獸人
kim giây	二手
York	约克
Cơ điện	机电
Zexu	則徐
Sức mạnh quốc gia	國勢
Thép cây	钢筋
số nguyên tố	素数
Zhang	漳
Loại là	型為
bộ lọc	滤波器
đổi tên thành	更名為
Zhu	筶
mã	法典
lát	切片
Florida	佛罗里达州
Đáng để nói về	值得一提
Hôi	涷
Bashan	巴山
Học viện	院制
Foley	弗利
Chung	般
Trưởng	謀長
Cột	專欄
Đuôi	尾部
Muromachi	室町
Cùng tên	同名
Quách Công	國公
cộng hưởng	共振
Biên dịch	编纂
luôn luôn	歷來
Ý định ban đầu	原意
hàng đầu	頂部
hướng Tây	西面
Norman	諾曼
quân cảnh	宪兵
Đến lượt	依次
cố gắng	試圖
sự trừng phạt	懲罰
Tranh luận	論證
con kênh	漕
bàn chải tre cho đồ dùng	筅
ban đầu	初始
con kiến	螘
Sau	時後
đôi pho vơi	處理
Đàm phán	协商
sự phấn khích	激動
Tran	遄
Đặt hàng	訂單
còn lại	遺體
có dây	有线
Sisi	西西
bối rối	困惑
đau	傷
Chuyển sang	改用
sự liên kết	協會
áo mưa	襫
Thành phố Thạch Gia Trang	石家庄市
cấp độ	水准
Có xu hướng	趋
trục trặc	故障
Giày	鞋子
Ag	阿格
Zhili	直隸
đại sứ quán	大使館
khao khát	愿望
Các triệu chứng	症候
sách	書籍
Loài đặc hữu	特有种
Đen và trắng	黑白
Tính cách	角色
Sự bảo tồn	守恒
Không có trở ngại	無障
biến thể	变种
Người đặc biệt	特人
Giải thưởng vàng	金奖
Buổi triển lãm	会展
Hoàng Gia	保皇
Yan	讌
bỏ trốn	逭
Siemens	西門子
Đẹp	漂亮
Đại học Công nghệ	工大
Hai lớn	兩大
Li	琍
Columbine	耧
lệnh cấm	禁
Myanmar	緬
gốc	由来
chất lượng cao	優質
Cấp tiến	漸進
Thanh nhạc	声乐
sự khởi tạo	初始化
Nấu nướng	料理
nghĩa trang	墓地
Ketu	克图
nhung	绒
Mũi	鼻部
món thịt hầm	熂
ngã	墮
Ngoài giới hạn	越界
Trọn bộ	全套
Đánh bại	大敗
Bão nhiệt đới	熱帶風暴
ẩn giấu	隐藏
ASEAN	东盟
Richard	理查德
Yun	贇
tinh tinh	黑猩猩
Michigan	密歇根州
hiện đại	摩登
đi xe đạp	循環
Fran	佛朗
Dade	大德
Lông đuôi	尾羽
danh tiếng	名氣
Jack	杰克
Chủ tịch	委员长
ban nhạc	带
诰	诰
Số lượng hàng	行量
Kho bạc	國庫
mở	開
Các vị thần	神灵
Thái độ	姿态
sự trì hoãn	拖延
Khối u	腫瘤
loài	種類
Suo	総
trẻ	年轻
chỉ	恰
Macao	澳门
xung quanh	四處
thần đồng	神童
căn bản	激进
Nằm	地處
Labra	拉布拉
Một bài	一職
tông đồ	使徒
Quy định	規
ngựa cái	騋
Cây kê	鍻
Nguyên	原创
chủ nhân	雇主
Chuyển tới	移往
Mang	驮
Máy xới đất	蒂勒
Qingming	清明
Pingshan	屏山
Tân trang	整修
khuyên nhủ	俛
Scull	湩
nghèo	穷
tình hình	境地
Hoa Kỳ	合眾國
Trường mới	新派
Wei	崝
cây kim	針
lớp trên	上层
Một nắm đầy tay	掬
hầm	窖
Tàn phá	朆
Thương tiếc	鮡
Đồng minh	盟国
Daimyo	大名
Hiệu ứng đặc biệt	特效
Viết tắt	简称
phòng thủ	保卫
Jiang Jingguo	蔣經國
công cộng	公开
Kế tiếp	接连
phục vụ	獻
chịu	承擔
Kết nối	銜接
Hum	嘤
Cố gắng lên	力图
thẩm phán	裁判官
Nhà kho	蛻
Bí mật	泌
Ở ngoài	门外
Viết	撰稿
Khướu	鶥
Giống như	同為
Tinh vi	精良
Hạt giống như	株式
Âm	蟺
Đẹp	靓
khách hàng	顧客
Nhạc rock	摇滚乐
Bài hát	宋
rắc	酹
mynah	鹆
sản phẩm	积
nọc độc	毒液
đần độn	駑
ánh sáng mặt trời	阳光
Rối loạn	失調
pha loãng	稀
cánh đồng	田
Tây Thành phố	西城
sưu tầm	蒐集
Lúc bắt đầu	伊始
Vật đúc	铸造
Hợp chất	化合物
Đơn nam	男单
bùn lầy	溷
Phòng giao dịch	务局
Hợp đồng	約定
nổi bật	引人注目
mang	攜帶
Năm sau	次年
Bê tông	砼
cung cấp bởi	供電
Đền thờ tổ tiên	祖廟
Mời vào	來進
nữ hoàng	皇后
mồm	口
Uỷ ban	委
Jubilee	禧
Zhang	昹
Tung và quay	辗转
chặt chẽ	严密
Vào	轉變為
Lun	仑
khí ga	瓦斯
khó phát âm	聱
Han	涵
Nhận nuôi	領養
Yannian	延年
Thung lũng	谷
Francis	弗朗西斯
bài báo	文章
Scotland	蘇格蘭
đồng cỏ	草甸
Nắm bắt	攅
California	加利福尼亚州
đá hoa	大理石
bồn rửa	下沉
run sợ	颤
khoảng thời gian	间隔
Mã quốc gia	国号
Chính trị	政界
Sẽ nâng	會舉
Tẩy	去掉
Hệ tư tưởng	意识形态
màu sắc	色彩
Trong	处于
Ni	坭
Và	者與
Võ sĩ quyền Anh	庚子
Ấm áp	暧
Tiết niệu	泌尿
khu mua sắm	商场
Rau diếp	苣
đồn trú	驻军
dây thanh âm	聲帶
đầu ra	产出
Mới	纽
Cơ quan chính phủ	政府部门
Zhu	毴
Do nhà nước điều hành	國營
lạc đà	駝
Nước hiệp ước	約國
súng máy	機槍
Phần thưởng	璊
Cánh cổng	閘門
Xấu hổ	嶙
Trung cấp	半山
khuyên nhủ	劝
gia đình	家人
Fenspat	长石
Chiều dài cơ thể	体长
chuyển khoản	轉移
Yi	岽
Phát biểu	語發
cũng	连
chỉ huy	指挥
giữa	之間
không phải	毌
Da	逩
giữ lấy	搦
Ed	爱德
khổng lồ	巨大
Góa phụ	遺孀
Yell	嚿
giữ	抱
quyền lực	势力
bước đi	踏
Kết thúc	尽头
Đề cập	提及
buổi hòa nhạc	演唱会
Đoạn cuối	末段
Yu	峋
Bỏ lỡ	無緣
Người sử dụng	用者
mập	胖
Bản thảo	文稿
Xi	汭
Tiannan	天南
Lưu trữ	牽制
Muộn	后期
phổ cập	通用
Ngày 4 tháng 6	六四
Yuanhua	元化
Dài	旯
Herak	赫拉克
Thuộc tính	属性
Bài hát nhịp	吟
thân hình	体
giá bán	價格
hội đồng thành phố	市政局
sâu	淵
lấy bằng vũ lực	掯
Tây An	荎
xe hơi	汽车
góc	角
Chim rồng	鳥龍
Malaya	馬來亞
Kashan	卡山
Klee	克利
bãi đậu xe	停車
tù nhân	俘虜
Toàn diện	綜合
Được phân phối trong	分佈於
Bản thảo đầu tiên	初稿
dãy núi	峦
Và tương tự	並同
Xây dựng	大樓
Oracle	甲骨
Thiên thể	天體
chất đạm	蛋白質
Yan	琰
Hedong	河东
Biên dịch	纂
Đã xem	見的
Cua	蟹属
Hiển thị trên	節目於
Quân đội	軍軍
Shan	駞
Lớp học	上课
Trở về	交還
khử trùng	消毒
Lí trí	心意
Jie	颉
Quán ba	吧
Quỹ	出资
Học bổng	学金
Zhao's	趙氏
Che	摀
Dược phẩm	薬
dán	贴
Jian	蠭
Phiền muộn	瞗
Shao	鯏
cung điện	殿堂
Vũ trụ	乾坤
Quay lại	後轉
Thẳng đứng	正直
Lô hàng	批
ngai vàng	寶座
trái cam	橙色
ngã tư	十字路口
đáy	底
Vé cao	高票
Hải cảng	港灣
lười biếng	嬾
Hảo	暠
Thùng rác	斌
Hết	出乎
Đồng hồ đeo tay	觀看
Toronto	多伦多
ung thư	癌
chim	鳥
sự tin tưởng	信念
bỏ rơi	朅
Nhiều thứ	物
Bao	萨克
Lu	滧
Qingjiang	清江
Gu	崮
leo	攀
ngủ nướng	位於
Lạm phát	貨膨脹
Bahrain	巴林
Tianshi	田市
Mao	茆
nốt ruồi	鼢
Chuyên gia	專科
thuê	出租
sự vi phạm	違反
ngang	橫
Kỹ thuật số	數碼
Issa	伊莎
Máy trục	克蘭
Đến	蕀
xa	远
Thư ký	書記
Quân đội	军部
Tennessee	田纳
Linh hồn	心灵
Phần Lan	芬兰
Chán	膛
Sắp chết	临终
Yi	峄
Shunji	順治
Cá cơm	鳮
ngốc nghếch	笨
Dazhou	達州
Cố gắng lên	盡量
Bố trí	版面
Miyaka	宫中
Quả cầu	球体
Asahi	朝日
Đông Phi	東非
uy tín	声望
Duyệt qua	浏
Hami	哈密
Chạy	潤
trọng tài	裁判
Stu	斯圖
Truyên thông	传统
chuyển khoản	轉職
Cá cha	父魚
Yu	顗
câu đố	謎
Quận Ke	克县
Chơi chữ	牪
thần kinh	神经
Zhu	苽
Hạ gục	拿下
Tang	郻
Posterity	後世
Giảm giá	买卖
Các tập	劇集
cân bằng	均衡
phép lịch sự	禮儀
Mo	莫
Tiểu bang đông	州東
Bắt chước	倣
Chết	遇難
cái cốc	觶
Xây dựng	厦
Tìm thấy	查找
Bi	濞
Dựa vào	凭借
Gary	加里
mùi thịt cừu	膻
Theo dõi	追查
bạn	你
học bổng	奖学金
lũ lụt	洪水
bộ	套
Quốc gia	民族
hát	唱
Li'an	利安
Sự giàu có	富貴
Shan	鯾
Nhanh	迅
Đánh vần	拼
Phim tài liệu	纪录片
Mọi người	人民
Chiến tranh	大战
Đau khổ	受害
rút ra	揄
Né tránh	道奇
giám đốc	理事
Istan	伊斯坦
Sui	隋
Náo loạn dân sự	民變
Để nó đi	任其
Đi họp	上會
Hai lớp	雙層
Xa Xăm	远远
chuyên nghành	專門
Trong miệng	口中
Thể loại	曲風
Năm ngoái	上年
tập trung	集中
hai	二
Quận Ne	讷区
Xâm lược Trung Quốc	侵华
Một nguyên tử hydro	氢原子
chuyên chở	傳達
Ghi chép lịch sử	史記
gáo	杓
Lan Guo	蘭國
Đôi pho vơi	对付
lừa dối	譎
Đồ đá	炻
Trạm thủy điện	水电站
Chữ ký	署名
Thuê	聘用
Đi đến quyết định	來決
Phấn đấu	争取
Qatar	卡塔尔
Giáo sĩ	神职人员
điện thoại	電話
Vịnh Discovery	愉景灣
Hội trường tổ tiên	祠堂
hafnium	鉿
lực lượng	逼迫
Vươn xa	深遠
Cologne	科隆
tội phạm	刑事
Xinchang	新昌
Châu Âu	欧洲
cm	厘米
Tây tạng	藏傳
Berkeley	伯克利
hình phạt	刑罚
Nghèo	逊
cử tri	选民
Hở	诶
câu hỏi	質疑
đạo đức	倫理
Tachibana	立花
hậu tố	后缀
Bực bội	怴
Hube	户部
đan lát	篳
cừu	羔
Sau đó	則以
Tiếp tục	續進
Sóng hấp dẫn	引力波
Một vài	毫
Huấn luyện	輔導
Wu	烏
Tân Hoa Xã	新华
Cùng nhau xây dựng	共建
Tiêu	度過
Longxi	陇西
rèm trong xe	幨
mục đích	瞄準
Xi	憖
Naruto	火影
Vấn đề	頒發
Trang Chủ	家園
Khu vực này	此區
báo thức	警报
Yu	顕
mơ	梦
sự phát triển	进化
sự sụp đổ	瓦解
Nhà ngoại giao	外交家
Đồ khốn	鲊
Cuối năm	年尾
Nhân dân nhật báo	人民日报
dựa vào	依賴
Lớp học	綱
Chuanshi	川市
bạch Mã	骠
không đồng nhất	异构
cây bút	筆
Cơ động	機動
chim chích chòe than	鶯
Tự bảo vệ	自保
Bayu	鲅
Cao cấp	高档
Ngày tiếp theo	隔天
đặt	搁
Thương tiếc	殇
xếp hàng	阵容
Máy bay quân sự	軍機
Âm	禐
Diễn viên chính	主演
Hun	鋋
Hệ thống nước	水系
Trung Quốc TV	華視
Lương tâm	良知
Bavari	巴伐
Li	坜
Chia tay	掲
bỏ cuộc	捨棄
Tháng đầu tiên	正月
xoắn lại	跧
con lửng	貆
Con rắn	蛇科
kg	千克
Suy sụp	攕
Thành phố Trịnh Châu	郑州市
Song Yuan	宋元
Lào	娯
chông chênh	傞
Đất	壤
Gou	苟
Bóng chày chuyên nghiệp	職棒
mơ hồ	含糊
dây	缗
Sau đó	遂
Người nước ngoài	外國人
Gia ban	售價
Và và	並和
Liên tiếp	历任
Lande	朗德
Sekihara	關原
điện tử	電子
Shin	脛
Wan	闋
miệng	口头
sự phát triển	演化
Thức ăn thừa	剩
Đầu ngựa	馬頭
Làm nhiệm vụ	執勤
chuyên môn	專責
Ý định ban đầu	本意
Người giúp việc	媭
Để kỷ niệm	為慶
Chuyển tới	轉往
Cởi trói	解開
lập dị	淫
Quân đội	大军
nòng nọc	蚪
chất lượng	質量
Vịnh mỏ đá	鰂魚涌
mở	敞
Gothenburg	哥德堡
bát	钵
Giá cả	費用
Chuyến thăm	到訪
Dài	耢
Constantinople	君士坦丁堡
Mêtan	甲烷
đào tạo	訓練
Bảng xếp hạng	排行榜
liếm	餂
Yên tĩnh	蛤科
Mặt trời mọc	旭日
Mossan	莫桑
Đồng minh	同盟国
hen suyễn	喘
Hân Hân	韩寒
Bay bổng	高漲
Vua Tần	秦王
khám phá	探索
Tan	鑯
Tiếp xúc	洽
Không	無
Báo chí	报社
ba mươi chín	三十九
Ngoại ô phía nam	南郊
Mảnh vụn	屑
giày da	鞮
con đường	之路
bất tiện	不便
Đôi nữ	女双
kẻ ám sát	刺客
Hạ cấp	降格
chinh no	自身
Với	與該
trả lại	偿还
U ám	鬱
Đỉnh	峰值
Chết tiệt	蘛
Tiền vay	外借
cống vật	貢
Ngừng	停產
Teco	特科
Hu	牤
Cá rô	鱸亞
khảo cổ học	考古
Đối với	為在
Cassander	卡山德
nói dối	誑
Dài	泚
Vĩnh Khang	永康
thường xuyênnếm thử	往往嘗
Dành riêng cho	献给
Quan	鮘
Giả vờ	搪
phòng không	防空
để không	以免
Hội trường tưởng niệm	纪念堂
Lớp học	階層
sử dụng	利用
Xấu hổ	赩
Chết trong trận chiến	戰死
hư hại	損傷
Thứ hai	次级
Du học	留學
Tes	特斯
Sự lão hóa	老化
Danh pháp	命名法
sốc	震动
nâng cao	预先
Xuống dưới dạng	下為
Massachusetts	薩諸
đậu	豆
trong quá khứ	以往
tim	心臟
Chiều dài là	長度為
Eizong	英宗
nộp hồ sơ	归顺
Photon	光子
Baishan	白山
Giai cấp tư sản	資產階級
lái xe	敺
Khánh thành	创刊
Hu	喿
Shicai	世才
Cứu giúp	幫助
viết	撰写
Tại đó	在該
con dê	山羊
Dòng chính	正线
van	閥
vỏ của ấm ba chân	鼏
Chu	莸
Tích cực	正向
ăn năn	忏
Kai	锴
Trường hợp	案例
đường đi bộ	人行道
tuổi thọ	长寿
xấu	惡劣
Cistanche	苁
Đặt trên	書於
hoạt động	活性
tác dụng phụ	副作用
Cửa hàng	精品
Tê liệt	癱
Cộng sản	共产党员
Gạo nếp	醤
Dài	瓏
thiên tai	殃
Bộ sưu tập	典藏
hội họa và thư pháp	书画
Chúa vĩ đại	大神
Tám	八大
Tháng sáu	俊
Jacob	雅各布
Kết án	判處
Độ C	攝氏
thở dài	嘆
Mingdi	明帝
sản xuất	生产
khen ngợi	稱讚
Kiêu ngạo	旃
Quản trị	治所
tiêu đề	称谓
Ye	俒
Azulene	薁
Không khí	艾尔
Của tôi	水雷
Liu Mingchuan	劉銘傳
Chế biến gỗ	木工
Con khỉ đột	大猩猩
Lương thực	主食
Diode	二極體
điếc	聾
Lợi nhuận	獲利
thế hệ	代
mặt trời	孫
công viên	園區
nhãn cầu	眼球
Polo	波羅
trẻ sơ sinh	新生
Taki	滝
Pháo đài	堡壘
Qi	秢
trang điểm	诌
Axit photphoric	磷酸
Westminster	威斯敏
TV không dây	無線電視
ngập úng	涝
giải quyết	置地
dự trữ	储备
khí ga	加油站
Bình	盆
Phong cách chơi	打法
Ờ	洱
Sao Hoả	战神
Vids	西元
trường học	學派
Liền kề	毗邻
Đội tuyển trẻ	青年队
cánh đồng	田野
Cuộc sống riêng tư	私生活
có lẽ	或許
Gothic	哥特
Xác chết	尸体
quân đội	兵力
Đời sống	命
du lịch	游历
cá nhân	親身
Suối	流的
tính toán	筭
Cho Han	為漢
Sau khi rời đi	出後
Tong	鼗
Ấp Lôi Châu	鴨脷洲
Với Xu	與許
con mắt	眼
Haute-Garonne	上加龙省
ung thư	癌症
Nghiêm khắc	為嚴
tập thể	集体
Chủ tịch	主任委员
Giữ	握有
thông qua	途經
sau đó	当年
Hẹn hò	拍拖
chuyến thăm	訪
Ba mươi hai	三十二
Sau Ji	紀後
Dia	地亞
Sự phẫn nộ	憤怒
Dakota	达科他州
Xe chung	聯車
ghẻ	鬁
Nước Tần	秦國
nhiều lần	再三
Suy sụp	悳
Gương mẫu	示范性
Tất cả	遍布
lừa	戲法
Bị giết	被殺
bàn thờ	壇
Nhượng bộ	特许
Khối	阻隔
ngốc nghếch	蠢
Zhan	枬
Khảo sát	勘察
Quân đội Taiping	太平军
Bến tàu	船塢
Âm	妱
bán đảo Malaysia	马来半岛
Cống vật	朝贡
Nhưng điều này	但這
Bị liên lụy	涉案
Được kiểm soát	有制
bị cô lập	孤立
Niên kim	年金
Miễn	免除
củng cố	加強
Tức giận	大怒
nhiều	眾多
Sulcus	疌
Thời chiến	战时
Vấn đề	發放
Bùn	泥沙
cuộc đua	種族
thì thầm	呤
Edo	江戶
Hai mươi tám	二八
cổ điển	古典
Tchaikovsky	柴可夫斯基
có thể	可
Châm ngôn	校训
An toàn	平安
Tịch thu	没收
Tổng tư lệnh	总司令
Jianchang	建昌
Artemisia	蒿
nghèo nàn	贫穷
Tole	托莱
Tiệc	銏
Su	苏
công viên	公園
kháng thể	抗體
Ghét bỏ	谪
Đến Kwa Wan	土瓜灣
Anda	安達
chia sẻ nó	分享
Sản phẩm này	本品
Sof	索夫
Căn cứ	接地
Hạt Ma	馬縣
Bố	琶
Hiệp sĩ	骑士团
Xue	薛
Lu Jun	路军
Từ thiện	慈善機構
Cộng sinh	共生
Thống trị	霸
dịp	場合
Hủy diệt	殲
Chồng cũ	前夫
Bất động sản	物業
Huỷ bỏ	中止
Alice	艾莉絲
Ji	凵
Kwong	邝
hươu xạ	麝
xe ngựa	辂
Thư ký	秘書
mẹ	咪
Tehei	德黑
Thời thơ ấu	小時候
Vội vàng	闖
Toàn bộ	總面
Bất khả chiến bại	不敵
Đội	该队
Vui mừng	訢
thuyền tam bản	舨
Chấm dứt	解約
Công nghiệp nặng	重工業
Indino	吲
China East	中國東
Với cùng	與同
Liên kết	債券
không ký tên	慥
Suy sụp	旔
Ở đâu	該處
Bốn người	四足
Tư tưởng Trạch Đông	泽东思想
Tin tức	消息
qua nối chồng	重疊
Nhón	厐
Trùng Khánh	渝
Đài Bắc	臺北
cuối cùng	最終
Andromeda	仙女座
trình độ	程度
di cư	遷移
Jinshi	進士
Chạy trốn	出走
Xin	馨
Chu	滁
Chúng tôi đúng	們對
ghế đẩu	凳
Ke	恪
Gyeonggi	京畿
Sau đó	則於
Shiraishi	白石
nơi cư trú	住所
phai màu	褪
Làm văng ra	三振
Tường	华尔
Tên	該名
lạy	疐
pháo binh	火炮
Có thể so sánh được	媲美
khói từ sự hy sinh	焄
Chỉ định	指明
Cho mọi người	讓人
Jia	伽
Lin	霖
ký ức	記憶
tiếng Đức	德國第
tất cả	全
Hydrogenase	氢酶
Euclid	欧几里
bờ biển	岸边
Át chủ	艾斯
Zhu	渚
Jiangzhen	江镇
Cháy	燘
Phiên mã	轉錄
Thống đốc	州长
Thiệu Hưng	绍兴
Uy tín	威
Đã chạy	蘭經
bảo trì	保養
Chịu trách nhiệm	负责
Phật sơn	佛山
Xung quanh	繞
Qishan	旗山
Tang	菙
Địa điểm	安放
nấu ăn	煮
nhà máy	工厂
Suzuki	鈴木
đột ngột	奄
Không có gì	无可
Chức vụ	立場
Giả định	設
Máy chơi game	游戏机
Kế vị	嗣位
Dâng trào	急升
sự mở rộng	延期
Ga Bắc Kinh	北京站
tòa tháp cao	高台
Ý nghĩa	谛
Quần đảo	諸島
Cacbon monoxit	一氧化碳
Lịch	历法
Co lại	縮小
Martin	馬丁
Bán hàng	销量
Đông Nhật Bản	東日本
dị dạng	畸形
Tuyến phòng thủ	防線
Surabaya	泗水
phòng tang lễ	殯儀館
hertz	赫兹
Nhà tù	关押
màu tím	紫色
Hu	讠
Gạo nếp	醡
Chính thức hóa	形式化
thầy tu	祭司
Utopia	乌托邦
Nan	覕
Tan Yong	譚詠
Đã đổi tên	改称
Mảng bám	匾
Nhiều hơn và nhiều hơn nữa	越來
Kouzhen	口镇
Goode	古德
Bắn	拍攝
cực	極端
gia đình	家庭
Yếu	弱勢
Cây thuốc phiện	甖
Hoa loa kèn	鹝
Tỉnh Shiga	滋賀縣
Cá bơn	鮃
Đọc to	宣讀
Cá chim	鲽
kho	囷
thứ hai	第二
Trung gian	调停
đảng cầm quyền	执政党
Holstein	荷尔斯泰
kỹ lưỡng	彻
Bình yên	平和
dự án	项目
Tham quan	来访
Actinium	錒
Cứu trợ thiên tai	賑災
Tổ chức	籌組
Trong vòng	的內
tan chảy	铄
Dịch chuyển đỏ	紅移
Thiết bị đầu cuối	航廈
Ứng dụng	報考
chấm dứt	終止
Trở lại	揹
Peiping	北平
Tổ chức	宪法
Sảnh chính	本堂
Hu	妯
tiên phong	先鋒
Sâu	蠋
Xe lửa	訓
Nam giới	牡
Shan	颩
Shao	邵
Bao quanh	周邊
Mơ hồ	洇
cây kim	针
Karls	卡尔斯
Hamming	海明
Lỗ Tấn	魯迅
Đàn áp	剿
năm	年份
Gọi chung	合称
km	千米
Ngoại kiều	疏远
móc câu	鈎
Qi Rui	祺瑞
Ghét bỏ	謫
Cannes	戛纳
Tại thời điểm đó	那时
khí thải	排放
Có thể	可将
Tro	阿士
tổ	窠
mẫu Anh	英亩
Tsamp	糌
tiếng địa phương	白話
Linh hồn	魄
Riêng tư	民營
cải tiến	改善
Vấn đề nông thôn	鄉事
sư tử	蓸
Jiangwan	江湾
than cốc	焦
bạch dương	桦
Do Thái	犹太人
Bốn mươi bốn	四十四
Xuân	烇
titan	鈦
chim đa đa	鸪
Âm	礑
Zheng	峥
nghệ thuật	憸
Sau thảm họa	災後
không may	不幸
Shunting	调车
Stanley	赤柱
Tencent	腾讯
Jing	荆
Người ấn	德西
Tầm trung	中程
lối đi bộ	徯
Đến vùng quê, đất nước	對國
số phận	命运
Nguyên tố của cuộc sống	壮年
Ba năm	三年
Cũng được thiết lập	還設
Gái điếm	嫡
Thuế	税收
Tháp chuông	钟楼
thác	級聯
Hun	獫
chính phủ quốc gia	國府
Chen Yi	陳奕
Quận	县域
Arkansas	阿肯色
Cấp dưới	麾下
Đổi lấy	担当
Manchester United	曼聯
cảnh giác	警惕
máy bay ném bom	轰炸机
đốt cháy	燒毀
Sông Ka	卡河
cản trở	壅
Cắt	剉
Nam	纳姆
cứu hộ	捄
Đầu vào	輸入法
Hoàng tử	親王
Hu	躦
hư hại	破壞
Nhãn hiệu	商標
Gao	臯
Máy dò	测器
Hai cái kia	另外兩
Hợp Phì	合肥
Phụ trách	主理
Khu kinh doanh	業區
Trong khoảng	量約
số tiền	额
aka	或稱
sao Hải vương	海王星
Yale	耶鲁
Wong Tai Sin	黃大仙
Ông chủ	上司
Mazu	馬祖
giá ba chân	鼎
Bảo vệ	後衛
Tù nhân	囚
làm vườn	园艺
Chống lại viện trợ của Mỹ cho Hàn Quốc	抗美援朝
tác phẩm nghệ thuật	艺术品
Marshall	马歇尔
phân loại	分类
và sau đó	进而
tạp chí	彈匣
Căng ra	拻
Tham gia	與會
thờ cúng	禮拜
Sâu	蝚
trắng	皑
Chết	亡
Hai tuần	兩週
giày trượt băng	滑冰
Tham gia nhóm	隊參
Quận Giang	江区
Khác nhau	紛紜
nhà ở	宅
Sco	斯科
Giác ngộ	启蒙
Quên ghi	忘錄
Sự phẫn nộ	瞋
Trường học	校本
Keheng	顆恆
Hei	鶡
phân loại	分類
Xấu hổ	殹
kiên nhẫn	病人
Phim hoạt hình	動畫電
các bạn	你们
Người ta nói	眾說
Chơi	播放
Dài	悠久
không người lái	無人
Lớp B	乙级
Linh cẩu	鬣狗
Hori	倠
Vỏ cây	树皮
Yahoo	雅虎
Gặp	邅
Tên là	名稱為
ngày	棗
chính sách quốc gia	國策
nặng	慘重
Qi	岐
bàn giao	交出
Giống	象
cụm	星團
cấp độ	级别
Rời khỏi	離去
ấu trùng	幼蟲
Theodore	狄奧多
Rô	方格
Kết thúc	盡頭
Bên trong	内在
chữ thập đỏ	红十字会
Lou Meng	樓夢
Xincun	新村
Cũ	老舊
Triều đại nhà Chu	周朝
Dài	塱
Axit keto	酮酸
ngược lại	反之亦然
Dự án	立项
Lai	莱
Đời sống	生平
phi tiêu	鏢
Hedong	河東
Xiban	西班
phù hợp với	依據
Tái sử dụng	重用
Phối hợp	閤
Cơ thể vật lý	肉身
Đường dọc	縱貫線
trận đánh	戰事
Sho	朔
Những ngôi nhà	家們
trại	陣營
Sang nhân dân tệ	至元
ban nhạc	乐队
mã lực	马力
xeton	酮
Nghiên cứu sinh	博士生
Maharaja	大君
Dopamine	多巴胺
xảy ra	發生
người sử dụng	使用者
Lớp dưới cùng	底層
Huh	嶦
Turner	特纳
Gò	頣
Người kilômét vuông	人平方公里
Chơi đầy đủ	全劇
Cá cơm	鳀
Bảo tàng	该馆
Điểm A	甲级
Bắt lửa	起火
Kích hoạt	扳機
Tumoyama	土桃山
Tuo	沱
Đảo	海島
đối lưu	對流
Ke	轒
chỉ	公正
Bản tin	公報
Huân	渙
ban cho	贶
Có thể một	加拿
bền chặt	耐用
gió nhiệt đới	熱帶氣旋
Jing	璂
Joe	喬
Luo	洛
Đột kích	突袭
Mang tính biểu tượng	标志性
Jie	傑
Dòng và	線及
Biebe	兵衛
Dai	壂
Tra tấn	酷刑
Jin	靳
Làm sạch	清洗
nhiều hơn	不止
cuộc thi	竞赛
Sở hữu	占有
Gan	贛
Giường bệnh	病床
Cặn bã	藋
Canh	機翼
Michael	迈克尔
Vẫn	還在
Hoạt động	勱
Nhìn chằm chằm	睘
Đó	那裏
cà vạt	缯
rộng rãi	广泛
Thư giãn	弛
Các loại	类型
thể lực	體力
Hồ sơ Quận	县志
Say	醉酒
Thăm dò ý kiến	泊爾
Yi	翊
rừng nhiệt đới	丛林
không kiên quyết	徊
Chắc chắn rồi	絶
Rehe	热河
lời thỉnh cầu	请愿
Pseudo	赝
mê sảng	譫
hàng không vũ trụ	航天
Yiya	屆亞
Vịnh Causeway	銅鑼灣
Thích hợp	合适
đúng	權
Tất cả	全數
Dang	砀
săn bắn	狩
chân	足
Tiền kiếp	前世
em trai	弟弟
Nó và	它與
Gõ cửa	婏
con bò cạp	魶
Song Giang	宋江
đồng lúa	水田
Câu chuyện dài	长篇
Điều này	這條
Ả Rập Saudi	沙特阿拉伯
Chiến tranh giành độc lập	独立战争
Bắt đầu sau	後開始
Khu vực xây dựng	楼区
yamen	衙门
Giải Quả cầu vàng	金球奖
Tế bào thần kinh	神經元
Một số quốc gia	數國
Hở	啒
Li	敧
Hy Lạp cổ đại	古希臘
Qi	穠
Đàn áp	打壓
khuôn	糢
buôn lậu	走私
Ủy ban đặc biệt	特委
Nhà Hán	汉朝
Số lượng	的數
Chơi	扮演
đỉnh núi	山頂
trải qua	窣
Thẻ	卡
Mạnh	強
quán ba	攔
shad	鳓
mục đích	瞄
Daxi	大溪
Đan mạch	丹麥
Trong một thời gian	一時
Giải Người đẹp	美獎
hổ có sừng	虒
Phay	銑
rào chắn	障
Ming	溞
Đăng ký	報名
bắp chân	犢
Ủy ban Trung ương của CPSU	苏共中央
sửa	修
Tin Shui Wai	天水圍
rùa	玳
diode	二极管
Phòng chôn cất	墓室
hệ thực vật và động vật	動植物
Lin	襏
Lúc bắt đầu	一開始
Cầu vượt	天橋
cuộc nói chuyện	會談
gốc	緣起
Di	棩
bí mật	祕
Lou	婁
Cao cấp	资深
Ya	伒
Qi	鶒
Thành phố Đảo	島市
Missouri	密苏里
thảm họa	灾难
đề tài	話題
Đăng ký	报名
tiếp sức	接力
mẹ của	之母
Xihe	溪河
Hiệp sỹ	骑士
tranh chấp	争执
Thiên nga	鹔
Liên kết	联合会
Trại tập trung	集中營
Thành viên ủy ban	委員
Về hưu	退役
Sen	森
Shao	魕
đặc biệt	特別
Dài	长久
Không thành công	未果
Phiền muộn	鬱症
Chaozhong	朝中
Hội chứng	综合征
vật lý	物理
Hang	岩洞
Chengdong	城东
Nếp	礕
Một tuần	一週
Lòng tin	信託
Chính xác	矯
Tham	婪
tình hình	状况
Đội mở	隊開
Những gì bạn thấy	所見
niêm phong	篆
Zoling	佐领
Onium	鎓
ôxy	氧
Trung tướng	中将
rừng	林中
Ngoài thị trấn	出城
Tự nhiên	土生
Wei	崴
Nhấn mạnh	强调
Phát biểu	演讲
sự bất công	寃
ria	髭
Jinling	金陵
radon	氡
Trí thức	知识分子
Alpine	高山
Điều	事
Chứng khoán	证券
Tuyệt quá	伟
chạm	触
Boudoir	闺
Chiến đấu dũng mãnh lên	奮戰
Gers	热尔省
được phân loại như	歸類為
gặp	會面
Tut	啧
Tăng cường	助推
đu đủ	木瓜
Mát mẻ	酷
Chơi	遊樂
yến tiệc	宴会
chơi	縯
Lào	籞
sáu	六
què	躄
liều lĩnh	倀
cà phê	咖啡
Sân cũ	老院
con nhộng	蛹
Để nó ở đây	將此
kích thích	激發
Nâng cao	撫養
bộ sưu tập	珍藏
kho báu	宝
Xấu hổ	鷤
Yêu cầu	要求
Đứa trẻ	小孩
Những năm gần đây	近年來
trở về	歸還
vật nuôi	宠物
Hồ Dongting	洞庭湖
Chất phản ứng	反应物
bước sóng	波長
Xinzhuang	新莊
đày ải	流亡
Hàng	條線
Robert	罗伯特
khoe khoang	侘
缍	缍
Nguồn cấp	电源
Ngày là	日期為
Cách mạng quốc gia	民革
đuôi	尾巴
văn chương	文学
Poole	普爾
Không có	未經
tầm nhìn	視力
Tai	邰
kỳ quặc	奇
Stedt	施泰特
Đối với một số lý do	因故
Huns	匈人
Không đứng đắn	不雅
sỏi	砾
Quyết định cuối cùng	終決
Tạo	所創
Khám nghiệm cung điện	殿試
Abel	阿貝爾
Ông ngoại	曾祖
Hình người	人形
chậm	緩
Đối với mặt trước	為前
Ngôn ngữ	語言
thạch anh	石英
Chất xơ	纖
Tallinn	塔林
Và thông qua	並透過
Đợi đồ ăn	等為食
Jordan	喬丹
Ida	伊達
Shinshu	真宗
bom	炸弹
Thương tiếc	斮
Đã chạy	鋾
Miễn	免去
bông	綿
Xâm lược	入侵
Xe ngựa	战车
Chen	諶
thùng đựng hàng	容器
khuyến khích	促进
Chim hoàng yến	加那利
Dương	鸑
Demi	德米
Vòng đeo tay	镯
Quốc gia	国民
lấp lánh	烁
nước Hà Lan	荷兰
chính xác	糾
Ghế đầu tiên	首座
Cử nhân	士學
Trong nước	在國
tập giấy	垫
nhà ở	房屋
giao thông	交通
Sáu ngày	六日
hẹp	笮
phổ biến	通俗
gian xảo	狡
Thu hải đường	海棠
Sửa nó	修好
một chút	少許
Mỏ vịt	鴨嘴
Yun	覙
con vượn	猩
Cân nặng	份量
Schwartz	施瓦
Thầu dầu	蓖
Định nghĩa	界定
Lev	列夫
Ghế ngồi	席次
Phong cách	风情
Với	附带
qui định	治
than củi	木炭
để ý	通告
ngôi đền	神廟
liên lạc	往来
Đài truyền hình	台視
Ụt	蒣
Ngoài	齣
Thất bại	未能
Tai nạn	坠毁
Pháo	機炮
Triều đại nhà Minh	大明
tiếng kêu bíp	嘟
Jacques	雅克
Xuân	烑
nguồn	根源
Sangui	三桂
Sadamoto	贞元
Gửi đến	发给
tỉ lệ	鱗
Coi như	视为
Su	菑
Bo Fu	薄扶
Khu dân cư	住宅区
Kiêu ngạo	樈
tiếp diễn	连续
Công nghiệp nặng	重工业
Tuyển sinh	招生
tiêu cự	焦距
Thủ đô	资
Taishi	太師
Có một phần	有份
phun	歕
Hồng	粉紅色
Quảng đông	广东
hạm đội	船队
Andy	安第
lợi ích	惠
Coilia	鲚
gầm gừ	狺
bánh mì hấp	馒
Tin đồn	传言
Bilge	舭
Nâng cao	進
cột	柱
người đọc	讀者
Nhận	接獲
băng thông	带宽
Ôxít	一氧化
Thông thoáng	明了
cũng thế	亦
Zhe	轵
Tên	为名
đãi	对待
cảm thấy	觉得
cuộc hẹn	约会
cái hộp	箱
Người Mỹ	裔美国
cá tầm	鱘
Cá chép diếc	鲫
tiếng nói	語音
Herders	牧民族
Cây	厂房
Trì trệ	滯
lấy lại	取回
Tuấn	摶
ao	塘
Chiến tranh Thế giới II	二战
sự thật	真理
Shan	汕