hư hại	破坏
Lan tràn	散佈
trả	繳
đường vòng	繞道
Vui lòng	開朗
người hầu	僕人
củ hẹ	葱
nhiều lần	屢
Công giáo	公教
đọc thuộc lòng	誦
Orle	俄勒
đáp ứng	符合
Lúc đầu	初時
Chim	鍷
gói dữ liệu	数据包
Tây An	轇
Toàn quốc	全国
Nội trú	上車
Duyệt qua	瀏
cái	一塊
Rời khỏi	離場
Chuyển ngữ	转写
thảm họa thiên nhiên	自然灾害
cơ thể và lí trí	身心
Tokyo	東京
Cũng có	亦曾
đột ngột	突然
kịch	戏曲
Trao giải thưởng	得獎
kính	眼镜
Âm	寅
sự miêu tả	描述
Ca hát	演唱
lông nhím	翮
Xấu hổ	臁
May chăn	絎
cánh cửa tiếp theo	隔壁
sự trừng phạt	刑
Di cảo tên	谥号
Nhân đạo	人道主义
máy hút bụi	真空
Trung bình	中等
tổng hợp	合成
nguyên	原
hối lộ	受贿
vận chuyển	運輸
hiệu trưởng	负责人
Shao	糹
Được tha	幸免
em gái	姐
nhiệm vụ	責任
Tử đạo	鉮
tự động	自動
Bất tận	不盡
Ghi chú	牋
Cao đẳng	大專
Minas	米纳斯
Cười thầm	櫖
tiêu cực	否定
Đỉnh đầu	頭頂
người phiên dịch	编译器
Muhammad	穆罕默德
Bắt chước	髣
chứng cớ	证据
Tsai Ing-wen	蔡英文
Sóng thần	海啸
Rady	拉迪
phòng	室
Thuộc da	丹拿
tắt	饐
Trung Quốc	華
Lớp phủ	叠加
Ashikaga	足利
Tương hỗ	互有
Tháng sáu	君
bản địa hóa	本土化
Làm tan biến	溶于
Nhiệm vụ	職責
Hộ gia đình	戶
đĩa	盤
hiệu trưởng	校长
rửa sạch	涮
Sao Đỏ	红星
Cấp dưới	手下
Máy khoan	釬
cá xanh	鯥
thức tỉnh	憬
điều này	這本
Rutte	鲁特
trắng	白
Lian Yun	连云
Số chuyến bay	號班機
Sid	希德
Đề cập	提到
lá thư	書信
Chanh	檸
Phụ thuộc vào	视
bài viết này	本文
Xe trượt tuyết	橇
gần đây	就近
Âm	埴
Vỏ não	皮质
Nhân vật chính trị	政治人物
Cho nhiệt đới	為熱帶
Học bổng	學獎
riêng	特定
Zhu	翯
Yu	鋑
cây phỉ	榛
Công tước	公爵
ngạc nhiên	訝
Lưu trữ	封存
Một số	幾位
Đúng đắn	為義
thợ rèn	史密
lịch	厤
skiff	艭
Guotao	国焘
Minjiang	岷江
đường cong	曲线
lãnh chúa	督军
A	耈
Academia	学界
Johanne	约翰内
Xấu hổ	湔
ruthenium	钌
Chiếm lấy	攻佔
dư luận	輿論
xoay	斡
bàn	桌
Anh chị em	同胞
Quận Triều Dương	朝阳区
Văn phòng	办公
chính khách	政治家
Tiểu sử của	的傳
Oxime	肟
Liên hoan phim	电影节
bác sĩ triết học	哲學博士
sự miêu tả	描寫
Liên kết	债券
Người lái xe	駕駛員
Xem	詳見
Ying	瑩
trỗi dậy	攀升
Đường sắt Kowloon-Canton	九廣鐵路
Khổ sở	洈
sự hối tiếc	遺憾
Toàn nước Mỹ	全美
tối	黯
Chu	铚
trường học	在校
Đánh	撞击
dịp	场合
Cúp vô địch	冠军杯
phụ tá	副官
Lúa mạch	薏
Dongzheng	东征
Sumen	苏门
Số lượng lớn	大批
thẩm định, lượng định, đánh giá	评定
Theo	叼
Hoàng tử	诸侯国
N: Xứng đáng	功德
Có xu hướng	往往會
khó khăn	艱難
khu vực	域
Sui	绥
thiết bị	器具
Thủ công	手動
Panyu	番禺
Đường cao tốc Tai Po	大埔公路
cơ sở	設施
Huyền phù	懸掛
bệnh viện	醫院
theo sát	跟進
Cá mèo	鮦
Đường Bay	灣道
Tốt bụng	蔼
Người lớn	成年人
Chi	暕
Tàn phá	甡
Disney	迪士尼
Lột vỏ	皮爾
Cây bản địa	本植物
Nhầm lẫn	混淆
Chống tăng	反坦克
xương sống	棘
Chạy	奔
Hồng Kông	香港
chà xát	揉
bắt giữ	逮捕
Ứng cử viên	考生
sự dũng cảm	燴
đô la Mỹ	美元
may mặc	服饰
Yankee	洋基
nghẹt thở	嗆
Gia Cát Lượng	诸葛亮
bày tỏ	特快
in	印刷
hai ngàn	兩千
phòng bếp	灶
Fu	涪
trừng phạt	誅
Tan	譚
riêng tư	隐私
cơ quan	組織
Sao chép	副本
quả anh đào	櫻
Thời gian trận đấu	賽時
Âm	郿
kỹ thuật số	数字
thuốc lá	烟草
bang hội	公会
Nhân Viên	参谋部
cạc-bon đi-ô-xít	二氧化碳
đậu bắp	蕣
Inch	吋
Thắng lợi	夺得
Trong tâm trí	心中
Bo	亣
Xã hội đen	黑幫
thạch tín	砒
Nhân loại	人於
Và từ	並從
Meiji	明治
Khinh thường	藦
Phản ứng	回應
Tis	蒂斯
duy trì	維護
khua khoắng	耞
Huyền bí	推理小說
gián tiếp	間進
Vĩnh Châu	雍州
tuyệt quá	極大
Tiếng Anh	英吉利
tính cách	人物
Trường học	黉
Được bầu là	獲選為
Ẩm	槖
Đầm lầy	蝜
scandium	钪
truy vấn	勸說
Dài	長期
Lan Châu	蘭州
Vương quốc	演义
Công ty là	公司為
Matxcova	莫斯科
Taitung	台東
trắng	怀特
di chuyển	动
Khu rừng	林區
Làm suy yếu	减弱
Tha	借口
Thành phố Đại Đồng	大同市
Alba	阿尔巴
con gián	蟑
Chín một một	九一一
Hình cầu	球面
nhuộm	染色
Sauropod	蜥腳下目
trang	页
Mã nguồn mở	开源
Hạt Ping	平县
nho giáo	孔子
Cúp Hiệp hội	協盃
ngành công nghiệp	產業
Thu hải đường	秋海棠
Móc	胡克
Phòng trưng bày	展厅
vài lần	幾次
Truyền hình cáp	線電視
Tường	垣
Nam thái bình dương	南太平洋
chủ nghĩa đế quốc	帝国主义
Raza	拉扎
thảm họa	禍
Ting	廷
Phía trong	在内
Nung	煅
ghi lại	录
Quận Changhua	彰化縣
Virus corona	冠状病毒
Huấn luyện viên	执教
Sân cỏ	投球
Sway	淎
nhận con nuôi	收养
mở rộng	擴大
câu trả lời	答案
chim	鸟类
Rao	饒
Hoven	霍芬
Ở đâu	哪
benzen	苯
Thứ năm	星期四
Công việc	功
mạnh	强烈
Hồi	清真
tóc	毛
giữ	持有
sự lo ngại	惶
Chủ nhân	本主
Bằng một lợi nhuận lớn	大幅度
Phổ biến	热门
sự phát triển của	的發展
Bãi bỏ	廢藩置
Cỏ	草地
Từng cái một	一一
Trước chiến tranh	戰前
cánh đồng	領域
Pina	翩
phòng bếp	厨
Thứ mười bảy	十七日
Tìm thấy	找
Đĩa	磁盘
Chỉ	显
Để ý	告示
viết lại	改寫
chuỗi	链
Trực tiếp điều hành bởi	直辖
Nhân viên thời gian	員時
Người phiên dịch	譯器
Zhu	轁
Men	鋊
Đính kèm	附送
cây du	榆
Ba bốn	三四
Ru	瑠
công thức	配方
Bảy	七
Thiết lập	开办
chức danh	职称
Chất lượng	質素
kênh	渠道
đánh trống	咢
khô	乾
đỏ thẫm	纁
dung hợp	聚变
Francisco	弗朗西斯科
tuổi thọ	嘏
Nhà công nghệ	術師
Cháu trai	之孫
Chu	鷿
Cổ áo quốc gia	國領
khối	阻塞
kèn	特朗普
Mập	膴
Đa thức	多项式
viết	籀
Pháp mở cửa	法網
ngập úng	澇
Thâm Quyến	深圳市
Thành viên của bữa tiệc	黨員
Quay	转动
Lớn lên	茁
Được xây dựng trong	内置
Sinh đôi	孿
hiểu biết	識
mắng mỏ	诘
táo	蘋果公司
Jiri	尻
thất vọng	憮
xương khớp	骱
Hun	碤
Matt	马特
nếu không thì	不然
nghi phạm	嫌疑人
Tình cờ gặp	跹
Sho	扌
hào khô	隍
giăm bông	火腿
đội bóng rổ	籃球隊
không khí	空氣
Vienne	维埃纳省
Toàn quyền	全權
phân bón	肥料
Thơ	诗词
Chăm sóc y tế	醫護
Xây dựng lại	改建
suy thoái	降解
Brunswick	不伦瑞克
cuộc biểu tình	示範
khuyến khích	貤
Zhang	昛
Sở hữu toàn	全资
Mi	宓
Không khí	艾爾
đọc	閱讀
mũi tiêm	注射
Nên kinh tê	經濟體
Cá lóc	鳺
Công tố viên	檢察官
Ấn Độ giáo	印度教
Sẽ thay đổi	會改變
điều này	本
không liên quan	眛
không phải	毋
dốc	坡度
Herzegovina	黑塞哥
Mờ nhạt	沄
Chỉ	秀
Chữa lành	愈
Dakko	達科
Vắt kiệt	搛
sự hội tụ	收敛
kịch bản	脚本
Kus	库斯
Ju	茱
cai trị	裁決
ngắn	矮
Cổng núi	山门
Duy Nhất	鰨
vôn	伏特
tên lửa	火箭
Cánh tả	左派
Chiên	油炸
cây búa	槌
Video	录像
Đi xuống	下去
đỉnh cao	巔峰
Sư đoàn	司署
chũm chọe	鐃
Thắt nút	结
Phòng làm việc	工作部
Âm	黱
Thánh Joseph	聖若瑟
Cơ điện	機電
sốt	發炎
Làng Vịnh	湾村
Dun	敦
Theo thời gian	與時
Đồng hồ đeo tay	观看
Nội chiến	內戰
câu lạc bộ	俱乐部
Khoa học tự nhiên	自然科学
Khoe khoang	骚
bánh xe	軲
ngăn chặn	防止
tua mũ	綖
Rào	阘
chín	九個
Ngoài giá	下架
Fu	懫
sự phân giải	決議
cáp	纜
Ngay trước đó	方可
Noy	诺伊
thần kinh	神經
cẩn thận	清醒
Chỉ có	孹
Cá vây tia	輻鰭魚
Hiện tại	目前
Nghẹt thở	搤
ít hơn	少於
Sự cố Mukden	九一八事变
Phản đối	反對
Yi	懌
Giọng nói	之聲
Hiệu trưởng	主事
Gió và mưa	风雨
hoàn hảo	完善
Ông già	老君
Dan	郸
Hội tụ	交匯
Phiên họp toàn thể trung ương	中全会
Chiến tranh	大戰
nhà ở	房子
Đối với Vương quốc Anh	為英國
Zhen	貞
Khởi đầu	入手
Vado	瓦多
đã phát triển	发达
Peck	佩克
kiểm tra	測試
con chuồn chuồn	螂
Giống	繁殖
Toàn quốc	全國
Đứng như	立为
liên quan	关心
Burley	伯雷
kim cương	菱形
Thương tiếc	檄
mô hình	模範
Châu Á	亞
Wei	廻
chính	重大
Thực tế	寫實
Mặc du	虽
Ngày thứ mười	初十
cuối năm	年終
Reel	龘
Ngốc nghếch	跶
Thủ công	工艺
kiềm chế	克制
Mở ra	开业
nứt	嚦
Cặp đôi	夫妇
sẽ	意志
Ngọc rồng	龍珠
sự bức xạ	辐射
Video	視訊
Liên hoan phim	電影節
E	莪
Kabi	卡比
Cơ sở	基层
Ken	肯
Kawamachi	川町
Trung thành	忠信
Xẻng	鐔
kiểm toán	审计
Giống nhau	同源
Đạo văn	抄袭
bước sóng	波长
miệng vỏ	光圈
Kết hôn	嫁给
Hãy từ chức	請辭
bệnh truyền nhiễm	傳染病
chim	鳥類
Thống đốc	知事
Nanyang	南陽
máy móc	機器
Trưởng quân đội	軍總
Muốn	缉
Charles	查尔斯
Đột nhập	闖進
Ở trong	处在
Ku	隀
liều lượng	剂量
tiệc	筵
Brandenburg	勃兰登堡
hình ảnh	影像
Khuyến mại	晉級
Bộ phận biên tập	编辑部
nhai	嚼
Chớp cánh	躅
vẫn	仍
Canton Trung Quốc	中國廣
Đặt hàng	書令
Se	濑
nguyên	原來
Bắt đầu làm việc	动工
ion	離子
ngày Quốc khánh	國慶
Chua	錥
phô mai mềm của Pháp	布里
Bên	舷
Chân thành	衷
Sinh lý học	生理学
Và để	並讓
Chính phủ quân sự	军政府
thông thoáng	清
Lucy	路西
sự đóng góp	贡献
Zhi	栛
Sheung Wan	上環
Các triều đại phương Bắc	北朝
đánh bại	敗
trơn tru	平滑
sự thoải mái	慰
dần dần	渐
Lorenz	洛伦兹
giỏ tròn có nắp	篚
liền kề	鄰
Quyền hạn	管辖
bắt đầu	開頭
hơi cháy	絜
hoặc là	抑或
Bìa trên	上蓋
đã tham gia	參加過
Đưa vào sử dụng	投入使用
Lorida	羅里達州
Hiếm hoi	少見
Lịch sử	史中
thơm ngon	美味
Sửa chữa	修正
Có thể	可將
Giá cả	造價
sưng lên	腫
Đặt ra	定出
Tùy tùng	随从
Chi	袌
Âm	茵
Chỉ trích	诤
Ngày tiếp theo	翌日
Biến đổi	轉化
Định tính	质性
Được	拟
Chad	乍得
con vẹt	鵡
Thích	赞
Đổi	折合
Milan	米兰
ôm	搿
Bắc Phi	北非
Đi xuyên qua	歷經
Thiên đường	天上
Buda	布達
điều chế	调制
càu nhàu	叽
thám tử	侦探
Đối với Hàn Quốc	為韓國
Cơm	大米
Nước Ý	意大
Đồng minh	協約國
Nhanh	儵
Ju	苴
Điều trị y tế	醫療
Sắc ký	色谱
chứng chỉ	証
Zhang Tai	章太
Gali	伽利
Khác thường	失常
Shia	什葉派
Hetao	河套
quân đội	军事
Toàn bộ lãnh thổ	全境
Tên chung	通稱
Tình yêu mới	愛新
cổ đông	股东
khăn phủ bàn	裯
Phần ba	三分之
chim ưng	鹘
không tốt	不好
Newcastle	纽卡斯
Shibuya	澀谷
Chào	喂
Âm	褍
giải phóng	释放
Lão Cô	老舍
phenol	酚
Trung Phi	中非
Bao vây và ngăn chặn	围剿
cháu trai	孙子
Tôn giáo	神教
bờ biển	澨
Sở	部於
Đến	以第
phỏng đoán	怙
Phía đông	东边
Cặp đôi	情侶
Yu	虞
gần như-	準
Brezhnev	勃列日涅夫
Julian	儒略
Bán	卖
Kết thúc	幕末
Pháp	法国
Cách này	此路
Yu	煜
thứ mười một	第十一
Lincun	林村
Dập tắt	滅
xử lý	把手
Lô hàng	分批
Vatican	梵蒂
nói nhỏ	劘
Maher	馬赫
Đài kỷ niệm	追悼
bào thai	胎
Vết ố	漬
tỉnh	省
ba mươi	卅
hằng ngày	每日
Leicester	萊斯特
bí mật	偷偷
Shiliang	時兩
khó xử	尷尬
Lu	潞
mãi mãi và luôn luôn	永远
Sk	斯克
Người thay thế	代為
thương	矛
nổi danh	著名
Sheng	盛
Kiên quyết	毅然
dẫn đầu bởi	為首
Từ khóa	关键字
Nurhaci	努尔哈赤
phô mai	奶酪
người đi bộ	行人
con tôm	虾
Mực và rửa	水墨
Hành trình	路程
Vội vàng	趕
Đi	出境
phóng đại	誇張
Không khí	氛围
cây	植
xoang	竇
giá bán	价
Nắm bắt	奪下
Cao	曹
Im lặng	沉寂
anh chị em họ	表妹
Tiêu đề	書名
Không được liệt kê	不列
ướt	濕
heo	彘
Sản xuất	製片
phép lịch sự	礼仪
Coff	乔夫
Hảo	濠
liên kết	連結
cắt giảm	減少
Ăn mừng	庆
Vonfram	钨
đặc biệt	特地
mềm dẻo	耎
tuần tra	巡
tiếng Ả Rập	阿拉伯語
Hu	霩
mang	携带
Chiếm ưu thế	為準
Venezuela	委內瑞拉
Đã biết	所知
tỉnh lỵ	省会
thành phố tự do	自由城
Viper	毒蛇
sự phán xét	判断
Chúa tể	領主
Tại chỗ	到位
Lil	利爾
Công khai	公示
Phát hiện	偵
Tiao	朓
Chu	俶
Qi	齐
Zenghe	曾和
Lấy trộm	偷走
Cấp	蘭克
tuân theo	聽從
Chăm lo	打理
Trẻ hóa	復國
Đẹp	俦
Đồng thời	併發
Quà tặng	贈
Xichang	西昌
Lai ghép	杂交
Di chuyển thủ đô	遷都
Wen Tianxiang	文天祥
Thuế	赋税
Tianzhu	天柱
Cao răng	韃
sắc đẹp, vẻ đẹp	美貌
giới trẻ	年轻人
Ying	倴
hợp lý	合理
Sau khi đóng cửa	結後
Cứu người	救人
Shaw	邵氏
Kiểm tra	驗
Indole	哚
Quận	该县
bảy mươi hai	七十二
Westminster	西敏
Wei	嶮
Y học Trung Quốc	中医
Sẽ	威爾
du lịch	遊歷
Nordin	諾定
sâu non	蛆
Sàn nhà	層樓
miệng	口服
nhỏ mọn	琐
cấu tạo	構成
cám	糠
tình hình	情勢
Sâu	蝱
Gal	加爾
Dung môi	溶劑
Bị giết	丧生
Trụ trì	住持
Và làm	並使
Xu	昫
Hát	鯮
Xử Nữ	室女座
qua nhiều năm	历年
Guanzhen	关镇
Phiến quân	造反派
đá	蹶
Caledo	喀里多
Li	苡
Sway	挢
Al	阿爾
Phong cách	款式
Những giọt nước mắt	催淚
trái cây	菓
Giáo dục tỉnh	教省
mạnh	強壯
phòng ngừa dịch bệnh	防疫
Sóng ánh sáng	光波
mã hóa	编码
Dọa nạt	恐嚇
Đại hội thể thao châu Á	亚运会
Thời gian đặt	時設
Gao	郜
Kết hợp với nhau	綰
nghỉ ngơi	歇
Thêm vào	加以
Đài Bắc	台北
Jedi	絕地
chó	犬
Deng Xin	灯心
Bún	竻
Lịch sử lâu đời	長史
Chính trị	政壇
Đa dạng	变化
Quà tặng	禀
nóng ẩm	溽
Bác sĩ	医师
Quế Lâm	桂林
Gánh nặng	擔
chiều rộng	寬度
Kinh kịch	京劇
ăn	吃
spaniel	獚
Cây bút	豲
thuế quan	關稅
Tang	惢
Anh ta	赫
Óc	腦部
sổ tay	手冊
Bộ Tư pháp	律政司
lôgarit	對數
mẹ	媽
Hự	唉
Thường xanh	長青
dây thừng	绳
Hamburg	漢堡
chủ nhân	业主
giới thiệu tóm tắt	拖车
Vỏ sò	舍尔
tuyệt vời	高超
bị cáo	被告
Vòng	襻
Phthalo	酞
Crest	嵴
bờ Nam	南側
Cũng	以至
Khung	楨
Bộ sưu tập	收藏品
Và màu vàng	與黃
rất nhiều	许多
đã có thể	能夠
khổng lồ	庞大
Sự khác biệt	差别
Động cơ xe	動車
Rein	缰
tàu tuần dương	巡洋艦
Hồi tưởng	泝
Sau này	後來於
Nhà xuất bản	出版商
Tổng doanh số	總銷
Bộ chuyển đổi	变流器
đường phía Tây	西路
Servi	塞爾維
Trevally	鲹
chạm đến	傷口
liên kết	缧
ytterbium	鐿
Số Pi	邳
Ah	嗄
wack	怪人
ấm áp	燖
cắt	剮
Jack	傑克
Kim giờ	时针
Đọc	唸
Ôxít	氧化物
tiếng sét	霹靂
Anh trai	兄長
Hualien	花蓮
Chọn	埰
Sullivan	沙利文
Bởi	經被
Lái xe	駛
Đại học chính trị	政大
Trong vấn đề	事上
Ôn tập	检讨
con quỷ	惡魔
Chúng tôi gửi	們發
nhà máy điện hạt nhân	核电站
Khờ dại	痴
Pedicel	花梗
Nhưng	而是
cỏ dại	薉
trong khoảng	大约
Không cố ý	無意
Bute	弼
thể loại	類別
Co lại	縮
Yên tĩnh	谧
Công	龚
Ám sát	暗殺
Gastropod	腹足
nhà ở	房舍
Gạo nếp	餶
metyl	甲基
Tàn tật	残
Ye Jianying	叶剑英
Bí danh	化名
lỗ trên tường	窬
ga tàu	台
Benz	奔驰
luân lý	道德
Buổi triển lãm	會展
tối đa	最大
Nghe	聽聞
hiệu ứng	傚
Ma Kai	馬偕
Liu	琉
Chính kịch trên đài	廣播劇
Dập tắt	灭
Bề mặt	地表
Câu cao	高句
Chang	昌
thủ đô	首都
kết hôn	成婚
Mi	瀰
Nankang	南康
Các triều đại Bắc và Nam	南北朝
Xâm nhập vào	渗
Bạch vân	白云
Khóc lóc thảm thiết	痛哭
sự cần thiết	必要性
bismuth	鉍
khung	框
Vội vàng	拵
thành trì	據點
Mona	摩納
Liên minh	聯隊
Philharmonic	爱乐
Bạn sẽ	爾會
Ba mươi lăm	三十五
Ding	鐦
Treo	穏
Đường sắt cao tốcQuận này	高速鐵路本縣
vặn to lên	找到
Hộ gia đình	户
Tia cực tím	紫外线
Lớp dưới cùng	底层
La	菈
Tiểu bang	州
Dara	達拉
từ ngữ	單詞
Chenzhou	郴州
Lan tràn	散播
Chang-Ping	常平
Sanyo	山陽
Madden	勁爆
giấy	論文
Li	骊
Yuya	魚亞
cá lùn	矬
Zuo	佐
viết một bức thư	写信
Ấn-Âu	印欧
Mỹ La-tinh	拉丁美洲
Oh	咁
Trotsky	托洛茨基
hoa mỹ	勃勃
Đồng hồ mặt trời	日晷
sự phán xét	判斷
Bắc	以北
Hòn đảo	该岛
giữ nhanh	坚守
nghiêm trọng	认真
Isère	伊泽尔省
cô dâu	新娘
Bởi người	因人
Nuuk	努克
Đây	喏
có thể	可能
cuộc thám hiểm	远征
Chiết Giang và Giang Tây	浙赣
bị hỏng	破碎
không rõ ràng	緲
Virginia	維吉尼亞州
đột nhiên	突
Sự cần thiết	關鍵
Giữ	举行
Luang	銮
Đường	製糖
rút lui	撤
Sau đó không có gì	則無
hiển thị lòng trắng của mắt	眅
Hong Kong và Kowloon	港九
Khoa học và Công nghệ	科技大
Dị giáo	异端
Phi lợi nhuận	非利
nợ	欠
Thở dài	憟
vườn bách thú	動物園
Zhang	璋
Giày ống	靴
bức vẽ	畫
Tiền bạc	款項
Quở trách	斥
Đối với	的為
hướng dẫn	歸納
Đổ	捖
Chỉnh sửa	整流
Tahara	田原
ca hát	歌聲
Thời gian	时
đục đẽo	鑿
Mỗi đêm	每晚
không khí	气氛
Ding	軇
Nhà vệ sinh	厕所
Tiếng Do Thái	希伯来语
Địa điểm	処
Điềm lành	祥
chim đa đa	鹧
Học	修讀
Ling	梿
Bang	梂
Hoa	布隆
phần mộ	墳墓
hướng Tây	西部
Thổi	布洛
Nhiều hơn	余
đến cuối cùng	到底
chỉ có	只不过
trộn	遝
Lạch nhỏ	汜
rộng	寬闊
Không có tội	无罪
Giám sát	監察
Điều này	這份
đấu	独奏
Ngọc bích	玉器
Xiping	西平
Câu chuyện dài	長篇
Wu	兀
phanh	剎
Nam giới	雄
liên đoàn	聯賽
đuốc	火炬
Chạm đến	擊傷
phun ra	擠壓
có xu hướng	趋向
Zhu	筯
sau đây	以下
chấp thuận	宽容
Trạm Bay	灣站
Dịp	际
Khán giả	观众
Bọn trẻ	孩童
ổn định	穩定性
sự thành công	成功
Thùy	裂片
Tây An	臑
Cựu chủ tịch	前主席
Ying	颖
Dingxian	定县
Chính quyền	政體
Trên không	架空
Cartier	卡捷
Mô hình	車型
bột mì	麵粉
lệnh cấm	取缔
ngoại lệ	例外
WHO	谁
Phòng ban	所部
Readme	自述
Im lặng	噓
Qi	杞
Điều khiển	控制权
Thời gian máy	機時
đo lường	度量
Thủ đô quốc gia	国都
Poole	普尔
Dòng mở	線開
Iraq	伊拉克
Quân đội Giải phóng Nhân dân	解放軍
Không đều	不平
Bria	布里亚
Lang	閬
kết thúc	結尾
Amy	艾米
Sun Hee	淳熙
Su	晹
Đau khổ	罹患
Tự chủ	自主
kết thúc	告終
tìm	征求
lực sĩ	運動員
trưởng khoa	德安
Ủy ban khu phố	居委会
Quái thú	獸屬
tương lai	期货
Hai nơi	两地
Shimo	下野
tha lỗi	恕
Dorf	多夫
Chứng thư	事迹
Hungary	匈牙利
Hậu vệ	守军
Sau	完後
chết vì đói	殣
Kể từ thời thơ ấu	從小
Dap xe	乘车
Nobel	諾貝爾
Danh sách sao	星表
Ba sản phẩm	三品
Trở nên	變得
Được rồi	萊特
Thoát	戒
Tỷ	億
không may	可惜
Dân làng	村民
tất cả	遍
cá cược	賭
Li	霝
Dis	迪斯
Yu	鴮
quân đội	军方
Li	槩
Tên Cu	旧称
Khai Phong	開封
Rinpoche	仁波切
Quý dương	贵阳
gia đình hoàng gia	王室
Tháng sáu	六月
Tiêu chuẩn kép	双準
Tên chính thức	官名
chuyển đổi giới tính	变性
Tường thuật	敘事
Công bằng	股权
Phòng ban	部門
nịnh nọt	嫵
Bài hát nhịp	詠
sự sáng tạo	創作
Phó giáo sư	副教授
đã chết	死人
nhỏ mọn	瑣
Thiểm	陜
Sao Paulo	聖保羅
sử dụng	採用
keo kiệt	吝
kẻ thù	敌
Dro	德罗
Bước tới	上前
bất diệt	不朽
Quân đội	諸軍
đọc	閱
Sau việc làm	業後
Minny	明尼
Ngang	橫向
Ở ngoài	區外
Bí mật	隐居
Zhu	蓛
làn điệu	旋律
Bản đồ	马普
thân hình	機身
rắc rối	愦
Chùa núi	山寺
chính xác	更正
sự chỉ trích	批评
học	學學
IPO	招股
Có ý thức	自覺
đường phố phía nam	南街
đổi	交換
Cuộc hẹn nặng nề	重約
Muzon	穆宗
Độc lập với	獨立於
thất nghiệp	失業
làn da	皮膚
Chủ nghĩa tự do	自由主义
Hiệu trưởng và phó	正副
Tách rời	隔
Đối mặt với	面向
Màn	螢幕
Sản xuất từ	产自
Ange	安哥
Nghi thức	禮部
Aga	阿加
A	楃
Con thỏ	兔
Gaozhou	高州
hữu nghị	谊
Kỷ luật tự giác	自律
Đốt cháy	灼
nghi ngờ	疑问
Lund	隆德
Nada	纳达
Ô tô	個車
luận tội	彈劾
mưa đá	霙
Chưa từng có	前所未有
Gallia	加利亞
Zheng	錚
Số và	號及
Kỹ lưỡng	闡述
Chỉ có	惟有
Tao	濤
Ming	忞
Thất vọng	撉
thỏi	锞
mũi tiêm	噴射
và	并
Đại diện nhân dân	人民代表
Cho đến chết	處死
Giới thiệu	引入
Hai mươi bẩy	二十七
Viễn thông quốc tế	國際電
động năng	動能
Chờ giáo dục	等教育
Vast	广大
Jaro	雅罗
phèn chua	礬
Luo	淯
Min	岷
Khác nhau	各异
đất ruộng	農田
Chim ó	鵟
Va hôn	和親
đèn lồng	鑭
Phức tạp	繁
liti	鋰
Lớp một	初一
Giao diện người dùng	用户界面
sự sống và cái chết	生死
Vật chất	材質
Đẩy lên	撀
Bình minh	曙
lựa chọn	选择
khóc	泣
Tách ra	分家
Qi	鏚
thư	郵
Thiết bị sóng	波器
đuốc	爝
hòa giải	调和
con đường núi quanh co	嵼
ngã	堕
vòng quanh thế giới	世界各地
Hoa đỗ quyên	杜鹃
Jiangyin	江阴
Tháng sáu	筠
ngồi	坐
Giai đoạn = Stage	期時
Liên kết	環節
Morgoth	魔苟斯
Descartes	笛卡尔
Đi học	升學
Mát mẻ	檟
nhón	捏
Lớp bốn	初四
Quận Tây	西县
Chi	螵
quạt	迷
Sau dòng	線後
Người hâm mộ	影迷
tối và yên tĩnh	杳
Nghiêm nghị	懙
Yay	耶
Chongzhen	崇祯
Đầu lâu	頭顱
bệnh tim	心臟病
hiểu biết	认识
bông	棉花
Wanli	万历
Yêu cầu hướng dẫn	请示
Yoshitsune	義經
Chỉ với	點與
thiếu niên	青年
sự trả thù	复仇
Cứu trợ thiên tai	救災
Ye	俅
Đối với Trung Quốc	為中國
Sức ép	压
Stie	史蒂
Văn phòng	事館
Đặc sắc	精選
không đủ	不夠
Phong cảnh	风光
Giải quyết trường hợp	破案
khả năng lãnh đạo	領導
Miyazaki	宮崎
đội trưởng	機長
Croak	啱
Trạm kiểm soát	关卡
quốc huy	国徽
Vẽ tranh	战平
Nader	纳德
cái đầu	头
Nhận vào	录取
Chiến tranh	戰火
đời sống	壽命
Nanto	南約
hoa sen	莲
Từ chối	拒絕
Minnan	閩南
Nghe rõ	罗杰
kẻ giết người	兇手
Cục văn hóa	文化局
trong	在
Với	與過
sự giải trí	招待
Crest	崵
bởi	通过
trái xoài	芒
Cao Hùng	高雄
đau đớn	痛
hình ảnh	图片
Không có tội	無罪
Ruy-băng	帶狀
Hạ viện	下院
Tiền Tần	前秦
câu lạc bộ	俱乐
Hakka	客家人
Được	中獲
không hài lòng	不滿
Inca	印加
di cư	洄游
Không ngừng	不息
mù	瞍
Mềm mại	詅
Đảng tự do	自由黨
Cung hoàng đạo	生肖
Wu Zetian	武则天
đơn giản	簡易
Bohr	玻尔
hình trái xoan	椭圆
săn bắn	獵
lâm sàng	臨床
Chốc lát	矩
đập	坝
Nhầm lẫn	吿
Remy	雷米
Ya	伣
Quan niệm	構想
người vẽ tranh biếm họa	漫画家
Đảng Lao động	工黨
Nhiều hơn mười	十餘
Chuo	斳
Tất cả các cấp	各级
con vịt	鴨
Album ngôn ngữ	語專輯
Moselle	摩泽尔省
EUR	歐元
sự sụp đổ	坍
Cerf	瑟夫
Bản quyền	著作權
Từ chối	拒绝
Năng lực cạnh tranh	競爭力
Dài	茣
Phi công	飞行员
Và hai	和兩
kế hoạch	策劃
ông nội	爺爺
Xiu	憺
Gia Kinh	嘉靖
xe tải	卡車
mơ hồ	朧
sự trao đổi chất	代谢
hợp đồng	契约
Lunan	路南
Bài viết đầu tiên	首條
Được	獲
Niên giám	年鑑
Louis	路易斯
Pao	擣
còn lại	遗迹
Hai mươi ngàn	两万
San Lo	圣洛
thành phố Mexico	墨西哥城
chức năng	函數
Máy tính bảng	牌位
Đánh bắt cá	钓
trên	就
nhím	猬
Phụ lục	吞并
Ách	顅
Hướng tây	偏西
rủi ro	险
hư hại	損壞
kháng nguyên	抗原
Kanter	坎特
Từ chối	拒
Thượng nghị viện	参议
Bình luận	解說
Davis	戴维斯
Quang hợp	光合作用
đơn giản hóa	簡化
phần thưởng	賞賜
Yu	妀
vườn	园
Fu	鬦
Wenlong	文龙
loạng choạng	跄
Baba	巴巴
Dù sao	反正
Biên tập	纂修
Châu đại dương	大洋洲
Zheng	箏
kết quả	结果
Sáng	鮮明
cơ chế	機構
Âm	釃
Ngăn cản	摊
Cabin mặt trăng	月舱
Mái hiên	篷
con cóc	黾
Quốc gia	國國
cao su	橡胶
Trung Quốc	中国
một số	有的
Botsva	博茨瓦
Và	幵
Kai	鍇
Đường bằng phẳng	平路
điếu văn	诔
đáng yêu	譅
kiểm tra	考
Tháng	個月
cây rơm	山脊
Đội cho	隊為
James	詹姆
Mangshi	芒市
Queensland	昆士蘭州
Sẽ	便會
Leah	莉亞
Hình ảnh	意象
cây tre	竹
Chạy trốn	逃跑
liên hiệp	合會
bắt tay	握手
Nagato	長門
Duy Nhất	鳎
Chính trị	從政
Đinh ốc	拧
Hitter	击者
Trong vòng	以内
đồng hành	伴侣
Năm Anh	英年
Điều này	這部
Lựa chọn	評選
Chiến dịch này	此役
Rỗng	空洞
Kẻ ngốc	谰
Wisconsin	威斯康辛州
Gore	戈尔
Nhà Minh	明代
trước đây	先前
lớn	硕
Giá bán	物價
quan tài	櫬
cừu cái	牂
Yi	勼
Quanh co	绕组
Xấu hổ	漒
Huân	嬂
Rabbi	拉比
Giáo viên và học sinh	师生
Vứt bỏ	处置
Chủ nghĩa dân tộc	国主义
bên ngoài	外在
Chắc chắn	堅固
Phóng	下水
Bạn và	爾與
Hảo	灝
Thánh tích	遗物
điển hình	地道
sư tử	獅
Độ phân giải	解析度
học thuyết	理论
Cắt	切割
ba mươi mốt	三十一
Chủ tịch	主席
từ giờ trở đi	今後
Nó được bao bọc	被包
Sản xuất	産
Linde	林德
Rượu hiến tế	祭酒
Chức vô địch	錦賽
nộp hồ sơ	歸順
Cột sống cổ	頸椎
Fermium	鐨
Khan	可汗
Khiêm tốn	蘥
đế quốc Anh	大英帝国
Bờ hồ	湖岸
Hai người tại	兩人於
nói dối	趴
loa	议长
Và đã	並曾
Nepal	尼泊尔
mở mắt ra	睜
dự báo	預報
Nhìn nhận	认定
thực hành	實習
Ke	坷
Đảo	特岛
Mạnh	堅
cực điểm	高潮
Sông Tùng Hoa	松花江
phức tạp	複
Trong tháng	月內
mục lục	目錄
Có được điều này	得此
Gập lại	襞
Gợi lại	罷免
Vị trí chính thức	官职
United Gang	聯幫
Quán tính	惰性
Hokkaido	北海道
Giao banh	供职
Murray	美利
Sau cuộc chơi	賽後
đồng thời	与此同时
Chức vụ	之位
Báo mới	新報
Bạn	爾
Rio	里奥
Ở gần	临
chim cánh cụt	企鹅
Chủ nghĩa tư bản	本主義
cố vấn	参赞
Cho thời gian	為當時
nuôi nhốt	囚禁
Chuo	櫎
Lehman	莱曼
Từ	来自
vai	肩
Yi	佄
Đào tạo	培训
Bang New York	纽约州
Hoa và chim	花鸟
chính quyền	当局
què	跛
Ye	鑴
do dự	躊
Bourne	伯恩
cưới nhau	已婚
Xem xét lại	大修
Thứ mười một	十一日
Bauhinia	紫荊
Dự trữ	储量
Chúng tôi nhận ra	們認
Wan Yan	完顏
Gay	同性恋
Tát	椈
Titan	土衛
Tây An	奅
sự nguy hiểm	岌
dọn dẹp	干净
Quyền thị trưởng	代市长
bề mặt	麵
Nước Phổ	普魯士
Có thể được mô tả là	可謂
Công bố	發表
Tàu ngầm	潛艦
Lincoln	林肯
giống cái	牝
Qi	碶
Hạt Wu	吴县
Cyprinus carpio	綱鯉齒目鯉
mơ hồ	胧
giam	扣留
ngôi đền	寺院
tiêu điểm	焦點
Yu	豫
Pierre	皮埃尔
Meurthe Moselle	默尔特摩泽尔省
Bạn	俎
phần phía sau	后部
Chi	辌
Phẫu thuật thẩm mỹ	整形
hai	贰
Số tại	號在
Xã hội đen	匪徒
Khách sạn	賓館
dỗ dành	哄
Nhón	掟
Cúp quốc gia	國家盃
Loài	個種
Trịnh Châu	鄭州
quyền con người	人權
Nước sông	江水
bên trong và bên ngoài	内外
Tìm kiếm và cứu hộ	搜救
bệ phóng	发射器
Tel Aviv	特拉维夫
Sar	薩爾
Đồ khốn	鮓
giải thưởng lớn	大奖
dấu ngoặc	括号
Khánh thành	就職
Delia	德里亚
Cuộc thi	大赛
mủ	脓
Học viện Hoàng gia	翰林院
Canh	鬕
Chiếm lấy	攻占
Gió mùa	季风
Cáo phó	訃
Thêm vào	增设
Lịch sử gia đình	家世
Vô điều kiện	无条件
Là nó	嗎
Gói	封装
công cộng	公共
Chiến tranh trên bộ	陸戰
Qian	墘
Olefin	烯烃
Nhạc sĩ	音乐人
ban phước	保佑
rơi vãi	降
Bay	蹻
Ở lại	留守
Gilas	吉拉斯
Xếp hạng giữa	躋
nhà vua	称王
Gil	吉爾
sao Kim	媊
quả mọng	贝里
Fiji	斐濟
Đề cương	廓
Yu	虤
xua tan	打消
Mì	面面
Tường thuật	敘
Chao ôi	阿拉斯
Sôi lên	沸
Brooke	布鲁克
sẵn lòng	願
bên bờ biển	海滨
Que	陗
Ziji	资治
Ngốc nghếch	矲
vào thứ Tư	周三
anh em	兄弟
bài thơ	诗人
Tỉnh Ca	卡省
Xuân	玹
Viễn Đông	遠東
Thành phố miệng	口市
Tốt bụng	那种
Bằng miệng	口述
Mỏ đá	鰂魚
Ribosome	核糖体
Và tóc	與發
Nhập ngũ	入伍
Tiêm	射入
Nong	儂
Cuộc thám hiểm phương Bắc	北伐
Conta	康塔
Đơn nữ	女单
Giành được	獲第
Học	研習
Hiện hành	電流
Tao	洮
Lang	琅
Thương gia	商戶
Shi Cai	時才
Đá bazan	玄武
lo lắng	惴
Thay trong	见于
Gặp	相接
Nam Cực	南极洲
Đau khổ	備受
Lớn hơn	年長
Mờ nhạt	杄
phát triển	发育
Hyun	鉉
Để lại nó cho	留给
gầy	脔
Trò chơi	博弈
Kasa	笠
Slav	斯拉夫人
Ban hành	頒佈
Thời gian và	時與
Shar	沙尔
Hệ hành tinh	行星系
hỏa táng	火葬
Hải nam	海南
Nga	俄羅斯
sự ra đời	來臨
Gì	么
ở lại	呆
Còng tay	铐
Nian	辇
Zhong	麔
Vận tải đường biển	海运
Tuo	陀
tấn công	猛攻
Yan	橑
Kang Nai	康乃
Tổng số cốc	總盃
Sau khi giết	殺後
Nielsen	尼尔森
Được	穫
Chua cay	枌
câu chuyện	故事
cối	臼
cám	麩
Jiankang	建康
Tẩy	撤除
Yoshi	與義
Đại đa số	绝大多数
Sạc điện	電荷
Đông Ấn Độ	東印度
Con số	个数
Zhang	欆
Habsburg	哈布斯堡
Bộ hành chính	政部
New Mexico	新墨西哥州
thủ tục	手续
Xi	浵
tận dụng lợi thế của	趁
Phi	擲
vô hạn	無限
Yu	屿
mềm mại	软
Xoắn lại	蜷
mục	项
Nội dung	含量
con rết	蜞
chủ đề	主题
Ghi lại	纪录
Trò chơi dã chiến	場賽
Bướng bỉnh	梀
Tsamp	猳
câu lạc bộ	梃
lỗi	謬誤
ôn tập	回顧
đủ	足以
cá đuối	鼭
Saud	绍德
Cục điều tra	调查局
gặp	会见
phái viên	使節
phân bón	化肥
pháo binh	火砲
Thay đổi	変
Đấu vật	摔跤
Zell	泽尔
tiếng ồn làm phiền	窸
cua biển	蛑
nạn đói	饥饿
quan tâm	利益
Phục hồi	回生
Putuo	普陀
Máy chém	铡
Pyrimidine	嘧啶
Kéo dài	辥
hữu cơ	有機
Kava	卡瓦
Thắng lợi	全勝
Chịu trách nhiệm	負責
ngân sách	財
Phần nhỏ	小部分
Rẽ phải	向右
Sk vùng	斯克州
Háu ăn	饾
thời gian	時間
Đơn vị con	亚基
ngân sách	预算
đồng đội	隊友
biểu hiện	表达式
Shuyi	淑儀
Chạy xuyên qua	贯
Camer	喀麦
tổ chức	主持人
Hoa anh đào	櫻花
Miền nội bộ	域內
Sự xuất bản	出版物
Phòng biểu diễn	表演系
dây chằng	韌帶
la kêt quả của	后果
Weiguo	卫国
khiêu vũ	跳舞
Meier	美尔
pha trộn	混
Trong vở kịch	劇中
Ston	斯顿
gia đình	世族
Lịch sử chung	通史
ổn định	安定
Đường may	缝
Nia	尼亞州
Yu Dui	於對
Gồm	所組成
may thay	幸好
Khó xử	肓
Li	蠩
Yun	鄆
Newyork	紐約
Cây thủy sinh	水草
phỏng đoán	猜想
Luo	溦
Fu	芙
truy vấn	劝说
Ngọc hoàng	玉皇
Thực ra	實為
Mela	美拉
tỉnh Chiết Giang	浙江省
giảm bớt	还原
Tiệc	騨
Ca hát	歌壇
Tổng diện tích	總面積
Nhút nhát	閮
rùa biển	鼋
mùa xuân	弹簧
Hông	髋
Cho bây giờ	為現
Miền	疇
sập	满贯
Bay lên	飇
Robin	罗宾
Gia trị được ki vọng	期望值
Lời nói đầu	序言
quên	忘
Huệ Châu	惠州市
tuyến tụy	膵
Vé	門票
đẹp	佼
tiếng Đức	德人
đi bộ	步行
Làm tươi	刷新
Qi	羗
người Trung Quốc	华人
hẻm núi	峽
Ba mươi ba	三十三
Biểu diễn nghệ thuật	演艺
Chỉ định	主治
Chỉ có	祗
Tháng sáu	筺
Giữ	揽
Trong tay	手中
Domini	多米尼
thiếu niên	青春
Lưu Bang	刘邦
Thành phố mới	新城市
Cốc	盏
Điều khiển	馭
Tường	華爾
nhà vua	國王
Tóm lược	摘要
Đằng sau xe	車後
Phôi thai	胚胎
TV Asahi	朝日電視台
Đa dạng	種各樣
Công việc nhà	家事
chiều dài đầy đủ	全長
Giải thích	阐
Lực lượng đồng minh	盟军
Boolean	布尔
Sau khi đến	來後
bản phác thảo	素描
Núi đá	石山
Tìm hiểu và	學與
Chân nam	南麓
Cuộn	輥
Vì sự thật	為實
Cho nó	為之
Gạo nếp	豽
Hung bạo	暴
Thuộc về bưu điện	邮政
trung thànhxôn xao	忠实洶
Bailey	貝利
Crewe	克魯
anh ta không làm	他沒
Thương	斯皮尔
Theo kinh nghiệm	實證
Giai cấp tư sản	资产阶级
hai lần	兩次
Hess	赫斯
Nhận đầu tiên	獲得第
Rừng hỗn giao	混交林
dịch	翻译
Hu	琥
Đất sét	克萊
Churn	流失
Dương	炀
Khi nào	時以
Argon	氩
Yi	翾
giữa	間
phù sa	淤
Đinh ốc	擰
đất sét	壚
Nagoya	名古屋
Hoa trà	山茶
Phan sinh	濟會
Shifa	時發
Cape Town	普敦
Liên minh dân chủ	民盟
xuất hiện	出现
Cuộc sống	活人
Ông nội	外祖父
kỹ sư	機師
Hoàn thành	竣
Đài Bắc Trung Hoa	中華台北
bánh lái	艄
Kuaiji	会稽
Sảnh đợi	大堂
Dòng chính	主线
Kinh doanh	工商
Chỉ có thể	僅能
Săn bắn	捕猎
vay	贳
Cấp dưới	下辖
Bướng bỉnh	輈
Tang	齀
Điếu xì gà	雪茄
Một nhóm người	一行人
Casa	卡萨
Thương gia	商家
bỏ phiếu	選票
Komatsu	小松
Di chuyển và	動及
Lòng tin	信賴
súng	槍
vấn đề	事項
Li	漓
chờ đợi	伺
Giấm	醋
Quan âm	觀音
Xe hơi	用車
Nhận định	識別
Zi và	子與
nụ cười	微笑
Quan thoại	官話
mực	墨水
Rela	瑞拉
Ghen tuông	揃
Gốc	產地
Hỏa táng	火化
Người sành ăn	美食
Chiến đấu cho	為戰
Yutai	於台
Hurd	赫德
tai Chi	太极
biểu hiện	表达
Tây An	読
Fiji	斐济
thông thoáng	明確
Tổng	总和
sự phân cực	偏振
liên bang	聯邦
Cho hai	為二
Sui	睌
bộ sưu tập	征收
Chen	辰
Dọc theo con sông	沿河
Giai điệu tích cực	正音
Và trong	並在
vùng trời	空域
thèm muốn	愒
Casti	卡斯蒂
đầu lâu	颅
bóng râm	廕
Sử dụng	克用
tan chảy	熔化
Shaoqing	少卿
Fukuyama	福山
Bắc Triều Tiên	北韓
Nhà Lý sau này	後黎朝
Baton	棒
Trực tuyến	網上
địa phương	当地
chuyên nghành	专门
thực ra	竟
Docking	对接
Chiến tranh giai đoạn	戰國時
Trụ sở chính	總署
ion	离子
Tối cao	至上
MCA	马华
ghim	销
Được xây dựng trong	建于
Dài	倞
Giám đốc	總管
Trung Quốc cổ điển	文言
Thứ hai	蒙德
Ăn thịt	食肉
Sâu	蓚
Kansas	堪薩斯
Kwai Tsing	葵青
King Wu	吴王
Người cao tuổi	長者
tương ứng	各自
Đài phun nước	喷泉
Nông nghiệp	养殖
gốm sứ	陶瓷
Yu	騳
buồn	悲
thì là	茴
Hợp tác	合作
Đông Phi	东非
Giáng sinh	聖誕
phòng thủ	捍衛
Chu	躽
trứng	雞蛋
hàng tuần	每周
Âm nhạc	音乐
Mirage	蜃
Giả mạo	伪造
Thời gian bằng	時由
Lượt xem	觀點
Ji Họ	姬姓
Lời phàn nàn	控訴
khí ga	气体
Khoảng cách ngắn	短途
Qinghai	青海
thợ mỏ	矿工
Vũ khí hạt nhân	核武器
Yuwentai	宇文泰
Tsuki	通志
ở lại	獃
duy trì	维持
Tặng kem	獎金
ba một	三一
Một bên	一边
Nhà sư	僧人
Trồng cây	種植
phòng thay đồ	更衣室
tinh thần	灵
đơn vị	单位
Nhạc Dương	岳阳
Vì sự bền bỉ	為執
đột phá	突破
Giám khảo	考官
Đồng ký	合署
mặt trước của quần áo	襜
kinh ngạc	驚人
Deborg	德堡
Eugene	尤金
ngoại ô	郊区
Bondage	束縛
Khối lập phương	方块
chống lại	抗
Cây bụi	布什
Dài	长
Mảnh khảnh	窈
giải phóng	解放
Manche	芒什省
Đầu tiên	甲第
giải phóng	釋放
Thêm vào	新增
bổ nhiệm	委任
Lớp hai	初二
Yu	騜
Shan	姍
Dễ dàng hơn	更易
nơi	斑
Dịch	譯本
Bộ	笀
chú rể	倌
Ghi lại	記載
Đỉnh đầu	头顶
Quyền hạn	舝
quần áo tã cho trẻ con	繈
Bắn	枪决
Tấn	吨
nguyên liệu thuốc men	本草
tổ	巢
Zhu	祑
Tiếp cận	临近
Quốc gia kiểm soát	制國
Giám sát	監
Aya	绫
Doba	多巴
Thị trấn nhỏ	小镇
gọi ra	咻
Lần đầu tiên	初次
Trưởng	酋長
Nhập cư	移民
khiêm tốn	卑
Trung Quốc	中華
Toàn thành phố	全市
Yao	貅
Năm nay	今年
sự áp bức	压迫
màu xám	灰色
nhẫn	响
Tìm thấy	發現
dè dặt	謹慎
La Mancha	拉曼恰
Khi đến thăm	訪時
Toàn thể	全会
chính xác	正確
thông thường	平時
Lợi nhuận	牟利
Sốc	冲击
Nỗi khó khăn	难者
Khen ngợi	赞赏
Longyan	龙岩
Với sự giúp đỡ của	借助
có hiệu lực	現行
Giàu có	裕
và vì thế	所以
Pan xanh lam	泛藍
vật	物件
Vàng	金色
Sáng	明
Xếp hạng Đại học	大學排名
Thành phố nam kinh	南京市
Bệnh trầm cảm	壓器
Địa chỉ gốc	原址
nhảy lên	蹿
Thiên Thủy	天水
tua	旒
hy vọng	预期
Đường sắt	路軌
Lấy	服用
Xiao	瀟
chuyên quyền	专制
Qi	虂
Được xây dựng trong	內置
Đã học	學的
Định cư	入驻
tội	罪恶
Quốc gia	国立
Chỉ trích	諍
Tu nhân của chiên tranh	戰俘
TEDA	泰达
trống	鼓
bài tập	任务
Khai sáng	启发
Cá chép	鲩
Suo	珷
khí hậu	氣候
Gree	格列
Giới hạn trên	上限
Bốn loại	四種
Qi	覲
trận chiến	仗
Thiếu tướng	少将
bùn lầy	濘
Người giám hộ	護法
Không biết xấu hổ	婌
Hạt Gen	根縣
Ye	赯
cao nhất	最高
Copenhagen	哥本哈根
toàn bộ	整
Ngươi	斄
Ml	毫升
Mù quáng	盲目
Giải Kim Mã	金馬獎
hạm đội	艦隊
Bộ nội vụ	務部
Cepheus	仙座
Đốt cháy	焚毀
Lông	海尔
Thích	賛
mũ lưỡi trai	帽
Putin	普京
cận thần	朝臣
Bác sĩ quân y	军医
Người đại	傣族
vật chất	料
Giơi hạn dươi	下限
đan lát	筚
Libya	利比亚
hy sinh cho thần chiến tranh	禡
mặt nước	水面
cuộc thi	競爭
máy trục	鹤
Bảng điểm	誊
Anh bạn	布羅
Shi	輚
mở	开
muộn	迟
Sảnh lớn	大会堂
vấn đề	难题
Chức vụ	司职
Tiếng hà lan	荷蘭語
Nasi	納西
chạy	运行
Vetch	鋕
Yi	怡
Dap xe	搭乘
dụng cụ	儀
khỏi bệnh	痊
He Hong	何鴻
Chính thức	公事
Brahman	婆羅門
Trong số tốt nhất	名列前茅
Erno	爾諾
Sharan	夏朗
Thủ lĩnh	領軍
Huguang	湖廣
Loại bỏ	汰
đại sảnh	廳
lấy	采取
Đúng	了對
Phi lợi nhuận	非營利
tích cực	正面
Nâng lên	秉持
Thêm vào	怐
Được đánh dấu là	記為
dẫn đến	導致
Mang	运载
Trước mặt	前置
Tại sao	为何
Dòng sắp tới	線來
họ	她們
Kỳ nghỉ	渡假
Dốc	斜坡
mua, tựa vào, bám vào	採購
Tên chung	通称
Nhà ga	该站
Lan tràn	散布
KCRC	九鐵
hơn thế nữa	矧
Zhan	欓
phóng đại	夸张
Ying	颃
Thiết bị đầu cuối	末期
thô lỗ	獗
giảng bài	教學
đóng cửa	阏
Con mèo	貓
thóc	稻田
Trung tâm	中央
Đồng phục	校服
Dayu	大禹
động lực	動機
chì	铅
Trên bờ vực của	濒临
Chiếm ưu thế	盛行
khắc chạm	栔
Phun	噚
Hai lớp	双层
Li	讜
Thời sự buổi tối	晚报
Tàu con thoi	太空梭
Khá	颇为
giỏ trái cây	籩
Thân tháp	塔身
Mia	米亞
Sự vi phạm	違規
Ngọn lửa	大火
Zhe	喆
Xâm lược	侵略性
Quốc tế	國腳
động cơ	发动机
Họ hoa	花科
Rạn san hô	珊瑚礁
Mauri	毛里
Khi nó xảy ra	發生時
Cái này	這首
Đặc tính	功能性
Georgia	格州
Tượng trưng	象征性
Một loạt các	一連串
Bai Chongxi	白崇禧
Đơn hàng con	亞目
Miaoli	苗栗
thổi	飕
Đường Des Voeux	德輔道
hiệu quả	效能
Thực hành	執業
Độ phân giải	議決
Ghét	憎
máy tính bảng	牓
Mike	迈克
Tuyết tan	融雪
Argentea	葙
xem	睹
Ver	凡尔
Đặt hàng	阶
Tây Bắc	西北部
Tuôn ra	通量
Tình hình chính trị	政局
nhiều lần	一再
Wilson	威爾遜
Mạo danh	冒充
Zhuang Zhen	庄镇
Ba chiếc nhẫn	三环
không bật	正午
Lừa gạt	涓
Và tham gia vào	並參與
II	二世
Bằng lăng	拉格
gợn sóng	涟
Dragon Haome	龍下目
Cặp đồng quê	國對
phân loài	亚种
erbium	鉺
Ý tưởng	思路
Hợp đồng	约定
David	大衛
phi hành đoàn	船员
Không thường xuyên	不常
nhà tù	监狱
Cấp	品等
quá đáng	過多
Giải thưởng thành viên	員獎
Kevin	凱文
Xa lánh	漷
Trong thành phố	城内
Alsace	阿尔萨斯
Shidi	士第
con đường	逕
Kế vị	继任
hoạt động	行動
Aff	阿弗
Lhasa	拉薩
sự đốt cháy	燃烧
Số tiền là	量為
Người bạn đời	配属
con đường giữa các trường	塍
Tranh cãi	之爭
Wuxu	戊戌
trượt	霤
Khai thác	剥削
Giải quyết	化解
Khối	崽
Nhớ lại	记
bờ biển	岸邊
Fu'an	福安
Sẽ giữ	會執
Quốc huy	盾徽
Khu vực đảo	島區
Nian	輦
Công quốc	公國
bán kính	半径
Bài hát nổi tiếng	名曲
Meli	梅利
Kowloon	九廣
Người đàn bà xấu xí	嫫
Quân Thanh	清军
Tấn công lén lút	偷袭
nó là	其
Cá chim	鲳
Babylon	巴比倫
kẹp	钳
Shao	魾
sắp chữ	排版
hỏi thăm	诜
Hồ Nam	南湖
Ngày 24	二十四日
Vạn tấn	萬噸
Cổng vòm	牌楼
Đại biểu NPC	人大代表
Nước xốt	酱
thích hợp	恰當
Yi	栿
Mãn Châu	滿洲
Cái đầu	团长
ngập	潦
Quy tắc của pháp luật	法治
Sông băng	冰河
Cả hai giới	兩性
Dòng đông	东线
nồi nấu kim loại	坩
Xếp hạng giữa	跻身
Phiên âm	誵
Trung thành với ai	忠於
Poop	便
Tongfu	統府
mộ	陵墓
Bươc	邁
thảm họa	灾
tải	負荷
Chỉ huy	统帅
sai	不實
Chống lại	對陣
Âm	猐
Châu Á	亞語
buồn tẻ	爚
băng thông	頻寬
Môn đồ	之徒
Lưu trữ	收容
Tranh giành	橔
Bộ gen	基因组
Yi	勹
thị trấn	乡
Đồng tác giả	合著
Người Mỹ gốc Phi	非裔美国
Mụ Na	木乃
nhảy lên	躥
Sri Lanka	斯里蘭卡
Không đầy	未滿
Nhỏ hơn	較小
du thuyền	巡弋
hạt dẻ nước	荸
Chờ đến trường	等學校
Mua, tựa vào, bám vào	购置
bọ chét	蚤
ăn cướp	抢劫
Lĩnh vực và	場與
Quốc gia và	國及
Xuất sắc	叱吒
mơn trớn	挲
lấy đi	带走
cá chép	鯉
Ngai vàng	皇位
Tất cả thời tiết	全天候
Cá chình	鱔
chuỗi	弦
Kết hợp	編入
Đường hoàng tử	太子道
Feicheng	肥城
Sacral	骶
London	伦敦
giới tính	性別
Trung đoàn	團軍
Kun	崑
Ngỗng hoang dã	雁
Lãnh sự	领事
Plutonium	钚
Thừa kế	承繼
Di tích văn hóa	文物
rạp hát	戲院
Ngai vàng	帝位
Ying	鞴
Sự miêu tả	说明
Ranh giới	分界
Hải quân	水軍
Quốc tịch Trung Quốc	中國國民
Tulu	图卢
sao chổi	欃
Bàn giao	交给
Odontosaurus	齒龍科
Hủy diệt	歼
Tần	沁
gộp lại	總額
bình Minh	暲
Mỡ động vật	桕
Tấn	郘
phương pháp	方法
vu khống	訕
Đến Shi	致仕
Đi	橓
Đạo đức	士氣
tuân theo	服從
Mờ nhạt	敨
Từ	一詞
gián điệp	間諜
Đọc	讀取
Madhya Pradesh	中央邦
rực rỡ	华丽
Lagrand	拉格朗
phía đông	東
Tuần thi đấu	賽週
Khi này	當這
Địa mạo	地貌
Mesopota	美索不达
phòng thủ	捍
chăn nuôi	孳
Tát	瞕
Hộp đạn	彈殼
đốt lửa nghi lễ	槱
chủ nghĩa Mác	马克思主义
Dazhou	达州
Ông già	妟
Sách cổ	古籍
Đặt	置於
dép gai	屩
sầu muộn	懑
Xẻng	镡
tòa tháp	塔
Lang băm	僉事
đầu lâu	髑
Thiên nga	天鵝
thực hành	实践
thấp nhất	最低
HG	汞
Xứ Wales	威爾士
Bas-Rhin	下莱茵省
Luẩn quẩn	狞
ổn định	枥
Hình thức âm nhạc	曲式
Bài đăng	張貼
hủy hoại	摧
Trưởng đảng	黨總
Mạng lưới đường bộ	路網
cờ	旗
Đa dạng	各种
xem xét	考虑
dồi dào	瀌
Súng tiểu liên	冲锋枪
Nắm bắt	扣押
Đưa cho	赋予
Hòa giải	调解
Thảo mộc	草本
Đánh bại	战胜
Ra mắt	登場
Zhu	苿
Truyện tranh	漫畫
Giải Giai điệu vàng	金曲獎
Phần dưới	下部
Wei Ye	维也
Yên tĩnh	謐
Phai màu	淡化
vịnh Ba Tư	波斯湾
Thời gian	間則
chim gõ kiến	鴷
Tổ chức	憲
Tát	肜
Ghế	座席
giám đốc	导演
Nga hoàng	沙俄
nhóm	小组
Xứ Wales	威尔士
Tiết kiệm	慳
Bạn bè	好友
Ville	维莱
Nago	名古
Ye	聒
Moser	摩泽
chơi	玩耍
Không hài lòng	不服
Sumata	蘇門答
Được xây dựng trong	內建
con hàu	蛎
Hôm qua	昨
Recycle	回收
Tát	蹐
Bộ sưu tập sách	藏书
Khu bảo tồn thiên nhiên	自然保护区
Bằng tiếng mẹ đẻ	母语
hạt dẻ nhỏ	芧
Luật dân sự	民法
cá đuối	鸐
Đồn cảnh sát	派出所
Băng qua sông	渡河
Người bắn súng	射手
bỏ cuộc	放棄
Nhân lực	人力
Năng lượng mặt trời	太阳能
Tóc quân đội	軍發
đất đai	陆
mang đến	带来
Đi biển	出海
Co thắt	挛
Marshalling	編組
Zigong	自贡
Beichen	北辰
thăng chức	提拔
con hàu	蚵
lưng gù	偻
Tây Tứ Xuyên	川西
Sài gòn	西贡
Hamm	哈姆
Hàm trên	上頜
Sau khi thay đổi	變後
Yun	鋞
Sự kiện	事記
Dài	竜
trong nhà	室內
Các sản phẩm	製品
khủng bố	恐怖
sự quản lý	管理学
đối lưu	对流
Nhân loại	人類
cây sung	梧桐
Khu vực hội họp	会区
dựa theo	按照
Golden State	金国
Giao thức	议定书
Heinrich	海因里希
Kea	基亞
cấp trên	优越
trang hoàng	缛
Trong số hai	出兩
Mập mạp	茬
nghèo	窮
Giáo dục	教育界
biển cả	公海
Hitachi	日立
sự quyết tâm	判定
Abdou	阿卜杜
Walter	沃尔特
Nhóm	基团
quai hàm	顎
Khu vực	大區
Max	马克斯
lớp trên	上層
mã hóa	編碼
Gundam	鋼彈
Hai	兩名
ga tàu	駐地
Nhanh	齋
Đảo Hồng Kông	香港島
đều đặn	正规
Trận chiến này	此战
Vội vàng	鈜
Fen	芑
thuyền buồm	帆船
sắc lệnh	诏书
Tiếng hà lan	荷兰语
Tiểu bang Mori	森州
Khảo sát	测绘
Công việc của chính phủ	政務
Frederick William	腓特烈威廉
Trong đội	队中
nhà hàng	酒家
Quốc giáo	国教
kêu vang	鐺
chính trị	政治学
Ya	衙
Ting	汀
Xem	看作
Yun	汔
Si	瞀
chim bồ câu	鴿
Mel	梅尔
Swa	斯瓦
Qi	蕲
Chính trị	政坛
Ễnh ương phương đông	鷽
Thượng nghị viện	参议院
Bất động sản	物产
sức mạnh	強度
rượu	醇
đĩa	圆盘
Mite	蟎
nhóm	組
Địa điểm	場地
hàng rào	籬
Đạo công giáo	天主教
Ming	旟
Lai	僴
Sự hy sinh	牲
Gây quỹ	筹款
Trình duyệt	浏览器
Giám đốc	总管
Xe đua	赛车
Wei	煒
trên sân khấu	在臺
chỉ	只是
không trang điểm	缦
Hu	胡
Jidong	冀东
kẻ cướp	土匪
Tver	特维尔
một chút	稍
gương	镜
Schleswig Holstein	石勒苏益格荷尔斯泰因
lò lửa	鑪
Chào	嘿
Có xu hướng	趨
Quyết định	決定
hướng dẫn	感应
luận tội	劾
Tổ tiên	始祖
nổ	爆
Tang	漌
Nee	倪柝
Cho đến chết	至死
Na	納
Sáng	輝
Nhăn mặt	蹙
Nhà ở công cộng	公屋
thịt hiến tế	脤
Sắp xếp	排序
Angler	鮟鱇
Trong suốt	透明
Luôn luôn	始终
Xô Viết	苏维埃
Có một cuộc hẹn	有約
Tấn	莟
ngay thẳng	直立
Qi Guo	齊國
Cảnh báo bão chung	聯合颱風警報
Danh sách rút gọn	入围
Luce	卢斯
Trang điểm	妝
Mở rộng	擴展
Quy mô	鱗片
Gắn kết	裱
Dordogne	多尔多涅省
thẩm phán	法官
bánh xe	轮
Jing	璔
Yamato	大和
Phiên bản tiếng nhật	日文版
Nói dối	躾
Xi	僩
Dura	杜拉
thưởng thức	享受
Mối đe dọa	威脅
trì hoãn	推迟
biển phía đông Trung Quốc	东海
Tun	暾
Tài nguyên	资源
Zhu	徂
Đường	糖
Quan chức cấp cao	高官
Shi	轣
Kết cấu	構
Xi	僲
vạch kẻ màu đỏ	紅線
Rand	兰特
Thời gian này	這個時
vô tư	冷漠
xin vui lòng	请
Dap xe	策騎
Castanopsis	栧
cát	沙
rối loạn	動亂
cẩu thả	慵
Chết trên	卒於
Linh hoạt	靈活
Khuôn viên	校区
Có hình dạng như	形如
nền tảng	基礎
Lời nói đến	來語
Thời tiết	天候
Ding	仃
Cameo	客串
Thân tàu	船身
Adrenaline	上腺素
Bị lừa gạt	被當
Làng Đông	东村
đau đớn	疼痛
Xa lánh	洅
từ điển	辭典
Khác nhau	紛
Khóc	忎
Bên cạnh	身旁
mang	鳃
người rừng	泰山
tắt	関
Ei	鸗
Phích cắm	塞
hung dữ	凶
Tại cuộc họp	會上
về nguyên tắc	原则
đầu tư	投資
Yamamoto	山本
Cacboxylic	羧
Đương nhiệm	現任
Trận bóng đá cúp	盃足球賽
Khu vực vịnh	湾区
Ngược lại	相比之下
Đã từng nói	曾說
Jiujiang	九江
vá	补丁
61	六十一
Cựu sinh viên	校友
chiên	炒
Quy Nhơn	歸仁
cắm trại	露營
Viêm	炎症
Hoàng đế Tần	秦皇
khu vực	地區
sân vận động	體育場
Quỹ đạo	軌域
bảo vệ	守衛
Bướng bỉnh	掇
Mary	瑪麗
anh hùng	英勇
Đạo sĩ	道人
Nhanh	快速
đơn giản	單純
Dòng chữ	题写
Anna	安那
đào mương	溝
Quận Ye	耶区
Đoạn đường	路段
khu vực	區域
Lyle	莱尔
Lywood	莱坞
Giơ lên ​​lơp	級時
Lu Guo	鲁国
Không sử dụng	未使用
Bầu	当选
Giải thưởng	獎禮
di cảo	追贈
Trung học phổ thông	中學
lấy	搭
giảng bài	教学
Âm	錖
Moo	喞
Potsdam	波茨坦
Maki	莳
tượng đài	碑
Biểu tượng	符
Tương ứng	分別為
Tòa nhà giảng dạy	教学楼
nước Đức	德国
Sản xuất điện	发电
không nghi ngờ gì nữa	无疑
Nói	言
thờ cúng	供奉
Ju	鞠
phương tiện	載具
Album	大碟
do đó	因而
Liên minh	联队
Bang Yu	國於
hủy hoại	毀滅
Ye	迳
Venice	威尼斯
Bahia	巴伊亚州
Catello	加泰罗
Trực tuyến	网上
Mơ hồcông việc của nhà nước	歧义朝政
Cá mèo	粇
Tin đồn	据传
thu nhập = earnings	收益
Watchman Nee	倪柝声
Bedo	贝多
Baotou	包头
Liu	銎
khí quyển	臭氧
hố	坑
thông qua	取道
Chân	足類
Được thăng cấp lên	晋升为
hợp tác	协作
chất xơ	纖維
quân đội	軍方
Do đó tên	故名
Sandia	圣地亚
cao quý	高尚
đạt được	获得
Mississippi	密西西比州
Gây quỹ	募捐
tối	黧
Ương ngạnh	反叛
bờ biển	海灘
Sinh hóa	生化
Dewang	德王
hình dạng	狀
Hoặc là	奥尔
con quạ	克劳
tôi e rằng	恐怕
xẻng	鏟
Jian	筧
kiêu ngạo	傲慢
Masonic	共济会
đàn bà	女子
Trường đua ngựa	馬場
Biến dạng	變形
Nói	说道
Đánh	擊時
Trận chiến	之戰
Missouri	密蘇里
sự đông đặc	凝固
Màu xanh da trời	蒼
đứng cho cốc	坫
đảng phái	黨派
từ ngữ	词
Chim ưng	隼
Chen	陈
có dây	有線
niêm phong	印章
Chiều cao công trình	樓高
thù địch	敌对
Lựa chọn	评选
Khách	訪客
Tử vong	之死
Nhiều	洛特
đặc biệt	特别
hộ tống	护送
Yong	埇
Đánh nhau	争斗
armadillo	狳
Bộ Nội vụ	民政部
toàn cầu	环球
Finale	終場
Nói	謂的
bính âm	拼音
tuổi tác	年龄
Duo	哆
ánh sáng	淡
ghét	癉
Quyến rũ	粲
mô hình	機型
Dominic	多明尼
mô hình	型號
Bray	布雷
Yan	顔
Cva	茨瓦
khảm	镶嵌
Đặt hàng	订
Đức phật	佛祖
Quận Gang	岡縣
Quạt	範
Đầu tiên	首次
Trong giai đoạn	相中
Chống lại	对阵
Hai ba	二三
Từ chức	离职
bóng râm	庥
Chấn lưu	砟
Yu	鴜
Diablo	暗黑
lúc đầu	起初
Sự tự tin	置信
Bước tiến vượt bậc	大跃进
Là	儴
Shiina Ringo	椎名林檎
Sau đó nhận ra	則認
Góc tây nam	西南角
điển hình	典型
Người Ailen	爾語
Lên án	谴
Sâu	軚
Cư dân	居民
sinh vật thần thoại	蜮
Lo lắng	惔
Gặp	相約
Xinping	新平
quán cà phê	咖啡馆
Đại học Columbia	哥倫比亞大學
sự tự tin	信心
Trong văn phòng	任内
Tài nguyên nước	水资源
Khởi hành	發車
Mặc du	虽然
Quạt bang	州藩
kiên nhẫn	患者
chồi non	蕾
Hai mươi lăm	第二十五
Ngô	玉米
Xì dầu	豉
Tiết tấu	涍
Ủng hộ	托
Duẩn Qirui	段祺瑞
Bán phá giá	甩
Ăn côn trùng	食虫
Phong	沣
Nhiều mây	叇
Hơn	則較
Han Jun	漢軍
Puri	普里
Euler	欧拉
mù sương	縹
Xem	参见
Cổng phía Nam	南門
Yu	騛
Ersay	爾賽
liên Hiệp Quốc	联合国
mạch lạc	連貫
than phiền	諑
cấp độ	級
lãnh đạo	領袖
cái cổ	脖子
hiện đại hóa	现代化
Nanxiong	南雄
Sura	苏拉
thanh kiếm	鋏
chú thích	注解
Và	們並
Lan	澜
Xuân	瑆
Và	與及
Nhà điều hành	業者
quan tài bên ngoài	椁
Hai loại	兩種
thời thơ ấu	幼年
nắm lấy	捉
cuối cung	弰
axit béo	脂肪酸
Đức Giê-hô-va	耶和華
bất kể	無論
Đặc biệt	特指
Thuộc về	隶属于
Tên	名
Bài báo buổi sáng	早報
Hồ Po	鄱
Liều lĩnh	莽
Wa	娳
Đây	茲
Li	馃
tiếng Đức	德文
đài hoa	萼
Anthony	安东尼
Quyền lực	權勢
Nó đang ở trong	其於
chũm chọe	钹
đống đổ nát	残骸
Hội đồng An ninh	安理会
Tài liệu tham khảo	参照
Bắt chước	仿照
Tốt nghiệp	學畢業
sự cứu rỗi	救世
hào	护城河
Shakespeare	莎士比亚
đạo đức	伦理
Mae	湄
Khoảng thời gian	时段
nhiều màu	繢
stronti	鍶
đường hầm	坑道
Lờ mờ	棜
tiền tệ	货币
tương ứng	分别
Hukou	湖口
Joseph	約瑟
Cửa hàng	門市
Trưởng sư	大师
neodymium	釹
Đĩa	板块
Nói	賽德
diễn viên diễn viên	表演者
Reeve	里夫
dân gian	民间
Quận Dapu	大埔區
Bộ ngoại giao	外交部
Georg	格奥尔
thuyền	舺
thường xuyên	經常
Vòm miệng	腭
cái đầu	头部
Đá	矶
Trở về	歸
Ba chiều	三维
Dài	久
Nhúng	霑
giữa Lo	中低
Dur	杜尔
Đặt hàng	個階
Cái này cũng vậy	這個過
Covet	觎
Những điều cần thiết	要件
đến	抵達
thiết lập	设立
Chọn	揀
Bản địa hóa	本地化
Tây An	耥
Sử dụng đất đai	用地
Người đi đầu tiên	先發
gạch	磚
Cà vạt	餫
Miễn	豁免
kẻ nghiện rượu	酲
đá vôi	石灰石
Corsi	科西
Hình trụ	柱形
xin lỗi	道歉
Thời gian dài	長時
Xe cơ giới	机动车
Sự đối lập	對論
Bonito	鱣
Chuyển hướng nước	分水
cá	鱼
Varey	瓦雷
Phải lòng	爱上
nữ hoàng	御用
Xiêm	暹羅
Theo dõi	曲目
Lòng tin	信任
Bài gốc	原任
Crimea	克里米亚
khách	宾客
Ô cửa	门口
kéo ra	薅
xây dựng	興建
cũng	甚至
Để ý	預告
vu khống	诽
Thời lượng	历时
Già hơn	桤
bằng lòng	恹
cái đó	那
Đạt được	获取
Tang	衂
xúc phạm	罪行
Nhà nguyên	元朝
nhãn	标签
Nheo mắt	磝
Ster	史特
oát	瓦特
Đã rửa tội	受洗
sân quần vợt	网球场
Tách ra	支队
Mang vào	带入
giọng	口音
Lừa đảo	螯
Năm ngoái	上屆
Astoria	道夫
Vilnius	维尔纽斯
Đi vào	行在
tiết kiệm	挽救
nghỉ ngơi	休憩
Thống nhất	團結
con cú	鵂
Đáng mơ ước	如意
Vào dịp	之际
tình cờ gặp	跲
Đánh máy	擊機
Danh sách	榜單
đổ nát	偾
Phía sau	後面
sử dụng	运用
trang mạng	網站
Gu	蛦
tiếng nước bắn tung tóe	泙
Lực lượng tăng cường	援军
Quinoa	蔾
đồng tiền	硬币
Zhuan	颛
Đối với	至于
Erba	爾巴
sân vận động	体育场
Kazan	喀山
trại	營
trôi dạt	漂流
Maoming	茂名
chặt chẽ	緊
Xiaoqing	小青
Phong tục	海關
钭	鈄
Đặc biệt	特种
kiêu căng	奡
đẹp đẽ	妵
Hoa sen	菕
đình chiến	停战
Bất hợp pháp	违法
Quốc gia	诸国
Nuôi dưỡng	教养
Burgos	布尔戈斯
Màu xám	黲
thư pháp	书法
Người Bồ Đào Nha	葡
chim ưng	鷹
Đánh chặn	攔截
Li	佪
niết bàn	涅
Người hâm mộ	歌迷
nổi loạn	谋反
sáng kiến	主動
Không chính thức	非官守
Tốc độ	航速
Cổ hủ	老道
Thái Bình Dương	太平洋
kiệt sức	枯竭
Xu	许
Maanshan	馬鞍山
xây dựng	建築物
Suri	苏里
Hoff	霍夫
đang chờ đợi	等候
Con thỏ	兔子
vận chuyển	运送
Thân hình	軀
Đơn chất	灸
kéo	扯
Làm mới	清新
Người chiến thắng	获得者
Nước chảy	流水
Yue	岳
cháu gái	孙女
ngu độn	密
Nước Anh	不列颠
Âm	桱
ngược lại	相反
xe tắc xi	計程車
Yunda	雲達
thẩm quyền	權威
Manha	曼哈
hoảng loạn	恐慌
Đồ đá mới	新石器
Epromium	镸
Ống nước	水管
Zoro	祅
Jeff	杰斐
Guinness	吉尼斯
gọi	呼
đại sảnh	霍爾
Liu	骝
giảm	減低
Tổng đội	隊將
Hàn Quốc	大韓民
Mast	桅杆
Dòng dõi	血統
điện	电气
Man rợ	夷
thay đổi	變革
Thông minh	優異
Yên tĩnh	蚇
Bản in lớn	大字
Khuôn viên	校區
Nhưng tại	但於
Thiên nhiên	性質
họp lại	聚會
Sản xuất điện	發電
không ngừng	不休
Loggerhead	蠵
Nguy hiểm	險記
Machimura	町村
tiếng nói	语音
Sơn	塗
Cho vợ	为妻
thư	郵件
Của	的則
cà vạt	綁
làm hại	害
tại thời điểm này	這一點
trợ cấp	津貼
Vô cùng	為極
Tahe	塔河
đồng tiền	錢幣
Nâng cấp	升格
Nhân mã	人马
Nổi bật	出眾
Đấu vật	角力
ngẫu nhiên	隨機
Tái tổ chức	整编
Yi	羴
Bắt cóc	枴
Hui	回族
nhầm lẫn	舛
Ủy ban Trung ương	中央委员
Wan	阕
Sóng thần	海嘯
ngôi đền	神殿
ngăn kéo	屜
Sự khiêu khích	衅
Mua trong	購入
Lỗi	澙
Đối với phương đông	為東
tạo nên	創建
Khu Liên Xô	苏区
và	而且
Nam giới	男性
sự chiếu sáng	光照
săn bắn	獠
Tán thành	获准
rau diếp	萵
thế giới	人間
phấn hoa	花粉
Nghịch ngợm	匭
bản nháp	草稿
sơ cấp	初级
Người môi giới	经纪
Người mới	新人
Đan mạch	丹麦
Độ ồn	響力
Rang	焙
Tamarisk	檉
Bảo vệ	护
đọc	阅
giảm xuống	駁回
Đi	围棋
bò	匍
kích thích	激励
Li	泇
cái hộp	匣
Âm	龖
ý định	用意
Beilu	北麓
ly hôn	离婚
CPSU	苏共
Thành viên của Quốc hội	议员
Giả thuyết	假设
kém cỏi	劣
thiên đường	樂園
Luôn luôn	始終
Haisheng	海生
xà bông	皂
độc quyền	独家
Phượng Hoàng	鉼
Chu Yu	楚瑜
ủng hộ	赡
Nhiều	重重
Yên tĩnh	蜊
Sâu	蝛
Tỉnh Hắc Long Giang	黑龙江省
Đôi pho vơi	對付
con bò cạp	艛
Tianchi	天池
Hime	姫
Thị trường	墟
Hatta	畑
Latour	拉圖
Không khí	爱尔
thorium	釷
vượt qua	扠
Và lấy	並獲
đổi	汇
Cấp trên	上级
Từ Hi	慈溪
Đông cứng	凍
tù nhân	俘虏
Jordan	乔丹
Pu	檏
Yu Shi	于世
Dagang	大港
um tùm	薿
Offroad	越野
con dơi	蝠
Đối đầu	對峙
vận động	征战
So sánh	比照
Thông báo	公佈
thí dụ	例
Manchester	曼徹斯特
Shao	魬
Trường Xuân	長春
môi	脣
Giám đốc	局长
Thánh thần	聖靈
Romania	罗马尼亚
Thiếu tôn trọng	不敬
Rêu	蘚
mở	开阔
Shinjuku	新宿
Tây An	奊
và sau đó	進而
Sẽ bắt đầu từ	會從
Tiền vệ	外野手
Chuyển đổi	轉型
đại dương	远洋
Tổng cục Chính trị	总政治部
Con nai	獇
ma thuật	魔力
Qufu	曲阜
So sánh	比較
Iliac	竂
tỉ lệ	規模
giỏ đựng đũa mảnh mai	籯
Điệp khúc	合唱
hủy bỏ	取消
Nghĩa trang	墓園
Wen Zhong	文忠
điều răn	诫
bực bội	怒
Xunzi	荀子
Không có	一個無
di chuyển	舉動
Đẹp	帥
Torre	托雷
Bang	嚘
Khu vực địa phương	當區
Hậu cung	後宮
Tin tức	资讯
Tro	特罗
thực tế	實
Tư nhân hóa	私有化
sức sống	生命力
Yan	闫
Hoàng đế Wu	武天皇
Emissary	密使
Lồn	屄
đường	馬路
Nơi quan trọng	要地
Không chung thủy	变格
tham dự các chức năng chính thức	浰
xe tăng	罐
sẽ	将
Ngừng	停辦
Sam	萨姆
Mackin	麦金
Ju	榚
Kết nối	衔接
nguyên nhân	事业
Nông nghiệp	农
sao chép	複製
Satoshi	聪
Tịnh độ	淨土
canxi	鈣
Áp dụng cho	投考
Lan tràn	流傳
Oviparous	卵胎生
Dịch chuyển	位移
Latin	拉丁文
Kui	逵
nguyên tội	原罪
Thực hiện một chuyến đi	成行
Theo mùa	季节性
Hợp tác	為配合
Milan	米蘭
Cánh tay	萂
Thời cổ đại	古時
Hiến pháp của Trung Hoa Dân Quốc	中華民國憲法
Inkstone	硯
Súp	湯
Shu	蕑
Ghim	蒾
Công chức	文官
hành hung	突击
Yas	亞斯
Pullen	普伦
chứng chỉ	證書
Tát	捔
Hoàng	癀
Dongjiang	东江
Xu	晥
Anna	安娜
Tham khảo	指稱
áp phích	海報
đời sống	寿
đã đăng ký	注册
Tên mã	代号
tranh tường	壁畫
thất vọng	怃
Giữ	擁
Ghế nữ	女座
Boolean	布爾
Tp.	市市
Senborg	森堡
Hình ảnh	成像
ấn tượng	印象
Phía sau	身后
Yan	焔
Chuẩn bị	预科
Hố đá	石坑
Ngai vàng	王位
người phục vụ	伺服器
bay	飛
Ở đâu	该处
Nancy	南锡
người tị nạn	難民
quê hương	祖國
kiểm tra	试
Kích thước	維度
đấu	獨奏
lợi ích	好處
giới tính	性别
Ghen tuông	嫉妒
bùn lầy	渾
Thắng lâu	龍運
Từ	起於
Tờ rơi	小叶
xúc phạm	侮辱
Wu	鬂
quét	掃描
Chống chiến tranh	反戰
Là	逶
con sông	江
quỹ đạo	彈道
không thay đổi	常数
Roi da	抡
Vui mừng	懽
Hou	堩
không dây	无线
Nga Mi	峨眉
Thân tàu	赫尔
vào thứ bảy	週六
thánh	圣徒
Đảng Lao động	劳动党
Soái hạm	旗艦
mili giây	毫秒
sẵn lòng	愿
kịch bản	腳本
Bài thơ	詩集
lily pad	蕸
Liên quan	牵连
Phát triển ngành	業發展
Thành phố Qiqihar	齐齐哈尔市
Đóng cửa	封閉
Geng	賡
Thủy quân lục chiến	海軍陸戰隊
Nuốt	櫡
Tanigawa	谷川
Bao vây	厎
kỷ luật	紀律
Diễn viên lồng tiếng	配音員
tử cung	子宮
Qi	慼
miền núi	多山
Sam	鐒
Như một tài liệu tham khảo	為參
Xuanwu	宣武
Chen	琛
Yi	濽
Vô thần	无神
Đó là nó	而已
đánh	撞
Hoàng Thái Cực	皇太
Tin	锊
chết trong nhà tù	瘐
Điện khí hóa	电气化
Hãy cẩn thận	慎
Phê duyệt	审批
thử	尝试
Ao	敖
đổi	換取
Cá vây	鰭魚
Sâu	蚮
gậy	桿
Đường Ham	咸道
Tao	韜
Làm hết sức mình đi	尽力
Wei	潍
Âm	臒
Lithuania	立陶宛
bữa ăn	餐
Cái gọi là	所謂的
đấu sĩ	战斗机
Tính di động	動性
Lòng khoan dung	包容
kết án	句
Tĩnh	静态
cửa biển	海门
Rồng	龍類
Chuyển đổi	转型
Ling	仫
Mike	麥克
Người khởi xướng	始人
điều này	這件
Chìm vào	沉入
Không được	不被
Huren	胡人
Biển nhật bản	日本海
Juan	胡安
giải phẫu học	解剖学
Shide	士德
Fu	阜
Giu-đa	犹大
Kolo	科洛
Kỹ thuật	朮
Cục quản lý	行政局
cào cào	蝗
truyền tải	傳動
Dung nham	拉瓦
Bobo	波波
Lá rộng	阔叶
đổi	互换
Không bao giờ	從未
Damascus	大马士革
Hông	臀
quá	太
Đặt thành	設為
Bọ cánh cứng	蠹
Abel	亞伯
Đấu cúp	盃賽
khuyến khích	促
loạt	系列
khảo sát	勘
hủy hoại	毀
Fu	饦
Ngã tư	交叉口
thăng trầm	熱潮
Co giật	玙
Li	俫
đông lại	沍
Cung điện Hoàng gia	皇宮
Ah	丫
thông suốt	顺利
Kai	鴗
Chi nhánh	科
Môn học	學科
Hủy diệt	殲滅
Cuối năm	年底
Chu	涥
kết cấu	構造
Khóa	綹
Aix	艾克斯
ba mươi tám	三十八
Lượt xem	查看
Kaza	卡扎
tàu không gian	飞船
dự trữ	備隊
đèn lồng	镧
gấu nâu	罴
Ban giám khảo	评委
Zang	臧
Nhặt lên	佔
Beni	贝尼
Tưới	溉
Con điếm	娖
Liên hoan phim	影展
cộng đồng	社區
Mau	很快
kháng cáo	上诉
Bedo	貝多
Tong	昽
học hỏi	学
sự liên kết	协会
tiêu đề	封号
Chì	擔綱
Ming	茗
cỏ dại	蓫
ranh mãnh	詭
Sumatra	苏门答腊
Giật	後座力
Nhà thờ thiên chúa giáo	基督教會
Tây An	埥
Thời lượng	为期
Đúng rồi	其對
Kiểu chữ	字样
Nitrile	腈
thúc giục	趲
Đền thờ	該廟
Liên kết	締
Đại học Oxford	牛津大学
ủng hộ	撑
Hư hại	损毁
hệ thống	系
con bò cạp	蓶
Thư giãn	放寬
Đặt hàng	階
Shinkansen	新幹線
Ủy ban Chính trị và Pháp luật	政法委
Hoàng Gia	皇家
dây điện	電線
kẻ thù	敵軍
mua chuộc	贿赂
Quá cao	過高
hành vi xấu xa	副
gỗ	木材
Đài Loan quốc gia	國立臺灣
đảng cầm quyền	執政黨
Mag	玛格
Không có trên đảo	島上無
mười tỷ	冓
Trang web chính thức	官網
Trường học kinh doanh	商学院
Trên mạng	在網
tránh	避
Đặc khu	特区
Navia	纳维亚
Tháp đá	石塔
Giá bán	價約
đứa trẻ	孩
Mỗi trường	各校
Bower	包尔
Phượng Hoàng	釪
dây điện	丝
Nước Lào	寮國
Quân đội quốc gia	国民军
Jue	珃
Yêu cầu giúp đỡ	求援
vẫn	靜止
Ngã	陷落
Tù nhân	犯人
Matsuyama	松山
Li Hong	李鴻
Xu	襃
cơ sở	设施
mặc	戴
Shito	糸
Qiao	皡
Phân phát	散發
Thở dài	呿
đèn neon	氝
ngực	臆
con ngựa	马
Nhân tạo	人為
Đầu tiên	第
Luxi	鲁西
quay lại	回來
Dalai Lama	达赖喇嘛
Về cuộc họp	為會
hội họa và thư pháp	書畫
Môn Địa lý	地理学
Nam bán cầu	南半球
Gọi chung	統稱
Lên kế hoạch	预定
gọi	召喚
Doanh nhân giàu có	富商
Seuss	修斯
ăn năn	悛
Juren	举人
Laro	拉罗
trận chung kết	總決賽
Đóng cọc	垛
Chỉ huy quân đội	軍長
Serbia	塞爾維亞
Đội	該隊
Vui mừng	開心
Lập lịch trình	調度
Lịch sử	史称
Hơn	更为
Cung bao gôm	還包括
Phỏng vấn	採訪
Chôn	伯里
thời hoàng kim	黄金时代
Tainan	臺南
Với quân đội	随军
thang máy	掀
Bầu cử sơ bộ	初選
Muộn	遲遲
Diễn viên	影帝
côn trùng	蟜
Zhongjun	中軍
franc	法郎
chó sói	狼
Moi lên	开挖
Bộ phận và	部與
thư mục	书目
Tới Hồng Kong	來港
Sảnh đợi	游说
Weiss	維斯
Chương trình	方案
Xiang	翔
Vấn đề	當事
xà ngang cho ngựa nghêu ngao	軏
Trở lại	復為
Anh ta	踳
sự thay đổi	迻
nâu	褐
đá lửa	燧
sao chép	抄
Đo đạc	測
Mười nghìn	萬張
Đã chạy	冉
Ngọc bích	棢
Đang	正在
Geben	哥本
Qi	翴
Hiểu	解作
Simo	西莫
Hạm đội	机队
Được phân phối trong	分布於
Asuka	飛鳥
Chì	領先
Giáo dục đại học	高等教育
Thúc giục	加快
Reuters	路透社
Dawei	大為
Tài nguyên thiên nhiên	自然资源
Đầu ngựa	頭馬
liên kết	链接
thủy lợi	灌溉
Tầng lớp lao động	工人阶级
Tok	托克
Trần	祼
quyền phủ quyết	否决
Dịch	译作
Ming Pao	明報
Ảnh đặc biệt	特攝
Tát	蹜
tiền bạc	金錢
lịch sử	历史
kịch	剧
Truy tố	检察
sau đó	当时
Tê giác	犀
Jie	梉
phá vỡ	分解
Thẳng đứng	直升
Cấp trên	上級
tán thành	铆
lãnh đạo	首領
Hương vịSu	風味甦
đối diện	對稱性
Xây dựng	建構
thời tiết	天气
Mẫu	花纹
Đường	餳
gói hàng	包裹
Đột nhập	攻入
Cho điện	為電
Langya	琅琊
là chấp nhận được	還可以
Sống ở	居於
khuyến khích	推動
tinh linh	鬼神
Nông học	農學
Fuer	夫尔
Nữ anh hùng	女主角
khoảng cách	距离
đủ	足够
Tỉnh Aichi	愛知縣
Yan	瑒
Với Lee	與李
Nhọn	鎜
Jing	泾
Can đảm	果敢
Diễn dịch	詮
Quốc gia châu á	亞國
Zhuan	袛
hướng dẫn	感應
Vua của Chu	楚王
Nakamura	中村
Sau quân đội	軍後
phân biệt	区分
thanh lịch	优雅
Tài trợ	融資
Đa giác	多边形
văn phòng	办公室
Đối với phía bắc	為北
Guowei	國維
Hun	馛
Qi	侓
Cột đá	石柱
Qi	錡
bôi đen	黩
Tuấn	疃
Tham gia	收留
chảy	湝
làm	弄
sự thỏa mãn	滿意
Hành động leo núi	爬行動
KMT	國共
thứ chín	第九
Giải thưởng thành tựu	成就奖
Lựu đạn	榴弹
thời gian	颞
Xi	郕
Ngược lại	反比
Tây á	西亞
Wangling	王陵
xói mòn	侵蝕
Jiashi	佳氏
Pháp luật	法系
Đang chờ đợi	以待
triệu tập	召集
Quan sát	视察
Gây rắc rối	闹
Lâu đài cổ	古堡
Ung thư phổi	肺癌
Thanh toán	清盤
mệt mỏi	瘁
Lớp đào tạo	训练班
cười	嗤
Gặp	相遇
Quân Thanh	清軍
Edinburgh	爱丁堡
Hình cầu	球狀
Y	犭
sức mạnh đó	权力
địa hình	地形
Tổng cục	总局
Ziye	济耶
Bên là	側為
Yak	氂
Tình yêu	相思
chính xác	正确
Sau khi ra tù	獄後
mynah	鵒
lông vũ	羽毛
Sẽ	會以
Sân bóng chày	棒球場
Loach	鳅
Poop	舩
di động	移动
Khu tây	西段
Nian	莔
ấu trùng của muỗi	蜎
Trưởng	務長
tiếp tục	持续
xăm hình	黥
Đảng đối lập	在野黨
cảnh sát	警司
Răng nanh	膲
Hru	赫鲁
Hủy kích hoạt	停用
ngũ cốc	粒
Trung Hoa Dân Quốc	中华民国
Hoa Mộc Lan	木兰
Trong và ngoài	出入
Ôm	褅
phụ âm	辅音
Rời rạc	离散
Trung hạn	中旬
Trong thị trấn	鎮內
thang máy	升降機
Nhóm trong	團於
máy bay ném bom	轟炸機
không rõ ràng	惚
Giám đốc	編導
hơn	甯
Như	作為
xi măng	水泥
Độc nhất	獨一無
cái kén	茧
Góa phụ	孀
Benji	本紀
Yulin	榆林
Lagrange	拉格朗日
Nói	口语
Ngành thủy sản	漁業
Rực rỡ	绚
giải phóng	釋
rắc rối	麻煩
Suy nhược	挷
Erz	尔茨
Gujarat	古吉拉特邦
California	加州
Ngày xưa	昔日
Ban phước	祈福
Faraday	法拉第
Beichuan	北川
Gou	茍
mua chuộc	賕
vui vẻ	乐
cơ khí	机械
làm suy yếu	削弱
Môn số học	算術
Cho vợ	為妻
Shek Pik	石壁
Plutonium	隒
cảm hứng	灵感
máy tìm kiếm	搜索引擎
Mờ nhạt	洣
đóng	閉
để làm cho	成
Giả thuyết	假設
Đa dạng	各项
Tăng cường	助推器
Nghiện	沉迷
Loiret	卢瓦雷
Sheren	舍人
Căn cứ	底座
trưởng thành	到期
Đang ở	是於
oxy hóa	氧化
Cm	公分
Sự thanh bình	安乐
què	瘸
Biến đổi	变换
Chữa lành	癒
Ướt	潮濕
chắc chắn xảy ra	必然
Hoa hồng	蔷
Thiên nhiên	性质
Và bên trong	與內
dữ liệu	數據
xúc tác	催化
Vẽ tranh	抷
Bắc Đại Tây Dương	北大西洋
Goku	悟空
chó sói	沃尔夫
Làm giàu	充實
Đường Chatham	漆咸道
Đên trươc tiên	先到
Yu	妌
Tình nguyện viên	志愿
Seth	塞斯
Nghỉ ngơi	休整
Hoàng đế Khang Hy	康熙帝
âm dương	阴阳
đi xe đạp	週期
Thời gian và	時並
thành lập	确立
cuộc khủng hoảng	危機
Sau đó	屆時
Ptolemy	托勒密
Được	上獲
Trình diễn	示威
đặt xuống	平定
Hai mươi tám năm	二十八年
Hàng ngàn	上千
hiện trạng	現狀
Cưới nhau	出嫁
mẫu vật	標本
ngày cuối tuần	周末
Dòng xe	線車
Hoàng đế Xuân	宣帝
bởi vì	因爲
Gái điếm	娫
từ điển	詞典
Hai mươi tám đêm	二十八宿
bằng văn bản	書面
quyền lực	功率
Không thể tiếp cận	不入
Jian	臕
Quân đội Anh	英军
Đê	墩
Bức tượng	造像
Qiaotou	橋頭
Vành	圏
Nhân Viên	职员
làm cứng	硬化
khác	其人
Các bộ phận	零部件
pha trộn	糝
Nhẹ nhàng	些微
Bột gạo	米粉
Cao	為高
xăng	汽油
con hàu	蚝
Rido	里多
Độc thân	張單曲
Beacon	烽
ôi thiu	餿
cổ xưa	古老
Hội đồng chính phủ	政院
Cauchy	柯西
Ohio	俄亥俄州
crom	鉻
Bài báo	條第
Độ C	摄氏
Trên tường	墙上
Cửa khẩu phía Bắc	北门
Nhật ký	日記
dòng chữ	题词
Ngựa thánh	聖馬
Nhân viên văn phòng	干事
Trang thiết bị	器材
không chú ý	跅
Bắt đầu với	始於
đường phía Bắc	北街
Yan	兗
Ye	曩
câm	哑
Ga tàu	驿
Avi	阿维
Arthur	亞瑟
ít hơn	少
Khuếch tán	漫
thỉnh thoảng	偶尔
Hojo	北條氏
Thông thoáng	晰
Sai	為非
Chiến dịch	竞选
Ba Nguyên tắc Nhân dân	三民主義
trứng	鸡蛋
Bài viết	篇
闬	閈
Bộ trưởng Bộ Ngoại giao	政部长
nai	麈
Tên	為名
Biên niên sử	纪年
chim	肫
Âm	鞄
Taizong	太宗
Sumatra	蘇門答臘
Chuyển đổi	转换
con sông	河
tiểu sử	傳記
phân	糞
ngưng	辍
phản ứng	反應
dân thường	平民
Đánh vần	拼写
Liệt kê	上市
Nhà nghỉ	宿
Thời gian kinh doanh	務時
Thành phố trường sa	长沙市
người máy	機器人
Đau lòng	饣
con số	數
hư hại	損害
Yun	蘊
Mặc	佩戴
đào mương	沟
tàu	船只
Trước đây	福爾摩
Oscar	奧斯卡
Sự bành trướng	擴建
Holmes	霍姆斯
Đau khổ	遭人
Chúa tể của chiếc nhẫn	魔戒
Trên	上在
ngoan cường	頑強
kháng cự	抗拒
Vương quốc Anh	英國
Âm	枓
nhận thức	意識
Bỏ sót	省略
con bò cạp	貐
Tuck	踕
ngôi đền	寺庙
Kun	鯤
Yong	鑱
Nhóm con	子群
Nhà sư	高僧
Tiếng kêu bíp	嘀
Yêu và quý	愛
vỏ ngọc	瑔
Gì	啥
Học hỏi	學習
Liên tiếp	先后
Han	瀚
Bài thơ	诗集
Pan	殫
Tại chỗ	就地
Cả hai kết thúc	兩端
Ling	槤
Shabu	趮
Trong	喺
Nhúng	嵌入
ôm	偎
Dọn phòng	内务
Người giúp việc	妢
hoàn thành	履行
Tám nghìn	八千
Barna	巴拿
Nhận định	定论
Đem đến cho	帶給
Kiềm chế	歛
ngôi sao	星星
năm mươi	五十
sự thiếu	短缺
Xie	勰
Ướt	潮湿
chuyển khoản	轉會
gián điệp	特务
Zemin	澤民
cắt thịt thành từng miếng	胾
một lát sau	後來
Sẽ làm theo	會隨
thông tin	信息
Sẽ hướng dẫn	會導
hoạt động	動作
Dốc	陡峭
Khóa	鎖
Tại thời điểm này	這時
Mi	宼
Thống đốc	省長
Trong cuộc họp	會內
CITIC	中信
Hoa	绽
Người giám sát	主管
Thuộc về	隸屬於
Zimin	自民
Vắt kiệt	掹
Hoa loa kèn	莉莉
Wo	禾
Đoàn ca múa nhạc	歌舞团
Slovic	斯洛維
Di dời	遷居
Sạc điện	充
mục lục	索引
Wagner	瓦格纳
đầu đạn	彈頭
rộng	闊
sự chỉ trích	批評
Chân giả	蕯
Kẻ hủy diệt	終結者
ớt	辣椒
tin đồn	謠言
Yoshiwa	义和
Giải thưởng hòa bình	和平奖
Quan sát	觀測
Cá tuyết	鳕
Nhóm lớn	大群
Kun	鹍
Miền	畴
đóng	紧密
Tần	骎
xác minh	验证
đâm	茦
Kinh thánh	经文
Trang Chủ	居家
Chia sẻ	共有
Giảm nhẹ	减轻
vĩ độ	緯度
Rồng đen	黑龙
Xây dựng	建設
Bác sĩ	郎中
Xu	僊
Eddie	艾迪
rẻ	贱
Thay mới	續約
Hou	侯
Mong	冀
Anh hùng	功臣
nhanh	迅速
Thời gian chính trị	政時
điều khiển	节制
nhà cung cấp	鬻
Ngớ ngẩn	詼
Deng	嶝
Quyền công dân	民权
Hậu duệ	子孙
sản xuất	產生
Công bố	刊出
cuộc hẹn	任命
món ăn	食
Mot loai	一個種
Mùa hè	大夏
Đại học Quốc gia Đài Loan	國立臺灣大學
gợn sóng	渼
Bay	鯼
erg	尔格
Quyết định	决
Người hâm mộ	粉絲
Neihua	內華
Phun	噃
lô hàng	批次
thứ bảy	第七
Ma	魉
mời gọi	邀请
Jin	晋
Đông cứng	凍結
không ai	都沒
nhẫn	环
đủ	足夠
trạm xe buýt	汽车站
khen ngợi	表揚
Shan	鄯
Phình to	胀
sự nhiễm trùng	感染
Liên quan	牽連
Tiếp tục	续
Trong	物中
Deji	德基
hệ thống	繫
Nươc Nha	本國
Yan	瀊
sức mạnh	勁
Kể từ Tây	自西
zirconium	锆
Zhu	栟
Bohemia	波希米亚
Trung địa	中土大陸
cái khiên	盾
Krakow	克拉科夫
Li	俐
Sau khi bị	后被
Zhu	斴
Cung nam	同年
cấp độ	水準
Khoang xe	車室
răng	齒
bí ẩn	神秘
Dongfeng	東風
Đá	摇滚
Seabream	鯛科
Gốc cây	鲌
Học viện	書院
Nhà ga trung tâm	中心站
Oda Nobunaga	織田信長
Nhà phát triển	开发商
caliph	哈里發
già chuyện	噥
Nu	努
Tăng đoàn	僧伽
Ling	媐
nhịp	跨度
Tinh vi	馔
Súng phòng không	高射炮
cổ áo	領
Máy bay chiến đấu	戰機
Gây bệnh	致病
liền kề	毗
Bị giết trong hành động	阵亡
cao	高昂
Màu lông	毛色
vợ / chồng	配偶
Mười nghìn	萬個
Thiên nhiên	生性
lột vỏ	剝
Einstein	爱因斯坦
Hoàng	璜
Niên đại	年表
Triều đại Tây Tấn	西晋
ma thuật	魔幻
Cứu trợ thiên tai	救灾
Anna	安纳
Tình cờ gặp	踄
Xijing	西京
Gua	卦
Tượng vàng	金像
giám đốc	導演
đất ruộng	农田
Yến tiệc	絭
Tổng chiều dài	总长
Mexi	墨西
Anshi	安市
Lập kế hoạch	企劃
Trường học kinh doanh	商學院
Dần dần	漸發
Bản ghi trực quan	視紀錄
Li	濆
Silicon	矽
Kể từ đó	從此
cái lọ	罍
Công nghệ	技術
Hoa Quốc Phong	华国锋
Bộ phận dịch vụ	務署
Zhang Zuolin	張作霖
tìm	覓
Gạch tráng men	琉璃瓦
Vòng	环路
Người đi bộ	人行
Hayakawa	早川
tuyệt vọng	怅
Giá cả	费用
Kwong	鄺
lãng mạn	浪漫
Một lát sau	稍后
erbium	铒
bên ngoài	外部
An Huy	安徽
Kawas	川氏
Lịch sử	历代
tưa miệng	鶇
Bóng tối	晅
Hờn dỗi	澁
hình minh họa	插图
Yao	尧
Các ngôi sao	的恆星
nghiên cứu	考证
Bộ ba	三合會
Trang bị lại	改装
lũ lụt	洚
Gợi lại	罢免
Sau đó	此後
Âm	鑮
Costa Rica	哥斯达黎加
lớn lên	成长
Hình bát giác	八角形
Đồi mồi	糎
Du kích	游击队
El	埃爾
Đạo đức	士气
Sai lầm	失誤
ngay bây giờ	现在
Hội chợ	博覽會
Điện thoại di động	手機
thành trì	据点
cố gắng	功夫
Vỉa hè	路面
Làm sao	豈
Wow	哇
Sống ở	居住於
Tỷ lệ từ	字率
Gốc	原产
danh tiếng	名望
Zi	梓
Thung lũng	穀
Một loạt các	一连串
Sống cùng nhau	聚居
Nhà thư pháp	书法家
Taisho	大正
Trên đường	路上
Lượng tử hóa	量子化
cà vạt	绑
Ẩn trong	藏於
Cúp châu Á	亞洲盃
dưới không	零下
Veneto	威尼托
Ôn tập	审核
Bộ gen	基因組
Tham gia	加盟
kéo	拉力
Công dân Trung Hoa Dân Quốc	中華民國國民
Từ chối	式微
Ngày mai	明日
Tăng ca	加時
Những trạng thái	各州
Viện khảo thí	考試院
Moore	穆尔
Ngày thứ sáu	初六
Tất	襪
Tiệc	馦
Người Mỹ	美方
theo chiều dọc	竪
xuyên quốc gia	跨國
Hiệu quả	效力
áo choàng ngoài	上衣
Wei	洉
tiếng ồn	喧
Đào tạo	培訓
Gu	顧
chim cun cút	鷷
Nỗi khó khăn	難者
Bữa tiệc	该党
Đất khai hoang	畇
Sự kết hợp	共轭
nhà điêu khắc	雕塑家
Suy đoán	推測
Sắc lệnh	敕令
bãi đậu xe	停车
Khối	阻挡
tất nhiên	当然
Danba	丹巴
Trong thành phố	城中
hiệu ứng	作用
Trục	轅
Chướng khí	沴
Taylor	泰勒
Chúng ta vẫn	們還
Vậy nên	以致
Con rể	忩
Xu	煦
câu đố	狴
Viên kế toán	會計師
Palermo	巴勒莫
Lịch sử trường học	校史
sán	吸虫
khách hàng	客户
Trưởng phái viên	布政使
Oracle	甲骨文
Thực tập sinh	學員
suy nghĩ	認為
Thắng lợi	奪得
gói hàng	包裝
Hồi	穆斯林
Các tuyến đường	條路線
sự sinh sôi nảy nở	增殖
Nghèo	遜
nó	牠
Quận ủy	县委
Gây ung thư	致癌
tình trạng	條件
Zhu	璚
nói chuyện	談論
nhóm	团体
Trẻ	雛
Biệt thự	別墅
không đáy	窔
Bồn nước	水箱
giỏ tre tròn	筥
cháu trai	孫子
nói chuyện	议论
tàn sát	大屠杀
danh từ: Tọa độ	坐標
Bằng thuyền	乘船
Không giúp được	不住
Projective	射影
Quốc giáo	國教
Đảng Whig	辉格党
hung ác	殘酷
Nuremberg	纽伦堡
Theravada	上座部
mắt cá	踝
Dominica	多米尼加
cây ngang	楣
ampe	安培
Tổng thư ký	秘书长
Thang máy giữa	中举
sắc đẹp, vẻ đẹp	美感
Chan	嬋
hộ chiếu	护照
ngăn kéo	褌
Nhạc cụ	乐器
Dẫn điện	導電
Maria	玛利亚
Gần nhất	最接近
quyền lực	幂
Mơn trớn	抚
Quách Tĩnh	郭靖
người ăn xin	乞丐
Shan	鞾
ướt	溼
Mongoose	獴
Hạt	努特
Bùng binh	旋處
Hum	嗀
Tật nguyền	残疾人
từng cái một	逐一
Thay đổi	而異
Bìu	簘
Krone	克羅尼
Giành được	獲得了
Kinh doanh như	商為
Nagamasa	長政
Cắt	伐
Bỏ trốn	逃脫
Kyrgyzstan	吉尔吉斯斯坦
Roy	鲁瓦
Yan	閆
Bình luận viên	论者
Madou	麻豆
Thẩm định, lượng định, đánh giá	考核
De Zong	德宗
Kịch	劇為
Bạn Xi	游錫
Kèn Trumpet	號風
Fabi	法比
Viện trợ chống Mỹ	抗美援
Nhưng không	卻沒
độ ẩm	濕度
Mất đi	佚
Miri	美里
Pao	榀
Ba phần ba	分之三
Đo đạc	测
Tái sinh	重生
cao chót vót	耸
chim	禽
Trường bình thường	师范学校
dẫn theo	掔
Hitt	希特
Tốc độ	佩斯
Patten	彭定
Swaddle	襷
sản xuất	生產
điều cấm kỵ	諱
nắp hình nón	幘
Trang bị	武裝
Lễ	礼
quốc phòng	国防
Đường dây chuyên dụng	专线
Teresa Teng	鄧麗君
phần lớn	大多
Quái vật	怪獸
Hồ bơi	池
một nơi	一處
Không bao giờ	時曾
Itai	伊泰
bier	柩
tập thể dục	行使
Lân lượt tưng ngươi một	相继
Che đậy	掩
Kuomintang	國民黨
triều đại	朝代
Thả khung	落架
tòa thị chính	市政厅
Đôi pho vơi	交道
hiểu biết	認識
Tuyên thệ	宣誓
Manila	馬尼拉
em gái	妹
Đệ tam	三元
Ene	烯
Changhua	彰化
hiệu ứng	効
chìa khóa, thìa	匙
Phát biểu	演講
Đẹp	謩
Châu Á	细亚
Thép cây	鋼筋
tâm lý học	心理學
Qian	芇
Xấu hổ	旈
Xin	鑫
Buồn bã	起事
quá	超過
Hồng	闳
Bắc	诺斯
huy chương	勋章
thành viên	團員
thịt	肉
Dây buộc	洛佩
Con đường thương mại	商业街
Soma	索馬
Máy khoan	鑽
Jia	郏
bốn mùa	四季
jin	斤
Nhựa	樹脂
Quanh co	蜿
Phía sau	身後
đến	至
Vaud	沃州
bình	甕
y tá	护士
Kho bạc	国库
tập trung vào	专著
Sự cứu rỗi	救亡
Họ và tên	全称
Zou	鄒
Bắn	槍決
cha mẹ	父母
vu khống	讪
phim Nhật Bản	日本電影
sự hiểu biết	掌握
Thân cây	干支
Sẽ	者會
Del	德尔
Vô cơ	无机
Ravioli Trung Quốc	餛
sân vận động	体育馆
độ đục	濁
Phúc lợi công cộng	公益
Cô ấy và	她與
Đã kết nối	连通
Đánh giá âm nhạc	樂評
Musha	武者
Phượng Hoàng	凤
Giảm giá	塞尔
Người Duy Ngô Nhĩ	维吾
Mỗi nhóm	每組
Gầm	咆
Nội chiến	國共內戰
Sự bành trướng	扩编
Một phần nhỏ	一小部分
Tất cả đang chờ đợi	統候
liên đoàn	盟
nhưng	郤
Thanh niên được giáo dục	知青
Cung cấp nước	供水
Morbihan	莫尔比昂
Tiếng Mông Cổ	蒙
Cung điện mùa hè cũ	圆明园
Mơn trớn	撫
Zhongqing	忠清
miễn nhiễm	免疫
núi lửa	火山
bằng cách ấy	從而
người dân	公民
Ying	瀅
Quốc gia	個國
Đang chờ đợi	有待
Nhịp	节奏
Pyrenees	比利牛斯
Chu	迺
Thành viên hội đồng	務委員
Meuse	默兹
lừa dối	誆
Lưới	格格
chôn	埋葬
Jinhe	金和
Đầy đủ lực lượng	全力
sự hiểu lầm	誤解
Thừa nhận	考入
Ceylon	錫蘭
Chạy trốn	逃犯
Nơi trú ẩn khỏi gió	避風
sự phản đối	異議
Vịt xanh	鸭绿
Giá là	價為
Kam Tin	錦田
mâu thuẫn	矛盾
Thành phố An Sơn	鞍山市
Sững sờ	愽
Thời lượng	為期
Những người tị nạn	流民
Không chỉ	不但
Nhát	腆
cánh đồng	场
Viết	寫著
phía sau	落后
Định tính	定性
Lington	灵顿
cuộc hẹn	約會
Các vấn đề dân sự	民政
thị trấn	鎮區
Đã cố gắng	未遂
Columbia	哥大
vườn	花园
thuyết phục	说服
Archimedes	阿基米德
phòng thủ	扞
cove	隩
Kế hoạch	普兰
Một đôi	一對
đại sứ quán	大使馆
máy trục	鶴
Tụ họp	聚
đây	此地
Tuần tới	壹週刊
Thời gian	時分
Mùa này	該季
Sáng	煌
Ga Hung Hom	紅磡站
Con gái thứ hai	次女
thử thách	挑戰
Cà vạt	餢
vỏ sò	外殼
Trong mắt	目中
Thành phố Hồ Chí Minh	胡志明市
nhưng	不过
Tàn phá	孮
Tham ăn	馸
Ram	拉姆
Áo mới	新泽西州
Khám phá	探究
thay đổi	换
Vượt qua	過數
trả	付
Cái này	这个
Ying	荥
Yo	呦
Tốc độ	踱
sự tương tác	相互作用
Ngã	落馬
Rolla	罗拉
Allier	阿列省
Guofa	國發
Yi	瑊
khác nhau	不同
Đau khổ	壌
Dài	迢
Rất lớn	甚大
Bộ quốc phòng	国防部
dựa trên	基於
Trên sân khấu	台上
trong khoảng	大約
Bức vẽ	畫作
Niên giám	年鉴
Không phải của nhau	互不
phản chiếu	映
nghề nghiệp	生涯
Tuổi tác	歳
mười lăm năm	十五年
sau đó	然后
xôn xao	汹
phong cách phương Tây	西式
Trung sĩ	中士
Ngoài mọi người	出人
hỗ trợ	援助
Điểm chuẩn	基准
Conscript	征召
Đá quý	寶鑽
vi khuẩn	细菌
Han	與漢
pha trộn	混合
lớp học	教室
bươm bướm	蝶
Chức sắc	政要
Di chuyển	招式
Giao banh	侍奉
xấu hổ	耻
Sở hữu	自居
cảm thấy	觉
Cam kết	犯
Wei	尉
Ở lại	斯泰
Do dự	猶豫
Syrah	西拉
Góa phụ	嫠
Chung	將軍
chiến tranh lạnh	冷戰
Kể từ thời thơ ấu	自幼
Phun	嗙
lụa	帛
Xẻng	锨
Yi	浿
Răng nanh	枋
nghi ngờ	儗
miễn cưỡng	勉強
Định kỳ	期刊
một cách tạm thời	暂时
Kinh nghiệm	體會
Người viết lời	詞人
Lựa chọn	遴
Haas	哈斯
Leo	匍匐
Yên tĩnh	幽
cố vấn	参事
Yi	従
thuế quan	关税
tăng	增
Phá bỏ	脱离
Mở cửa	開門
tàn bạo	殘暴
palladium	鈀
Mỏ đá	鲗
Thêm	加之
động kinh	痫
Người dân thành phố	城人
Xã nhân dân	人民公社
sự chuyên chế	暴政
Polis	波利斯
biển Caribbean	加勒比海
mài ngọc	碾
báo cáo	報告
Tiêu cực	负面
quan tâm	利息
Âm	翨
Canada	加拿大
con trai cả	長子
Yan	鷰
dịch vụ	服務
trắng	皤
Dũng cảm	大胆
Tường thuật	叙事
Âm	覞
Nâng cao	增強
Dương tử	長江
Mảnh khảnh	细长
Ủy quyền	授权
Wei	涠
mây	藤
giải pháp	解法
thực tế	现实
Tự túc	自足
Xương bánh chè	髌
đen	黑色
áp phích	海报
canxi	钙
Ủy quyền	委派
đổi	换取
Thẩm quyền	管理局
Novgorod	诺夫哥罗德
Mụn rộp	疱
Ghế	席
Phòng triễn lãm	覽館
Bắt chước	彷
Tám hoặc chín	八九
Li	鞬
Đến	而來
Inn River	因河
Làm rõ	阐明
nghe	聽
Nghe	聽見
Anh bạn	布罗
bắn	斃
Bất khả chiến bại	無敵
um tùm	萋
Mỏ neo	主播
vịnh	海灣
Toàn bộ	一共
Quýt	橘
Sự bành trướng	扩建
Adenosine	腺素
Changshi	昌市
Ben	賁
Hợp đồng	契
Shao	掭
Zhuo	嬀
Fluke	僥
mưa đá	霰
Không vui	不快
Phạm vi ảnh hưởng	勢力範圍
Quốc kỳ	國旗
Malaysia	马来西亚
ngựa đực	骘
Tù có thời hạn	有期徒刑
vật lý	物理学
Nakajima	中島
gecmani	鈒
cố vấn quân sự	軍師
đường cong	曲線
Không đủ khả năng	不起
chuyến du lịch	遊
Ứng tuyển	适用于
đường hầm	隧道
chuyển khoản	转会
một nửa	半數
Cột	柱式
khắc	镂
Castanopsis	櫧
Axit nitric	硝酸
Album	專輯
Ukraine	烏克蘭
Hợp nhất	鞏固
Sele	塞莱
Tổ chức lại	改組
Kinsen	金森
thích hợp	一貫
Weinan	渭南
Bữa tiệc mới	新黨
nếm thử	嚐
Nguồn cung cấp	用品
tiếng Nga	俄语
Với	設有
Phòng chờ	候车室
Thợ nề	梅森
hung ác	虣
Chuyến bay đầu tiên	首飛
danh từ: Tọa độ	坐标
phòng tắm	浴室
Tour Miền Nam	南巡
Sony	索尼
Tashan	塔山
đồng âm	諧音
Không sợ hãi	無畏
phần còn lại	其餘
Mười của	十年代
Tổ chức	制宪
phòng bếp	廚
Qiang	羌族
Vận chuyển hàng hóa	货运
rộng lớn	广阔
súng lục	铳
ý định	意圖
Đáng tin cậy	守信
Co lại	缩
người phụ nữ xinh đẹp	佳人
Tha	藉口
Đường bờ biển	海岸線
axit	痠
họ đang	們是
Nhu la	如
Fiji	斐
Theo rõ ràng	據顯
viviparous	胎生
tiêu	椒
Nơi đo	该地
Klin	克林
Trung tâm mua sắm	商城
A	一條
đội tuyển quốc gia	国队
huy động	動員
Đầy đủ	佈滿
Hướng tới	向于
Lưỡng cư	两栖
thay thế	替換
ăn mừng	庆祝
Bang Bohai	渤海国
chiếm lấy	攻下
sốc	驚
hóa lỏng	液化
Quay	鏇
Guis	吉斯
Động cơ điện	电动机
y học Trung Quốc	中医药
đô thị	宗主
Nhãn	廠牌
Sensilla	感器
Tuần tra	巡视
Porsche	保時捷
Sau nhóm	組後
mạch tích hợp	集成电路
chổi	帚
Dòng sông màu vàng	黄河
ga tàu	驻地
Trận đấu	對賽
Vương quốc	王國
Nhóm tiệc	黨團
Doha	多哈
selen	硒
manh mối	線索
đĩa	柈
Lượt xem	览
Gọi nó đi	稱之為
Satsuma	薩摩藩
Tangzhen	塘镇
Ge	葛
Luôn luôn	一直
Siberia	西伯利亚
Thời gian nhẹ	輕時
Nước mắt	撕裂
liệt sĩ	烈士
cho ăn	飼
Tất cả các hướng	各向
tạo thành một cái tủ	組閣
Lật úp	朝天
lật đổ	颠覆
Nhà thiết kế	设计者
khác	他人
Tây Ngụy	西魏
Chạy trốn	逃往
hơi nước	蒸氣
Đội thắng	隊奪
Lá bắc	苞片
Dai	傣
Qiqi	七七
máy bay	客机
hung dữ	悍
khu bảo tồn	保护区
Thủy quân lục chiến	陆战队
tiền gửi	存款
sốc	震
Cardiff	卡迪夫
Serranidae	鮨科
Xuân	煊
Trên bề mặt	表面上
Khởi hành	发车
Sheng	晟
theo	遵循
hoạt động	作業
riêng tư	私
Bài báo	条
MẶT NẠ	西
Tiếp xúc	連絡
Jintao	锦涛
Số thực	實數
Joseph	约瑟
Đoàn kết	統一
hướng dẫn	导
Đánh giá	評估
Gustav	古斯塔夫
chuyên gia tư vấn	顾问
Xin	忻
Với Chen	與陳
nhân từ	慈悲
Tàu du lịch	邮轮
hùng hoàng	錸
Công cộng	公有
sáng kiến	倡議
Thames	泰晤士
nửa đêm	午夜
Dongan	东安
quan liêu	官僚
Damp	阴湿
Truman	杜鲁门
poker	撲克
Lanh	麻科
Những người tốt	好者
Hư hại	損毀
Pan American	泛美
Mili	米利
Mô-đun	模組
La	啦
Oshima	大岛
Văn phòng	事處
đá quý	寶石
Con đẻ	后代
Khu vực danh lam thắng cảnh	风景区
Tuần tới	后周
Quốc tịch Yi	彝族
Sa mạc	沙漠
Thời kỳ cao điểm	高峰期
Bằng thạc sĩ	碩士學
Cùng bộ phận	同科
sắp xếp	捃
Chim ưng	鷂
Thô	粗糙
Bermuda	百慕
Cảm thấy tốt hơn	好轉
song song, tương đông	駢
Huy hiệu trường	校徽
Masaji	政司
Âm	奣
Mười nghìn	萬名
Yong	镛
Kết nối	接駁
và	及
Tiếp tục	續
khuôn mặt	面孔
Ai	瑷
cầu	桥
cối xay	礱
Wa	瓦河
Cái đầu	人首
lãnh đạo của một quốc gia	國家元首
dấu vết	蹤跡
Sau đó	則將
nghiêm khắc	严
Taihe	太和
thờ cúng	拜
có	擁有
đắt	昂貴
Xung quanh	身边
hạ nghị viện	下议院
Đồng thuận năm 1992	九二共識
chưa	還沒
Meiling	美齡
Tiếng Thụy Điển	瑞典语
hydroxyl	羟
quái vật	妖怪
Noe	锘
chặt chẽ	紧
hoạt động	行动
tòa án	庭
Cuộc đua	人种
Yu	踙
Thorium	鍒
Mực ống	魷
An	安
Đàn bà	女方
Yi	俋
Wilson	威尔逊
Phát triển công cộng	公開發
Shan	鱯
lễ hội âm nhạc	音樂節
thay đổi	換
Wu	武
nghiêm trọng	嚴重
Trường y tế	医学院
Trang trí	裝修
Trả lại	還給
khát	渴
Bắc cực	北极
Cuộc sống	起居
Seju	世居
vấn đề	發出
Bà	太太
Xe ghế	座车
thâm nhập	渗透
nâng lên	撬
FA	足總
Lăn qua	辗
âm dương	陰
vật trang trí	锒
giải cứu	搶救
Phối hợp	合
Nhà dân gian	民居
Phát xít	纳粹
bass	鲈
mặc dù điều này	尽管如此
Bowling	保齡
sự chỉ rõ	规范
thương	鎩
Của không	的無
Hát	墎
trang	页面
Lyon	里昂
Nhóm dân tộc	族群
Các thành viên	員会
Jian	蹇
Bing	邴
Cho phải	為對
đài quan sát	天文台
Con dốc	匝道
Chủ tọa	主委
Yu	奜
Rockefeller	洛克菲
Ab	阿卜
Cũng được thiết lập	亦設
Giám sát	班长
Nhiều nơi	多處
chữa lành	瘳
Băng nhóm	岡
Hiệu sách	书局
sợi chỉ	缕
bình yên	寧靜
được đặt tên	命名為
cộng sự	夥伴
Tâm thất	心室
Uy tín	盛名
quay số	拨
Tan	賩
Đoàn kết	统一
Qingling	庆龄
Xây dựng	樓宇
Jiao	涽
lòng yêu nước	爱国主义
Trưng bày	展出來
Mười tám	十八
Den Bosch	登堡
MRT	捷運
Mùa này	本季
Literati	文人
bông mịn	纩
Gửi đi	遞交
Ít hơn	不及
Chuyến thăm	参观
vòng cung	弧
Trường phái ấn tượng	印象派
Đột kích	突襲
nhiệm vụ	责任
Đại học Thanh Hoa	清华大学
Tưởng tượng	设想
tha lỗi	諒
sản xuất tại	产于
Rory	羅里
Thị trấn cầu	桥镇
Ju	琚
Miyagi	宫城
phát triển kinh tế	經濟發展
Rất nhiều	大量
Đại học Úc	澳大
Người dân địa phương	地人
Khoa học viễn tưởng	科幻小說
Quan hệ họ hàng	親緣
danh hiệu di cảo	谥
Trích dẫn	引述
Thứ mười chín	十九日
Đồng ý	篤
Đào	挖掘
Mỗi năm	年年
Các loại	類型
Số Pi	埤
cho thuê	租約
bảy mươi	七十
Kei	箕
Chăm	湛
Richtodd	里士多德
lực lượng	強行
Quyền hạn	轄區
Choáng	愼
phòng	房
lâm nghiệp	林业
Cộng sản	共產
Hằng số	該恆
Biên độ	幅度
Lian	琏
Hàng châu	杭州
ẩn giấu	躲
Liên đoàn thanh niên	团委
Thẩm phán	判
Băng nhóm	謢
Nghiền ngẫm	芻
Thông thoáng	澄
Gạo nếp	饸
Người phụ nữ cao tuổi	妪
Anh hùng	群雄
thơ	詩
hộ tống	護航
bài báo	物品
Hạng Vũ	项羽
bầu không khí nặng nề	氳
đục đẽo	劂
Cấm	禁止
Mặt đất nặng	重地
Phần giáo dục	教育科
Tình nhân	恋者
Chongxi	崇禧
Tây Ninh	西宁
Pipit	鷚
Giải thưởng Người	人獎
Đây	这里
đỉnh cao	岧
đỏ	红色
Được thiết kế cho	專為
che	盖
Hui	迕
bươc	步驟
Không	沒
nhà nghiên cứu	研究员
cây	楰
mỏ neo	锚
biển Đỏ	紅海
Kể từ thời thơ ấu	自小
lò lửa	爐
Yi	樿
trợ cấp	補貼
Đại học Bách khoa	理工大學
khuyến khích	鼓励
ở gần	近
Xi	奚
Con rắn	蛇座
bài hát	歌曲
từ thiện	慈善
Đấu thầu	標賽
Huyện	尔区
thối rữa	朽
thực tế	实
Triển khai thực hiện	实施
Mo	謨
xấu hổ	窘
Zhiqiang	志強
Alice	愛麗
Ulu	乌鲁
Tiểu Vương quốc	酋长国
Sự chuẩn bị	筹备
Ethanol	乙醇
trả lễ	致敬
sau đây	下列
Điều đáng tiếc	悕
Đồn cảnh sát	警察局
Trận chiến	戰賽
Xin vui lòng tham khảo	請參
theo đuổi	奉行
Perylene	苝
Bảo vệ	衛冕
cũng thế	又
dính	黏
Pha lê	晶体
Antioch	安條克
Hạn ngạch	名額
He Shen	和珅
Miễn phí từ	免于
Thừa nhận	考上
Sẽ được phát hành	會發
bối cảnh	景象
có hiệu lực	现行
Aegean	爱琴
Đều đặn	正则
Harvard	哈佛
Lan xe buyt	巴士線
Một số	某個
Vua hoàng đế	景帝
Ở trên	上述
Jie	杰
Pseudo	偽
Qi	炁
khúc dạo đầu	序幕
Quảng đông	廣東
Li	郦
nặng	惨重
bệnh tật	癃
coban	鈷
quan hệ tình dục bằng miệng	口交
sự phân chia	師團
Chi	邆
Thế giới	天下
vi mô	微
mê sảng	谵
Khoa	教職
Đã qua đời	過世
lặn	潜水
Nó	伊特
nhà ở	屋
Lắng đọng	沉積
Tổ chức đảng	党组织
Kiểu chữ	字樣
Đào	棪
Pheno	吩
Thử	試著
Đổ bộ	着陆
Giống nhau	形似
Di truyền	遗传
Proton	质子
cái nêm	楔
Quốc tế	国际
Nói dối	卧
Li	雳
Sức cản	电阻
in vivo	體內
công khai	公然
Thị trưởng	區長
mendelevium	鍆
Technetium	锝
Biệt thự	墅
Được mời	受邀
đứng trên	站上
Acridine	吖
phòng bên	眃
Được xuất bản trên	發表於
Xem xét	審
Chôn cất	埋
Liao	遼
cá mập	鯊魚
trò chơi	比赛
người phụ trách	馆长
Đồng hành	伴隨
Hát	吇
Nước Tần	秦国
Mảnh này	这块
Kuan	夼
Ling	竓
ý kiến	意见
tính khả thi	可行性
Thị trường	市道
toàn cầu	環球
Được xây dựng trong	内设
đóng gói	收拾
Quản thúc tại gia	软禁
Đồ cổ	仿古
Phương sách	胜地
ánh sáng mặt trời	陽光
Bất hợp pháp	違法
Tru	特魯
bạc	白銀
nhào bột	韍
Vụ nổ	衝轟
Chuỗi	字串
Trẻ em	小朋友
ngân hà	星系
Kiel	基爾
ngâm nước muối	醓
ổn định	厩
Đèo Nam	南傳
Bị thương	受伤
Cơ quan đặc biệt	专署
con át chủ bài	王牌
sô cô la	巧克力
Giải thưởng Chuông vàng	金鐘獎
Mặc du	雖然
tối	晦
cuộc đua	种族
Ngừng xuất bản	停刊
bực mình	生氣
tiên phong	先锋
Thành lập tại	設立於
Mang lên	培养
chốc lát	瞬间
nhập cảnh	條目
giấy phép	許可
cá nhân	个人
Tính là	計為
quân đội	军队
Tụ họp	集结
Ngôi sao neutron	中子星
như một trung tâm	為中心
suy luận	推斷
Nền kinh tế thị trường	市场经济
cáo	狐
Texas	德克萨斯州
tuổi trung niên	中世纪
Hàng đầu	顶级
Ra trận	开战
quả anh đào	樱桃
Bên nước ngoài	外方
con dơi	蝙
đổ	倾
Số lượng	數達
Còn lại	剩余
Trong nhà tù	獄中
ngoại quốc	外来
thay đổi	改
Guohua	國華
sử dụng	用法
Các quốc gia phát triển	发展中国家
luyện kim	冶金
Thái giám	太监
Tôi sẽ	滋病
chủ nghĩa Mác	馬克思主義
chim bồ câu	鸽
tỉnh / bang	州省
Ren	谺
đạo giáo	道家
thân cây	梗
cách	方式
Cho thuê	承租
Xưởng máy	機廠
đừng	别
Mela	梅拉
Ra khỏi văn phòng	出仕
Tham gia	涉足
Tát	飏
Gằn giọng	踲
lịch sử không chính thức	野史
dòng chảy	径流
đồng tâm	同心
hạt dẻ nước	茈
bán	沽
Chao ôi	噫
Pháp luật	法例
Người sản xuất	制片人
Trận đấu	赛的
hình thức	形態
Đông chí	冬至
thác nước	瀑布
Đặt nó	將其
Taipa	氹仔
Xianzong	憲宗
Chấn thương	傷勢
Kiệt tác	名作
Saka	阪
Nổ tung	炸毁
Bản chất	精華
Xe đạp	單車
Âm	釺
Sinh thái học	生態學
Huyện hành chính	行政区
tàu tốc hành	快車
Ăn	攝取
Số Pi	乕
Niigata	新潟
khu vực	病房
liên doanh	合資
Chìa khóa	鑰匙
AIDS	愛滋病
Đính kèm	附加
bàn luận	討
Vegas	維加斯
con bò cạp	蚣
Su	蘇
Bình luận	評
Như thể	猶如
Anh ta	臚
ngã	失陷
đi ra	出來
thắt lưng	腰
cha mẹ	雙親
Nhân bản	分身
Leven	利文
Lăn	轧
Ngôn ngữ Minnan	闽南语
Gạ gẫm	招攬
Khu vực	大区
Hemingway	海明威
Hình thang	梯形
Phát triển, xây dựng	研製
Xô	扅
hình dạng	形狀
Thao tác	操控
Là để	是將
Nhu cầu	須要
một vài	几
Florida	佛罗里达
con bò cạp	蠆
Sulawes	苏拉威
Phong cách	作风
nhà tâm lý học	心理学家
thị trấn	鎮
Cho người thân	為親
Mạnh	强
Trang trí	饰
Làm việc cùng nhau	共事
chức năng	功用
Phi	投掷
Thông báo	公布
Trung đông	中東
Cử đi	出动
chung	联合
Khó khăn	難度
Xuân	眀
giản thể	簡體
hàng không	航空
Trụ sở chính	本部
Và đất nước	和國
Taxa	类群
bị cấm	被禁止
Nấm bột	粉菌
Mổ xẻ	析置
Vách đá	摩崖
Xung quanh	一帶
Chứng nhận	认证
khắc nghiệt	苛刻
Một lúc	一個位於
Chính quyền liên bang	聯邦政府
Hai	了兩
Gửi	傳送
Sự chuẩn bị	籌備
Tiềm năng	势
một số	些
bĩu môi	噘
Lời phàn nàn	投訴
Huấn luyện viên	主帅
Mọi người	子民
Đường đó	那样
Yun	筌
Hoàng tử	王子
Sasa	佐佐
Coban	科班
Chúa tể của những chiếc nhẫn	至尊魔戒
Xa lánh	淍
phóng viên	记者
Wen Zong	文宗
Lang	瑯
Nội Mông	内蒙古
Sự chậm trễ	延誤
Tròn	圓形
Hiện tại	現
Ngã xuống	脱落
Xếp hạng	評級
Công chức	公務員
Đang đến	是來
Sản phẩm	品
Đối với Chen	為陳
người phiên dịch	編譯器
Bà ấy	畲
Yuan Pei	元培
nhảy	跳躍
Thô	粗略
Lớp như	類為
dâu	草莓
Chính	大調
dựa theo	据
địa phương	當地
Độc lập	自立
Sau khi đặt	定後
R & D	研發
Dân gian	民系
cạnh	缘
Tráng miệng	甜品
Nepenthes	猪笼草
Người phát trực tiếp	流器
Thổi	打击
bảng	木板
Thịt	肉质
Chiếc cúp	奖杯
Bảng chữ cái Latinh	拉丁字母
Hội đồng quản trị của giáo dục	教委
Trục	軸線
Trước	历届
Thiên Hà	天河
nhà chứa	妓院
Bu	逋
Trẻ mới biết đi	幼儿
Cắt	割
Anh chàng Hong Kong	香港仔
Nhiên liệu hạt nhân	核燃料
Kỷ băng hà	冰期
Giữ	召开
Alishan	阿里山
Trùng hợp	吻合
cái nút	钮
Quân đội cho	軍為
Trên bàn	桌上
Ba	峇
Những giọt nước mắt	眼淚
Thương tiếc	儫
giàu có	富有
Bầu cử lại	改選
Và làm ơn	並請
quanh co	迆
tình cờ gặp nhau	遘
kiềm chế	羈
xây dựng	兴建
Missy	密西
Con vịt	鴨脷
Học hỏi từ	师从
Biên dịch	編譯
Ngựa hoàng gia	皇家馬
thông thường	常规
Chú ý	瞩目
Maher	马赫
tỷ lệ	速率
Phiên bản phim	電影版
Trung Mỹ	中美洲
Rau cần tây	芹
Tát	肎
Bình tĩnh	佐世
Đứng lên	厮
Lần như	次為
đá	巖
tươi	新鲜
quỷ lùn	侏儒
buổi sáng	上午
mũ sắt của lính	頭盔
cô đơn	孤獨
Chỉ có bấy nhiêu thôi	不了了之
quả hồng	柿
Ga đường bộ	路站
Vẽ tranh	劃
dịu dàng	紳
Phục hồi	休養
Nghiêm ngặt nhất	最嚴
hái	鎬
hàng	排
Mach lẻo	流言
Kos	科斯
Sau khi thành phố	市後
Định kỳ	周期性
Thu hồi	撤銷
cá tráp	鲂
tuân theo	坚持
Làm việc	上班
mua	購買
quả mọng	苺
Cơ thể chính	主体
Ulaanbaatar	乌兰巴托
Fei	霿
Tôpô	拓撲
Phát hành lại	續發
Câu cửa miệng	口碑
Yau Tsim Mong	油尖旺
Đền thờ công cộng	公祠
Vô điều kiện	無條件
nền tảng	基础
upbraid	吒
Tosca	托斯卡
Saint Ann	聖安
Chủ đề	纫
Kiểm tra	誧
tầm thường	平平
Shen	珅
Trói buộc	缚
Cây dương xỉ	蕨
Người theo chủ nghĩa riêng biệt	割据
Hoa màu trắng	白花
Nhà máy đường	糖廠
Triều đại Liêu	辽朝
gân	腱
thân cây	莖
tán thành	鉚
kính viễn vọng	望遠鏡
Đồng hành	同行
Wikipedia	基百科
Cám	布蘭
Quận và	區及
xuống dốc	下坡
khu vực hạn chế	禁區
Gấp đôi	孖
ám ảnh	出沒
Đại Hội Đồng Liên Hiệp Quốc	联大
lót	袷
Phép tính	计算
Trong phạm vi	範圍內
Thuộc tính	屬性
phỏng theo	適應
kim tự tháp	金字塔
Dơ bẩn	齪
Lộn nhào	逓
Người tự do	自由民
Sau khi hoàn thành	成後
chạy không tải	顢
sự phát minh	发明
Nhận định	识别
Chỉ có	僅有
Zoff	佐夫
dễ dàng	轻易
Còi	嗫
Quận trưởng	太守
điều chỉnh	调节
Thất vọng	失望
Quận Zhongzheng	中正區
Yi	旿
Kanagawa	神奈川
chính khách	政客
khuyến khích	提倡
Dài	昳
Bligh	布萊
Đầu tư vào	投入
Đang chuyển động	動中
Livan xin	橧求
bình quân đầu người	人均
Với ngựa	與馬
Sa thải	革職
Tuần tra	巡警
cá voi	鯨魚
tập trung	濃
Gan	肝脏
ngưỡng cửa	阈
Băng nhóm	墄
Năm ngôi sao	五星
Jian	臽
thân hình	身体
Phenylpropyl	苯丙
Ba tám	三八
nhu cầu	需要
Cám	布兰
trứng	卵子
Yi	濳
Anh hùng	海洛
Sau này trở thành	後成為
Nhô ra	突起
thực hành	做法
vận dụng	摛
Chua cay	茞
Luân phiên	互生
trang	頁面
Gợi lại	忆
Ger	热尔
Kui	鲿
Kiểm tra	會考
Li Zhuo	李卓
Da	妲
Xây dựng thành phố	建城
nhỏ hơn	更小
Tiếp cận	進場
Zhi	芷
hợp tác xã	合作社
sức mạnh	实力
Vita	維他
tiền tệ	幣
Đúng	在對
Sư Tử	利奥
Khuất Nguyên	屈原
Mông Cổ	蒙古国
Lễ	典禮
giải phóng	放出
bố trí	佈局
ánh sáng	燈光
khó khăn	韌
skiff	艑
Rơi vào	歸入
Có nguồn gốc từ	發源於
Quận tiểu bang	州郡
Cho cuối cùng	為終點
Khiêm tốn	謙
Ogg	奥格
Cúp Liên đoàn	聯賽盃
Trung tây	中西部
kêu vang	噠
táo	蘋果
Phúc châu	福州
Virginia	維吉尼亞
Có thể	得以
vượt qua	打通
Han	蟴
đang yêu	戀愛
Nâng cao	個進
Châu Âu	欧
Rong	瑢
Dro	德羅
Đá	磐
Rạp chiếu phim	電影院
Roe	獍
Một bên	一邊
Yu	燏
Quận Sài Gòn	西貢區
Jun Fei	軍飛
nghìn	仟
thoát khỏi	擺脫
Huang Qi	黄耆
Vicchi	維奇
Tối	傍晚
Khảo sát	考察
pháp luật	规律
Ma Shi	馬師
tuổi già	晚年
con lợn	豨
Quận Xicheng	西城区
khuếch tán	扩散
De	棑
Đốt sống đuôi	尾椎
nhiều	鬮
Dihua	迪化
Nâng cao	进发
bằng chân	徒步
mã hóa	加密
ngành công nghiệp	業界
Tìm kiếm	寻找
vẫn	依然
năm	年華
Richard	理查
Gạo nếp	馪
Đáp ứng	因應
lượng mưa	降水
thông minh	優良
Hai	兩顆
máy bay	刨
đặc biệt	特
Không bật	午
Vì điều đó	為該
Somalia	索马里
giao thức	協議
tính thẩm mỹ	美學
Sali	萨利
Ernst	恩斯特
Tráng lệ	宏伟
xưởng đóng tàu	船廠
Paraguay	巴拉圭
khí hóa	气化
lo lắng	忑
Zong	粽
Nấu nướng	炊
Seoul	漢城
canh	翅膀
ứng dụng	應用
Hấp phụ	吸附
Bởi	的經
tên nick	外號
Ở phía Đông	在東
Kênh	竄
cha truyền con nối	世襲
Dòng dõi	血统
Trang thiết bị	裝備
Tìm kiếm sự thật	求是
Hun	蘤
lao động	勞工
giao nhau	相交
Vượt qua	十字會
Sự thanh bình	和平
trưng bày	顯示
Sữa	奶
Nhọt	疖
Không đời nào	無從
Yi	仱
Arnold	阿诺
nói chuyện	谈
sự sụp đổ	垮
Cắt	掍
Thị trấn nhỏ	小鎮
Sẽ làm	會使
Tuo	庹
Lo lắng	忪
thủy triều	潮汐
Triều đình nhà Thanh	清廷
Ngôi sao	球星
qua nhiều năm	歷年
Gangneung	江陵
Kez	克孜
Trục xuất	开除
Lý do	原由
Hồi tưởng	溯
Prince Consort	驸
Gibraltar	直布罗陀
Thủ đô	京城
Wilder	野手
Nổi dậy	叛乱
che	罩
Chi nhánh	分部
thí dụ	例子
Châu Á	阿仙
cờ vua	棋
đang có một	有個
Ma quỷ	衛門
Kho báu	寶藏
Cuốn sách lịch sử	史书
sự xâm nhập	侵擾
cốc	盅
Chơi	出賽
được bổ nhiệm làm	任命为
Phương pháp lớp	類法
Kerry	克里
Wenwang	聞網
Vòng loại trực tiếp	後賽
Người	事人
Nói dối	謮
Gấp đôi	雙人
cây	厂
Xây dựng	建置
Zhiming	志明
Georgia	喬治亞
nói	說話
Zhu	麄
Phù sa	沖積
Ya	垭
nói nhảm	喋
Liên đoàn thanh niên	青年团
Hu	籥
mặn	鹹
Enthalpy	愓
tuổi	嵗
Nâng cao	進階
Tên này	這名
Thị trấn sông	河镇
khoảng cách	距離
Dành cho bốn	為四
hân hoan	慆
Ngọc bích	敡
giao thức	协议
heo vòi	獏
có thị lực kém	眊
Độ lệch tâm	離心率
Trả	讵
Fei	扉
Vợ lẽ hoàng gia	貴妃
Cuối cùng	終在
Xuân	庋
Đạo văn	抄襲
Lớn	一個大
mềm mại	軟
Mọi người	人家
giống nhau	相同
lớp học	阶级
Mía	卡内
mệnh giá	面值
sự hoang mang	混亂
Lập trình	编程
cồng	锣
Luôn luôn	一律
Shilesu	石勒苏
Hướng tới	朝向
mẫu	圖案
có lãi	利多
đối ngoại	外事
Cơ thể như	體為
Gia Hưng	嘉兴
trước đây	早先
Bian	垍
Du lịch	遊客
Mi	糜
Fu Li	傅里
Người dẫn chương trình	司儀
Steroid	類固醇
Ka	喀
Yuen Long	元朗
trở về	返回
Bãi bỏ	廢止
luật sư	律师
trong khu vực	區域內
bắt đầu	开端
Cái đầu	儡
Chung	将军
sử gia	史学家
Phá vỡ	摜
kho bạc	帑
một phần ba	三分之一
khác biệt	分明
rắc	灑
điềm tĩnh	平息
Haiti	海地
Đường biển	海道
Colorado	科羅拉多
chuỗi	鍊
Dòng người	人流
hiệu trưởng	校長
Thiết lập	開辦
Làm phiền	擾
Huang Yumin	黃毓民
tăng lên	上漲
Cũng không	亦不
Không đời nào	绝不
Quyên góp	捐贈
Theo dõi	軌跡
Phim ảnh	底片
Xueyou	學友
Rein	韁
Đừng đặt	別設
Chính xác như	酷似
Mục tiêu	靶
Quận Heping	和平区
Sườn núi	山腰
đá	岩
Keli	克力
Các công ty nước ngoài	洋行
bệnh đậu mùa	痘
Kiên quyết	坚决
Wadi	瓦迪
Xuồng ba lá	小艇
Routh	劳斯
Chết	恮
Ám sát	刺杀
Sinh	胞胎
Đưa cho	讓給
Qi	俓
Phát triển, xây dựng	研制
ngột ngạt	闷
Khó xử	倻
Chu	蜛
xương bàn đạp	鐙
Thiên nhiên	本質
Bắt chước	仿效
Smash	粉碎
Tương đối	较为
Qi	戚
một mình	独自
kiêu ngạo	驕
Thư ký	秘书
Sân trong	天井
Sâu tai	蠼
Nơi đo	該地
thương vong	伤亡
Tải xuống	下載
Nhiều	繁多
Một trăm ngàn	十万
Mờ nhạt	慩
có	拥有
Robert	羅拔
Thổ dân	原住民
Người nuôi dưỡng	福斯特
triết học	哲学系
Malaya	马来亚
bồi thẩm đoàn	陪审团
Aisne	埃纳省
tu sĩ	僧侶
Trong tiến trình	在進
bong bóng bơi	鰾
ruột	肠
rhodium	銠
mực	墨
cây sồi	棫
ngoại quốc	国外
Điều đáng tiếc	惜
Loot	利品
Trục xuất	驱逐
Chữa lành	瘉
công bằng	相等
Làng hành chính	行政村
Răng nanh	馞
Giang Thanh	江青
Đột ngột	嶆
Holstein	荷尔斯泰因
Học cấp độ	級學
Quân đội Nhật Bản	日军
Kenya	肯尼亚
thường xuyên	常常
Phiếu bầu	票數
Dọn dẹp	清理
Yi	辒
xấp xỉ	约
Đầu hàng	自首
Tổng quát hóa	廣義
xuất hiện	外貌
Hay bông lơn	鍥
Tao	燾
lò phản ứng hạt nhân	核反应堆
Trung Quốc	中國國
Bướng bỉnh	鋀
cây búa	錘
Chói mắt	炫
Sachsen	萨克森州
Mohe	靺鞨
Hiến pháp quốc gia	國憲
hình ba chiều	全息
Nai	凪
Đột ngột	齏
liên minh	聯盟
trường hợp	案子
Tỉ lệ sinh	出生率
Cong	琮
Tiểu sử	列傳
Các thế hệ	代代
Vùng biên giới	边疆区
Dưỡng dục	培育
Yu	媥
cục an ninh công cộng	公安局
sinh viên	學生
dựa vào	賴
ngành công nghiệp	業
héo	萎
Đỉnh chính	主峰
Ngày hôm đó	当天
Kai	鴔
Hàng chục	几十
Bule	布列
Qi	蘐
Tây An	熑
Bị liên lụy	捲入
Zhuangzi	庄子
tai	耳朵
Lai	霦
quý giá	寶貴
Huang Yu	黃毓
thuốc phiện	鸦片
cho phép	允許
chải	刷
Vận chuyển	載機
Hai ngàn	二千
Sọc	斑紋
Salamanca	萨拉曼卡
xà gồ	檁
năng khiếu	才子
có thai	孕
chất thải	浪费
Tờ báo	该报
Jingsheng	景勝
Weiguo	衛國
chủ nghĩa hiện đại	現代主義
Những quả bóng	個球
Sự sỉ nhục	唂
hình thức	结成
Khoa học viễn tưởng	科幻
Đưa cho	送給
Điểm nóng	热点
Giết chết	弒
Trường nổi tiếng	名校
Nghi can	嫌疑
Hiển thị cho	展到
đông bắc	東北部
Tôi	朕
Nhát	詥
Sri Lanka	斯聯
Watson	沃森
acmite	鉥
Hùng Hom	紅磡
câu lạc bộ	俱樂
Tây Bắc	西北方
Yong	埘
khách sạn lớn	大酒店
Máy bay quân sự	军机
chơi	戏
Km	公里
Trước mặt	鋒
đổ nát	隤
Giải thích	交代
Tịch thu	沒收
phi tiêu	摅
Về mặt	來講
hình trái xoan	椭
hỏi	问
Ashina	阿史那
Syria	敘利亞
la Mã	羅馬
Chú ý	留意
Chúa tể	勋爵
Học bổng	學金
Basti	巴斯蒂
di chuyển	搬迁
hiển nhiên	明显
Mời	引人
McDonald	麦当
qui định	统治
Đến như	來作為
lễ Phục sinh	復活節
mặt khác	对方
khuỷu tay	肘
tải lên	上載
phần cứng	硬件
Tuyên bố	的說法
sự phân giải	决议
Nhóm thành viên	員組
Cấp thành phố	市级
đồng hành	侶
Nổi bật	出众
Trái đất	大地
kết thúc	結局
Yin Ke	寅恪
Byzantium	拜占庭
Fati	法蒂
nhà tù	狱
Tiết kiệm	歂
thịt cừu	膍
phân phối	分發
Zhu	栘
Tát	櫐
Trẻ	孅
tiêu đề	标题
đồng âm	谐音
Ngôi sao năm cánh	五角星
Trong xe	車內
Thời gian	時所
tia lửa	火花
Nhanh	斯威夫特
Fran	弗蘭
Năm thời gian	時年
Bảo vệ	侍卫
nhìn chằm chằm	瞪
thậm chí nếu	即使
khẩn cấp	緊急
cái đe	砧
Đảng nhân dân	人民黨
Nobita	大雄
xiên que	丳
ngốc nghếch	愚
Động vật giáp xác	鲸鱼座
Tài nguyên tham khảo	參考資
lồng	櫳
Thầy tu	教士
Vi phạm	睽違
Thờ cúng tổ tiên	祭祖
Ngốc nghếch	螱
không cần thiết	未必
Kết hôn	下嫁
Mười nghìn tệ	萬元
Hệ thống sông	河系
Năm ngàn	五千
Quan	蒑
Học hỏi	習
căng thẳng	张力
franxi	鈁
Niêm phong	加封
Cho phép	可讓
Cô đơn	滃
Bách Tế	百濟
Vạn lý trường thành	長城
Bản sửa đổi	修订
mập	脂肪
Ju Li	句麗
Li	蠮
sai	讹
thủ tục	手續
dựa theo	根據
Đã vẽ	德鲁
Quân đội tiền phương	方面军
dừng lại	罷
ngoại quốc	对外
Lan Châu	兰州
trái cây	水果
CD	光碟
Sự chiếm đoạt	撥款
Indonesia	印尼
Âm	褺
Cướp biển	盗
Habu	哈布
một cửa hàng thức ăn nhanh	快餐店
Hum	奨
đà điểu	鴕
Dongcheng	东城
Suy sụp	旣
Rời khỏi	离去
Gia ban	售价
Yong	颕
thời gian này	這次
Võ thuật	武林
tàu ngầm	潜艇
Ziwen	子文
sẵn lòng	願意
Wemb	溫布
thu hoạch trong vụ thu hoạch	穡
Đánh con chó	打狗
Xiao	滭
sưu tầm	收集
Với Hồng Kông	與香港
Khờ dại	癡
nồi	鍋
Một năm	一年
Yan Qi	焉耆
gần đây	近日
nghiêng	傾斜
Năm	年代
Ác quỉ	惡靈
Cha-con	親子
Yongqing	永清
mồ hôi	汗
Thrush	菥
chôn	瘗
điện cực	电极
Li	楽
Yu	剠
thuyền	舟
Gandhi	甘地
nước lạnh	冷水
Viên thuốc	碉
Sẽ	便將
Lo	担忧
thực ra	其時
phiền muộn	瘼
nhãn hiệu	牌子
Thời gian đã trôi qua	時已
Chân dung	刻画
Sau	後於
Quyết định	決定將
Dưới	之下
Vít đường ống	管螺
bưu thiếp	明信片
bằng phẳng	平板
hồi ký	自传
Chu	轔
định dạng	格式
Nếu trong	若在
Gia hạn	熱內
Đến	前來
Jianguo	建國
Chế nhạo	譏
Phòng cháy	防火
Cũng cho	亦作
Huyện Vân Lâm	雲林縣
Thị trấn mới	新市鎮
Âm	镾
Rỉ sét	窆
Tỉnh	省立
Dang	筜
chào mừng	歡迎
Thế hệ trước	前代
thêm vào	加法
La mắng	詘
Chu	莬
gia tài	遺產
sự ô nhiễm	汙染
Xếp hạng	名次
Liuhe	六合
Yell	呑
Đế chế Mông Cổ	蒙古帝国
Thân thịt	胴
Mỏ than	煤矿
chì	带领
Chúa tể	爷
Phong cách	風貌
Yi Fu	逸夫
Đúng cái này	對這
dự trữ	儲
du thuyền	巡航
Hơn	較於
con rận	虱
Hay bông lơn	瓦格
Nibble	鎡
Provence	普罗旺斯
hẹp	窄
nhân học	人类学
Shu	涭
Rơi xuống đất	倒地
Chức vụ	之職
dự định	打算
Trưởng	事長
Khoa Lịch sử	历史系
hệ thống	制度
Trong đám mây	云中
vạch sọc	条纹
Đầu tiên với	先用
Vượt qua	通行
Khởi đầu năm mới	年初
huyết thanh	血清
Sẽ	威尔
Ngôi sao	神星
Như nhau	均匀
cần sa	大麻
Trận đấu cấp độ	級賽
đó là	即
Cát	金沙
chặt	剁
Tách rời	分设
Trung bình	中型
Thành phố Tân Trúc	新竹市
Jiao	娇
kích thước	维
Một phát	阿方
cố gắng	企图
ATV	亞視
Jue	玦
Núi màu tím	紫金山
nguyên chất	粹
Dao	刀
Tai Po	大埔
Vì điều đó	於該
Đài	無線電
Sáu	六個
phương tiện truyền thông	媒體
Đột ngột	頓時
Nhà điều hành	业者
Tỉnh	县内
Thân hình	身上
Tiết kiệm	攢
Hàm dưới	下頜
Bavaria	巴伐利亚
mong	希望
Kai	垲
Vắt kiệt	扊
Sư đoàn	赛区
vũ trụ	宙
xung quanh	围绕
đơn vị	單元
Gusset	衽
Cứu quốc gia	救国
Mại dâm	娼
Nói đùa	戏称
như là	這樣
Quyền hạn	列強
Thành phố New York	纽约市
Biên đạo múa	編排
chân thật	善意
giới trẻ	青年人
sự giống nhau	類推
bóng chày	蟀
mật khẩu	密碼
trở lại	背面
Dài	陇
dưới lòng đất	窅
Chết	離世
nổi bật	顯赫
Cuốn sách này	這本書
phẫn nộ	怨恨
Dùng cái này	用此
Jianping	建平
Chụp	枪击
biên giới	邊境
Amaterasu	天照
yêu nước	愛國
nhu cầu	需求
Dân bang	州人
Trạm năng lượng	电站
Tám	八
Ishida	石田
lít	公升
ở gần	靠近
Phô mai	之士
Nghe nhìn	音像
cho thuê	租赁
Giải phóng	下達
tên nick	諢
Mộ	墓葬
Tuyên chiến	宣戰
hàn xì	焊接
Tiêu đề	題為
Tấn công	襲擊
tầm cỡ	口径
Đấu thầu	申办
Tát	梫
Trong những trường hợp	況下
henbane	菪
Mặt riêng	己方
Than khóc	嗷
Liang Wang	梁王
Cree	克雷
sự hợp nhất	兼并
Shi nói	時說
Máy vi tính	微机
Không thiếu	不乏
Nói chuyện	誾
Saki	崎
Mở lại	重開
Bò sát	爬行动物
cây gai dầu	縕
Cản trở	阻挠
lưng	鬐
Công	有功
Đã vẽ	德魯
côn trùng	蟲
có lẽ	大概
thương hiệu mới	全新
Jiazi	甲子
Sự chinh phục	征讨
Wiki	維基
Con gà trống	屾
Chống lại	兑
Giao hưởng	交响
Nhỏ	斯摩
Phục vụ như	充任
liên hiệp	聯
Ulva	莼
Enlai	恩來
chim ưng biển	鶚
Và tiếp tục	並繼續
Âm	琔
Tròn	圆形
Cứu giúp	助
hội,, tổ hợp	集会
rẻ	廉價
Quận Sha Tin	沙田區
lực lượng	迫使
Newton	牛頓
Tăng và giảm	得失
Tiểu bang	州州
Trở lại	背
rut	辙
diệc	鷺
Quần áo	衣物
Bị cáo buộc	據稱
nghiện	癖
Thames	泰晤士河
Mưu mẹo	威特
Ding	叮
Nội thành	内城
điền kinh	田径
cây thạch thảo	希斯
thương mại	通商
trong	於
Tang	賅
Lộn nhào	挓
cửa hàng bách hóa	百货
Chi	栨
ở trên	以上
Lịch sử	沿革
mộc qua	柤
Yas	亚斯
Cố gắng hết sức	極力
Nghẹn ngào	兣
Cơ giới hóa	机械化
Cannonball	炮彈
chất rắn	固體
Stie	施蒂
Cho dù	為連
Johor	柔佛
chiến tranh	戰爭
Ribas	里巴斯
Bagh	巴格
Quốc gia	國家
Frey	弗雷
Dai	埣
Khả năng sử dụng	用性
Phiên bản	实例
hàng	線路
Kilôgam	公斤
nô lệ	奴隸
cổ điển	經典
Đứng trên	台於
kéo	輓
Vĩnh Xuân	永春
nhà thầu	承包商
Li	溤
tư thế	姿势
buổi hòa nhạc	音乐会
Leng	楞
Nhát	靦
cuộc khủng hoảng	危机
giải quyết	沉降
Ya	虡
trang điểm	彌補
赙	賻
Tên thật	現名
Itabashi	板桥
Khúm núm	跜
NMR	核磁共振
Kun	坤
Kyoto	京都
Thành viên tại	員於
cánh tay	武器
Gandalf	甘道夫
lanh	絺
xương sườn	肋
Khuôn	模具
La	喇
nịnh nọt	谄
tiết kiệm	節省
Nói chung	一般而言
Li	俍
Yuwen	宇文
Vôi	石灰
Đổi tên	易名
Gạo nếp	糉
Wei	贑
Khen ngợi	讚譽
Cái này	這張
từ điển	字典
Tích cực	阳性
nhóm	群体
vui mừng	愉快
nhầm lẫn	迷惑
Chu	葅
Huguang	湖广
tủy	髓
Đầu tiên	首任
lá cờ trắng	白旗
Trevally	鰺
Ding Wei	丁未
Năng lượng Hidro	水能
hội,, tổ hợp	装配
hợp đồng	協定
Thu hút	引来
không ổn định	憧
nhà thờ Hồi giáo	清真寺
Nói lại	重演
Delineate	划定
Taishi	太史
Marseille	馬賽
tấm màn	幃
nhà soạn nhạc	作曲家
Tal	塔尔
lễ kỷ niệm	慶典
Abdul	阿都
ăn	吃饭
Khắc đá	石刻
truy cập	访问
chuyên dụng	专用
Kuma	隈
Zeng Guofan	曾国藩
Fives	五
viết kịch bản	撙
dấu vết	蹟
Hu Yaobang	胡耀邦
tre dài	籊
Đưa vào	普顿
Illevillene	伊勒维莱讷省
sức chịu đựng	耐力
Tiếp cận	伸出
Chỉ	覽會
Tuyển dụng	新兵
Cáo buộc	指控
Rael	雷尔
Cá vây	鰭魚綱
Dậm chân	跘
Nổi tiếng	为人知
Bị bỏ rơi	遺棄
Di	荻
phóng uế	屙
Nắm quyền	执政
Hàng trăm	數百
Sam	山姆
Bose	玻色
chờ đợi	等待
Như là	此等
Âm nhạc	乐曲
kiện tụng	訴訟
Thanh toán	清算
Công giáo	天主教徒
giác ngộ	教化
dày	厚
Nguyễn phúc anh	阮福映
Porter	波特
trực tiếp	生息
Gọi là	称作
Gọi chung	合稱
cá thu	鯖
đảo chính	政變
Âm	騱
Bò rừng	野牛
Hợp lý	邏輯
Hồng Lâu Mộng	红楼梦
không khí	風氣
Chương trình đa dạng	综艺
Pavilion	館
Tát	攗
Quốc gia	全國性
tòa ánTát	球場剌
Vật lý và hóa học	理化
tranh tường	壁画
Thành lập	创办
nhìn trộm	窺
Khẩu súng	該槍
sự sụp đổ	倒台
khuyến khích	推动
tươi	尟
Nanyang	南阳
Chỉ huy	統領
Cháo	粥
ý tưởng	意念
vồ lấy	抢
Latvia	拉脫維亞
Ở đâu	所處
lợi nhuận gộp	毛利
khó chịu	镦
Nhặt lên	揼
Đài truyền hình	电视台
Sự cấu thành	選區
Tưởng tượng	虛
Bộ điều khiển	控器
khóc	啼
đồng hồ mặt trời	晷
Đến	前来
không phải	未
Cách mạng Mỹ	美國獨立戰爭
Không	中沒
Linden	椴
Ngực trần	裸胸
phanh	軔
thủ môn	守門員
Yên tĩnh	蝂
Polymerase	聚合酶
Yi	伓
Dọn phòng	內務
văn bia	墓志铭
Thoải mái	舒适
tiếng Đức	德語
Luo	濼
Đường nhánh	支路
sinh học	生物
bão táp	風暴
Lăn	軋
Đến Đài Loan	來台
dưới lòng đất	地下
chuyển khoản	轉讓
Kant	康德
Cây giống	子植物
Bún	諽
Có lẽ	也許
sự hiểu lầm	誤會
Cả hai mặt	两侧
Thủ môn	门将
Bực bội	旄
Hán Việt	汉语拼音
mạnh	酽
kết thúc	终点
Xấu hổ	襾
sau	以后
Để hiểu	瞭解
Trang web thành phố	城址
Đãi	救治
Jianhua	建华
điện	電氣
bàn phím	键盘
Kích thích	激怒
đây là	此為
Thuyết phục	深信
Dài	梴
đặt xuống	撂
mỏ dầu	油田
gấu trúc	熊猫
Lực lượng liên minh	聯軍
pháp luật	規律
Hát	檮
Thành phố Cáp Nhĩ Tân	哈尔滨市
Shikai	世凯
Wenlian	文联
Ghi lại	记载
Chủng loại thực vật	植物种
Tình yêu	阿摩尔
antimon	銻
Bằng tiến sĩ	博士
Hướng tới	走向
Du thuyền	巡洋
Lớp thứ ba	三等
Sử dụng nước	用水
Trợ giảng	助教
Tây An	胇
Nước thải	汙
chủ đề	題材
đông bắc	东北
Ganquan	甘泉
con muỗi	蚊
Với cái này	與這
Không biết	不知
Kea	基亚
Nhãn hiệu	品牌
Zang	臵
Ông chủ	头目
Gợi lại	召回
Yu	勮
Tham khảo ý kiến	咨
Vancouver	溫哥華
Băng qua	道口
thắng lợi	贏
Kể từ	截至
Giám đốc	處長
mạng lưới	網路
Ô tô và	車與
Thanh Đảo	青島
Không cho phép	不许
Tòa án Công khai	开庭
súng	炮
Chome	丁目
Chiều cao tháp	塔高
Trường hợp này	這種
Belarus	白俄羅斯
xấu hổ	恥
Số Pi	郫
hướng dẫn	归纳
rồng bay	螣
râu	耏
Tong	侚
gốc	來歷
Mẹ chồng	婥
cuốc đất	鋤
Khởi đầu	开局
cười	嘻
Đầu tiên bởi	先由
Nặng	重型
Xe Jeep	吉普
Cánh đồng	菲爾德
chung	將領
Levy	从征
đo lường	测度
Trân trọng	謹
Haidong	海东
Gu	辜
Và có	並擁
Tsuen	荃
Khai mạc	開口
Liên Xô	蘇聯
móng tay	钉
bào tử	孢
Covet	觬
Vợ lẽ	妏
Định lượng	數量
Người già	的舊
Li	俌
ngoài ra	除此之外
Tro núi lửa	火山灰
Chú	舅
Gạ gẫm	征集
Quán ba	杠
Bộ truyền động	动器
Ở ngoài	外側
Xinhai	新海
thần thoại	神话
Bên Yu	黨於
đường	途径
chiếm lấy	擒
Chiến tranh quân sự	軍戰
Nuôi	滋
Quảng trường	廣場
Bưu điện	邮局
Môi trường sống	栖息地
ắc quy	電池
gì	甚麼
Thời Đông Hán	东汉
cây ô rô	冬青
Natri	酸钠
Japonica	稉
Tầm quan trọng	星等
Hitter	打者
Colorado	科罗拉多
Người Thổ Nhĩ Kỳ	土耳其人
Dương	漾
Trở về nhà	返國
Bởi vì nó	因之
Công	淙
vòi nước	舁
tốt nghiệp	毕业生
Chính xác	正是
Kaiyuan	开元
Tuổi thứ ba	第三紀元
Góa phụ	遗孀
berili	铍
Cơ quan chính quy	常客
CAO CẤP	貴賓
Ở ngoài	外道
Thế hệ cuối cùng	末代
Ngã tư	交集
Đã học	得知
Ji	驥
Domicile	戶籍
nhà khảo cổ học	考古学家
Sốc	震惊
Jingde	景德
Cảnh sát vũ trang	武警
chiếm lấy	攻克
phản ứng	應對
Nhưng trong	卻在
thiết bị đầu cuối	终端
đào mương	瀆
Tấn	攵
vịnh Cửu Long	九龍灣
lái xe	駕駛
một số	某些
Dòng đầy đủ	全线
Pooh	维尼
Hai mươi tám	二十八
bừa	櫌
Không có gì	毫無
Tỷ lệ	率為
rouge	胭
Đi từ	離為
Lợi thế	优势
vanilla	香草
Raiders	奇兵
Kan	阚
nhận con nuôi	收養
thích hợp	适宜
sau khi kết thúc	結束後
Sau vàng	后金
Y	鐾
món ăn	食物
Quận Yin	鄞县
năm mươi nghìn	五万
Đi	煣
Donghua	東華
Cái bàn này	本表
Bùng binh	迂
Hoa hồng	玫瑰
sự kiện hiện tại	時事
Khiêm tốn	谦
Vay	借鉴
Vải sẽ	佈將
Phong tục	海关
âm thanh	聲音
Lang băm	匽
Đại học bắc kinh	北大
lao động	劳动
Thánh chiến	聖戰
lòng bàn tay	棕榈
bài đăng	岗位
Họ cây	树科
Tổ tiên	先祖
Watts	瓦茨
Danny	丹尼
Xuezheng	學政
nông trại	農場
đáng yêu	恇
Nhân dân tệ	人民币
Người giữ lại	家臣
Tus	圖斯
Tháng sáu	浚
Wells	威爾斯
Như một ví dụ	為例
Mái hiên	幬
thủ đô	首部
Yêu và quý	爱
Sau	化後
Giữa	間於
Đến	來的
Sanhe	三河
đến	向
Thay đổi họ	改姓
đông Đức	東德
Lushun	旅順
Trường trung học nữ sinh	女中
Cao hơn	高於
Chào	逷
Con đẻ	後代
Parker	派克
Đưa cho	赐
chữ số	数位
Hạt Feng	丰县
Ở Hongkong	於香港
Bảng chữ cái ngữ âm quốc tế	國際音標
làn sóng	浪
thủy thủ	水手
Jing	葹
Thành viên của Quốc hội	議員
Cảnh sát	民警
Roosevelt	罗斯福
nhiệt	燂
Danh sách	榜单
Triệu hồi	召见
Nhìn vào	看待
tần số	频率
Khiêu khích	挑起
Kui	夔
Vở kịch	該劇
Supercharge	增壓
Khách mời	嘉賓
Bệnh xơ cứng	硬化症
Thì thầm	啨
khiếm khuyết	缺陷
Than phiền	诉
Ba chiều	三維
Xi	晛
Ăn cướp	刧
Wan	莞
Cống vật	朝貢
Răng cá chép	鯉齒
vay	借用
cái đó	苫
Chu	踍
Yi	厷
Công	龔
Rie	里耶
Áp suất không khí	气压
Madi	馬季
Tàn dư	残余
Muni	牟尼
Yan Jing	嚴經
Sững sờ	懔
đứa trẻ	兒童
tiếng Nhật	日方
Triển lãm nghệ thuật	美术馆
đã kết thúc	訖
kỹ sư	工程师
lớp học	课
Hở	唒
Bàn luận	议
Hỏi thăm	查詢
Ứng cử viên	參選
Takada	高田
Âm	鼿
Chanh	檬
Tiêu điểm	重点
cá bùn	鰋
Uesugi	上杉
Bồn rửa	沈
Đóng cửa	封闭
tỷ giá	汇率
nền tảng	根基
Được thăng cấp lên	升为
Xác thực	正宗
quan tài	櫝
Hàn Quốc	朝鮮
khiển trách	咎
bài viết này	本條
Tianya	天涯
Po	泊
Hải quân	水师
Con nuôi	所採
kế hoạch hóa gia đình	计划生育
Morihito	守仁
lữ đoàn	旅長
thuyền nhỏ có cửa sổ	舲
Ngân hàng trung ương	央行
Xấu hổ	魪
Giết chết	杀死
Linh thiêng	神圣
tuổi	歲
Nghe rõ	羅傑
thị trường	市場
Thời lượng	歷時
Liu	靏
Lin Sen	林森
Các nhà cung cấp	提供商
Co lại	缩小
Ca sĩ-nhạc sĩ	創作歌手
Đồ họa	圖形
Tây Bengal	西孟加拉
Yan	剅
Qi	槀
Ye	祊
điểm này	這點
ngọt	甜
Và phải	及對
Cá chim	鯧
kéo	拔
không chính thức	非官方
Tham dự	葠
Cho một	為個
tặng tiền thưởng	犒
So sánh	相較
Đường chính	主干道
phương pháp	辦法
Cho cổ	为古
Mặt tiền cửa hàng	店面
xúc phạm	得罪
Choshi	铫
Giành chiến thắng trong gang tấc	險勝
khao khát	欲望
Tham gia cuộc chiến	參戰
quần áo	服装
rượu	果酒
khô	榦
hợp pháp	合法
chim ưng	鶻
Thập tự chinh	讨伐
đục đẽo	錾
Cai Yuanpei	蔡元培
gò đất	丘
Parker	帕克
Göttingen	哥廷根
Trung bình	中位數
Trước và sau	前後
Yi	僼
Pan	泮
Kháng nghị	訴求
Cang	沧
Aya	綾
xoắn	絞
chịu đựng	忍
Shangguan	上官
sự phát triển của	發展
Ăn mừng	慶
dược phẩm	醫學
Albre	阿尔布雷
Khu vực kinh doanh	务段
Ngày thứ năm	初五
Giá cả	耗資
thành nội	勅
chế độ	政权
đá	蹴
Gail	蓋爾
Nhặt lên	撎
Xuất hiện khi	時出現
Đồng đô la bạc	银元
Bonito	貣
Ký tên	號誌
theo dõi	跟踪
Lịch sử quốc gia	国史
Người phụ nữ của chúng tôi	聖母
Ji	骥
Lớp ba	初三
Genesis	創世紀
Qi	狕
Lập lịch trình	调度
Vùng nước	水區
Tất cả mọi người	人人
Shao	齾
mười một	十一
Chống đế quốc	反帝
Saint	圣
Xixia	西夏
Xa lộ	高速公路
Affine	仿射
Thực hành	践
Simpson	辛普森
Joan	瓊
Anjo	安條
Adam	亞當
Trời xanh	青天
Habi	哈比
gian xảo	獪
bàn thờ	罈
Trừng phạt	浤
Auckland	奥克兰
Bươc	迈
Km giờ	公里小时
giống cái	雌性
Chỉ số khúc xạ	折射率
Quốc gia	国家
đột ngột	遽
Tài chính	财务
bộ trưởng, mục sư	部將
hai mươi bốn	二十四
Yi	乽
Nhưng không có gì	卻無
Dài	耇
tan chảy	融
Thân tàu	艦體
F	載於
Mũi Hảo vọng	好望角
Ay	嗲
máy phát điện	发电机
nông thôn	乡下
Wei	薇
con lừa	驴
Phía dưới	下文
Máy bán vé	售票机
Đến từ	來處
lao động	劳工
suy ra	得出
chèo thuyền	划艇
Dân thường	庶人
Saiyan	賽亞
năng lực	天赋
Ontology	本体
thịt nấu chín dùng trong tế lễ	膰
ân xá	大赦
Xiu	岫
Lu Sheng	陆生
Con vịt	達克
Vẫn còn sử dụng	沿用至今
giống nhau	一樣的
điếc	聩
McCart	麦卡特
đào	搯
buổi triển lãm	展覽
món thịt hầm	焖
Thạch Gia Trang	石家庄
Ainu	阿伊努
Giám thị trường	校監
mở	開放
Nguy hiểm	危险
tỉnh lỵ	省城
Quận tóc	區發
Bian	比安
ngoại quốc	對外
làn sóng	波
Luân hồi	輪迴
Công nghiệp hóa chất	化工
Nửa đầu	上半年
Gần gũi	亲近
Kai	楷
Taishan	台山
tạm ngừng	顿
Nấm ngoài da	癣
giống	喜欢
Li	櫫
kết tinh	結晶
Ông chủ	波士
tăng	增多
tương tự	同樣
Rêu	摩斯
mơ	夢
phù hợp với	依据
Chao	挶
giết chết	殺
Hòa giải	調解
phần thưởng	赏
tài giỏi	聰明
Ngày hôm đó	當日
săn bắt	躡
Thông tin	資料來
Mở rộng đến	延至
Kenta	肯塔
Sừng lớn	大角
khao khát	願望
Lụa	軬
thế giới	世
Sta	斯大
đồng thời	同時
Tp.	斯市
rộng	宽阔
Giám đốc	总监
Bị nghẹt mũi	嗅
Nam Úc	南澳
thưa thớt	嘒
Ngốc nghếch	膫
San Francisco	旧金山
Có	有
đạn	子弹
trận đấu	媲
Chang	萇
Thẳng thắn	执导
Hầu hết	乎
mục lục	目录
Tsunji	尊氏
Gọi ra	籲
màu xám	灰
Tự do	自由式
Fermium	镄
sự đốt cháy	燃燒
Học phí	補習
Một nửa thứ hai	下半場
Ký tên	徵
dư luận	舆论
Nuốt	燕子
Mang	摃
ngoài trời	露天
nói chung	大体
Bức vẽ	涂装
do	由于
N: Xứng đáng	功绩
Bố trí	布置
mục tiêu	目標
Chiều dài của	的長
Hou Jing	侯景
Bằng phẳng	扁平
xã hội	社会
Trái xoài	芒果
rủi ro	風險
Hơn mười nghìn	餘萬
Tam Hiệp	三峡
Chan	滻
Âm	赕
phản ứng	响应
con ve sầu nhỏ	螓
Liên đoàn bóng đá	足联
Zhu	禚
Kiệt sức	盡
Neon	蜺
Lũ lụt	鱛
Đã chết	亡者
đầy hơi	脝
Kyoto	京人
Nian	埝
Surging	澎
bên	侧面
đốt cháy	爇
Yan	箄
hoạt động	活躍
đồng đội	队友
Đài Loan Qing	台灣清
sâu	深
Cô đơn	阋
thô lỗ	伧
Tán thành	核准
Minh Thanh	明清
Cá chép	鯗
mua chuộc	賄
Thomas	托馬斯
Nút thắt chiến tranh	戰爭結
tang lễ	葬礼
Danh sách	榜
Hợp nhất thành	并入
ở gần	濒
Dương	鸂
Gobi	戈壁
Bên ngoài bữa tiệc	黨外
tượng đài	纪念碑
mối mọt	蛀
kẻ giết người	凶手
keo kiệt	嗇
Không	沒有
Chứng nhận	認證
ngủ ngáy	鼾
âm lượng	卷
cửa hàng	储存
Chì	领先
Điêu khắc	雕刻
buồn	凄
sự phát minh	發明
phương sai	方差
Wincher	溫徹
Cấp	排名
Ngạc nhiên	怹
Xa Xăm	遠處
khuôn tre	笵
hóa đơn	法案
Lòng tốt	仁愛
ngôn ngữ	语
ngưỡng cửa	門檻
Miu	缪
Nghĩa vụ quân sự	服兵役
Taichung	臺中
Erdo	鄂尔多
X-tốc-khôm	斯德哥爾摩
Phức tạp	复杂性
roi da	鞭
Bột Hải	渤海
GBP	英镑
Ruijin	瑞金
Quê hương	家村
Danh mục	名錄
Wang	汪
tiêu đề	啣
lảm nhảm	咿
Một lần	曾
Tán thành	獲准
Cấp độ đầu tiên	一級
Trận đấu	赛事
Wan	畹
Trạm thời tiết	气象站
Trận chiến chính	主戰
che giấu	瞞
Hệ thống quân sự	軍統
Cất cánh và hạ cánh	起降
thần học	神学
Pooh	呸
đại lô ngôi sao	星光大道
Lingen	林根
hợp pháp	法定
uy tín	威信
Hai trò chơi	兩場
X-tốc-khôm	斯德哥尔摩
Chín mươi bảy	九七
Và cũ	與舊
Không tệ	不俗
Ngày 23	二十三日
Thai kỳ	妊娠
Thánh địa	麥加
Thua cuộc	連敗
tỉ lệ	比值
Châu Úc	澳
Đảng Quốc xã	纳粹党
cửa tiệm	铺
Mons	蒙斯
Ye	迒
trả	缴
Luxembourg	卢森堡
kịch bản	劇本
xung quanh	周圍
xe hơi	車廂
Có không	是無
Yên tĩnh	蚬
Wang Li	王李
Phình to	隆起
sự hối tiếc	遗憾
Anji	安吉
Cướp biển	舙
Zhi	枠
chủ tịch	會會長
Postdoc	博士后
Đức phật	彿
xuất sắc	輝煌
Băng dán	石膏
Để làm cho	以作
Hoặc	任一
méo mó	扭曲
Sách bài hát	诗经
Cuối của phía đông	东端
Tiếng kêu bíp	嗶
nguyên	原始
Hun	猃
Biến dạng	变形
Thang máy	举
sẽ	將會
cũ	久遠
Vương miện	克朗
nói	告诉
Xấu hổ	歮
Yan	嫣
bươm bướm	蜨
nhà kính	温室
Hàng	行
Đường dây mở	开行
Ya	埡
chim bay không đều	翪
Lên kế hoạch cho	定於
Sự sỉ nhục	磥
Từ	將從
than cốc	可乐
Lạt ma	喇嘛
Đặt hàng	订单
Trung bình và thấp hơn	中下
Trường đảng	党校
Nhảy ra ngoài	跳出
Sa mạc	漠
Bướng bỉnh	瞢
Thời gian này	今次
Nong	荇
ở nhà	家中
Duy nhất	惟一
nhiều	众多
Choáng váng	愭
Khởi nghiệp	创业
Mất đi	遺失
Hạ lưu	下游
Nhân vật	图
Trận đấu mạnh mẽ	強賽
bên cầu	堍
một hớp	啜
Bảy	柒
bánh ngọt	饼
Pedicularis	马先蒿
Phát hiện	探测
Phiền muộn	萧条
Lộn xộn	作亂
Bắc Kinh	北京
khí ga	气
Báo chí liên quan	联社
Tim	威克
Sao Hoả	馬氏
phần bổ sung	副刊
ga tàu	颱
mạnh	烈
Shao	梪
Người bán hàng giỏi nhất	暢銷
Tây An	咸宁
hình vuông của bàn cờ	罫
Chiaki	千秋
Baden	巴登
Đối với	為求
con vẹt	鸚
Vội vàng	涶
Shi	轋
trường hợp	案
Tan	賮
Trừng phạt	诛杀
Đàn bà	妇人
Quá nhiều	太上
Gấu mèo. - Gấu mèo	貍
năng khiếu	資優
Nhưng từ	但從
Xiangdi	祥地
phóng	發動
cơm	稻
củ cải	蘿蔔
Sơ tán	撤离
giẫm đạp	蹂
Plato	柏拉图
Các biện pháp	措施
Gửi đi	送入
Giải phóng	下达
Sẽ	旨意
Dalai	达赖
Tức giận	悱
Gì	什
khóa	釦
Lúa mạch	薋
Bao quanh	週邊
Zhizhou	知州
Đúng đắn	義勇
Hung ác	狆
bộ sưu tập	画廊
Lyme	莱姆
công chúa	公主
tuổi tác	齡
Cấp độ	層級
tang lễ	葬禮
cái nhíp	镊
Hiroshima	广岛
Cũng thế	亦然
bề mặt	麪
Che	捂
Lính	士卒
và	並且
Cô gái xinh đẹp	美少女
Co thắt	攣
Phao nổi	浮
Tuoba	拓跋
ép	倥
phục vụ	迎合
Cà vạt	平手
dơ bẩn	秽
Nguy hiểm	危地
thắt lưng lớn	鞶
Tàu buôn	商船
Ngã	福爾
gạch	砖
Hồng Kông	全港
Quân luật	戒嚴
Lên đến	長達
sửa	脩
Hongji	弘治
Kỹ thuật	工科
ấu trùng	幼虫
Tháng mười hai	十二月
Tiệc	颻
Li	苳
Sự hoàn chỉnh	完整性
dược phẩm	医药
sản phẩm	产物
Miyazaki Hayao	宮崎駿
sự chiếu sáng	照明
sợi chỉ	緒
đợi đến khi	等到
Bị cáo	被告人
họ	它们
Người chồng	丈
Tốc độ	时速
chính xác	準確
không thuận lợi	不利
Quan hệ huyết thống	血緣
Điều khiển	掌控
ngoài trời	室外
tránh	回避
Mở	豁
nơi bị động vật cưỡi	畽
Dài	長的
Giáo dục nghề nghiệp cao hơn	高职
Xie	窹
con quạ	克罗
Buzhen	埠镇
Liên kết đôi	双键
ngay bây giờ	現在
thủ đô	资本
Chỉ huy	连长
ngày	晝
tuyên thệ	誓言
Cà kheo	跷
Ô nhiễm không khí	空氣污染
nhôm	鋁
khởi đầu	開工
đến lượt	反过来
Sienna	魹
Tiếng Phạn	梵語
Xinyi	信義
Con gà trống	屓
hằng ngày	日报
Bị thương	傷患
Tiện	方便
Hán tự	漢字
để trần	裸
Hou Guo	侯國
Giảm giá	优惠
tỏi	蒜
Bởi	藉由
Bảo vệ chính thức	官守
Trong bữa tiệc	黨內
Đội	隊的
lừa dối	欺騙
Norwich	诺维奇
Lun	伦
bong bóng bơi	鳔
phi hành gia	宇航员
Trung học phổ thông	高中
lời bài hát	歌词
Ibrahim	易卜拉
Được đánh dấu là	標為
Herders	牧民
Thân hình	為體
Suave	倂
Làn đường	萊恩
thoát ra	爆發
ngay	随即
Màu be	邶
Đưa cho	施
Peptide	肽
Takeyama	竹山
Indica	豼
Goo	咕
Kết nối	连线
Ome	青梅
đúng	恰恰
Nhân vật chính	主人公
phản chiếu	體現
Nền tảng nhảy	跳台
Mở ra	辟
Bing Bing	冰冰
Giảm giá	發售
Carole	卡罗莱
lừa dối	谲
Gọi là	叫作
Trừng phạt	懲
Kích hoạt	触发
Không liên quan	无关
cà phê	啡
Mauritius	毛里求斯
hào phóng	慨
Zhenguan	贞观
Trạm cầu	橋站
sự dao động	波动
hung ác	残忍
Chất lỏng	液态
Ghi chú du lịch	游记
lưu hóa	硫化
Tổ tiên	先民
phát sóng	播
ký ứcao	记忆潢
Tính chất hóa học	化学性质
Choshi	銚
Lớp khí	气层
cho anh ấy	為他
cầu nguyện	祈
toàn bộ	總共有
Bán cho	售予
phức tạp	复杂
Trong vở kịch	剧中
Tân binh	新秀
sự phán xét	判決
Linnaeus	林奈
hành hung	攖
tối ưu	最佳
xinh đẹp	媄
danh từ: Tọa độ	座標
Protium	氕
Bất khả chiến bại	不敗
Được mời	獲邀
xấu xí	娸
Gan	鞧
Kế vị	繼任
Thành phố đá	石城
Yau	攸
Jue	厥
khuyến khích	促進
Kể từ đó	从此
bất mãn với chính mình	欿
Chiến thuật	戰術
quét sạch	消灭
Làm kinh doanh	經商
dấu vết	踪
Trang Chủ	傢
Dài hạn	長一職
đất	土壤
bộ sưu tập	采集
Liệt kê	挂牌
Geng	耿
Sydney	悉尼
không xác định	未知
Hồng quân	红军
Ling	凌
Tìm thấy trong	發現於
Li	醂
Đánh nhau	對戰
Đồng thời	当代
Jung	柾
phần lớn	大多数
Bờ hồ	湖畔
Quốc ca	國歌
củ hẹ	蔥
Atlantic	斯大西洋
Trường học	学堂
áo giáp	盔甲
Xoay	阼
Cải cách ruộng đất	土地改革
Chuyến bay thử nghiệm	試飛
Do	应于
khuôn mặt	面对
Giác ngộ	启示
Trộm trứng	偷蛋
Đồng nghiệp	同乡
sừng	篥
Yeke	耶克
Barr	巴尔
Học như	學為
Phát ban	疿
Ví dụ	舉例
Cột trụ	列式
Dolly	多利
Shao	韶
Cũng tại	也於
van	阀
bắt đầu ở	起源于
League of Nations	國聯
cỏ	草
Bán hàng	销售
Cho sự nghiệp	為業
âm đạo	陰道
Williamsburg	威廉斯堡
Nói	說中
Echigo	越後
công trình dân dụng	土木工程
ho	咳嗽
giảm bớt	缓解
Bit là	位為
Quốc gia	眾國
Rời khỏi đội	離隊
Croup	苙
nó thế nào	如何
bát	鉢
Đại học Bắc Kinh	北京大学
tin đồn	傳聞
Cấp thấp	低级
Nhà máy	出厂
Elizabeth	伊莉莎白
Cứu giúp	助於
Ion âm	负离子
Sỏi	斯敦
Đạo sĩ	道士
Pháp luật	法学
Đốt cháy	烙
Manny	曼尼
Để làm cho	來製
cô	錯過
cái rổ	筐
biết rôi	懂得
Vượt qua biển cả	過海
hiện trạng	现状
Ông ngoại	曾祖父
Cameroon	喀麦隆
Tây tạng	藏传
Đánh	创下
Chính thức	官吏
nguyên vẹn	完好
người ghi chép	隸
Âm	胤
Mảng	数组
ống sáo	篴
Điều khiển	行驶
Ở giữa	間內
Dừng lại	停駛
Hung ác	椋
bỏ phiếu	表决
chung	常见
Sima	司馬
Sự khác biệt	差別
hình ảnh	圖像
Quận Ling	陵县
Tai nạn xe hơi	车祸
Thay quần áo	更衣
Giao lộ	交界
Situ	司徒
Min	閩
Theo dõi	赛道
thuộc về	属于
Bắt cóc	柺
Cứu giúp	助于
Thành phố cấp tỉnh	地级市
Taichung County	臺中縣
Ts	茨
trưng bày	显示
Quy tắc dòng	線則
Ghi lại	實錄
Nói	言之
Chủ yếu	为主
Thói quen	習性
Cái nào là	其為
bán lẻ	零售
Ứng dụng	申
Corsica	科西嘉
Suga	菅
đổi	彙
Wei	魏
Shao	殳
khẩn trương	亟
Đệ quy	递归
Chấp hành	行刑
Chọn	皮克
tang lễ	喪禮
Nhà cung cấp	厂商
Xuất hiện lại	再现
Champa	占婆
Li Ye	立葉
Hội thảo	研讨
Đánh bại	戰勝
Queens	昆士
Yun	藴
nguyền rủa	詛咒
Kennedy	堅尼地
Để qua một bên	擱置
Gọi là	所稱
trước	面前
Trích dẫn	援引
bạo loạn	騷亂
Chậm	斯洛
Đại học Soochow	東吳大學
toàn văn	全文
Châm biếm	讽
Quân đội Nga	俄军
Đầu rồng	頭龍
Đừng nghe	不聽
Qi	綦
Trung Nam	中南
Bắn	拍
giản thể	简体
sự thiêu rụi	燹
Tang Shu	唐書
Chết	灭亡
Hỏi thăm	詢
Tập trung vào	着重
Smash	掅
Ký tên	簽下
bài học	教訓
Lượng calo	熱量
hoa sen	萏
mờ	模糊
vận chuyển	轉運
Đến	改為
Lịch Gregorian	公历
Bác sĩ nha khoa	牙医
Học giả	士人
con số	号码
Căn cứ	本營
Gian hàng tại	館於
Đồng ý	嗯
bờ biển	岸
trong	裡
Sau đó	其后
Maryland	马里兰州
Tên thật	本名
Ling	凴
đóng	闭
palladium	钯
Bắc TP.	北城
Domberg	多姆山
nước miếng	唾
tàu con thoi	航天飞机
Mặt bằng phẳng	平地
Đội trưởng	大队长
Thời gian	間時
Hoàng	瀙
thực tế	事實
năng lượng nguyên tử	原子能
Đã sẵn sàng	待命
mã bưu điện	邮政编码
Gạo nếp	粂
đạo giáo	道教
Lấp đầy	填补
đến nay	至今
Bacillus	杆菌
Đứng như	站為
ẩn	隱
căn cứ	基地
Lữ đoàn hỗn hợp	混成旅
Lide	立德
Xinxiang	新乡
Callus	胼
Chitose	千歲
Thương mại	商工
Yi	佉
đặc ân	特权
phẩm giá	尊严
Ủy ban kế hoạch	计委
monomer	单体
câu hỏi	质疑
ngọt	甜美
Tốc độ quay	转速
Đỏ tía	勃艮
Phần	区段
Cửa hàng	贮
Cục	主席团
bệnh bạch cầu	白血病
Tần	鎴
Là tất cả	均被
Cú	梟
Tàu	艦艇
sửa	修理
hầu hết	殆
Cắt	剖
Tuyên chiến	宣战
tích cực	积极
Huazhou	华州
Shiju	時舉
Quy định	法規
con rái cá	獭
Xiêm	暹
anh ta	他
Hồ Châu	湖州
Loy	洛伊
cố chấp	愎
Gánh nặng	經擔
Bóng râm	遮蔽
Năm	年時
Hiệp ước hòa bình	和约
nước luộc thịt	臛
Haeza	波江座
Bodo	波多
Chùm tia	樑
thanh lịch	雅
Khám phá	探討
Trân Châu Cảng	珍珠港
Vắt kiệt	搹
Chú	伯
đơn vị	單位
Braque	布拉克
viết	写作
Thu nhập hàng năm	年收入
Jia	贾
Người tham gia	參將
Vĩnh hằng	永恒
thành viên	成員
Xa xôi	偏僻
Yên tĩnh	蚑
Nhân vật	圖
Vây quanh	圍
Portland	波特蘭
hội thảo	研讨会
Sâu	蠚
Dali	达利
hai mươi mốt	二十一
nhấn mạnh	重音
Nhóm và	團與
Shen	渖
toàn thành phố	全城
Nước ngoài	外国
Yi	贻
Arthur	亚瑟
bối cảnh	场面
Họp mặt thể thao	運動會
theo tiền lệ	躔
Yêu cầu	索取
Cho mọi	為每
lồng	笼
Nhân sinh	人命
lãnh thổ	版圖
toàn bộ	總數
Sau đó lấy	則採
Hợp hiến	憲制
đại sảnh	会馆
Tổng sản lượng	產總
báo chí	报纸
điềm tĩnh	冷靜
chà xát	擦
gọi	呼吁
Thổi	打擊
Sư đoàn	師會
thuật toán	算法
Witte	维特
Shan	姗
Kỷ luật	訓導
bệnh viện	院
Cho đến khi	直至
Khu trung tâm	中區
rừng	林匹
người Anh	英式
Tang	鞁
Quyền hạn	轄
Kích động	鼓动
Và bởi	並由
Cánh phải	右翼
nhiều lần	反复
tiết tấu	揍
Nhà cách mạng	革命派
Tài khoản	戶端
Thức ăn thừa	賸
Đúng	過對
Yi	佽
thêm	加
Si	駟
Nhìn vào	瞱
Đúng đắn	作义
Gu	雦
Nhìn trộm	橅
Thông thoáng	清除
Vì nước Pháp	為法國
Tonga	東加
Xinh đẹp	葩
Nhập ngũ	参军
nhà Trắng	白宮
Huân	洹
Vội vàng	淓
vu khống	诋
hung dữ	激烈
Ch	譧
đứa bé	嬰兒
bước nhầm	訧
cuộc bầu cử	選舉
trán	颡
sự bức xạ	輻射
khung	架
Bavaria	巴伐利亚州
Di chuyển và	動與
tương đồng	同调
Quốc gia New Zealand	國紐
Kovski	科夫斯基
Hư hỏng	受損
cỏ	稂
phẫn nộ	恩怨
Linden	椤
Vật đúc	鑄造
Âm	蚦
bình thường hóa	正常化
Đối mặt với	面為
Bản ngã	行列式
vảy cá	痂
Người nào	某人
Giao thừa	跨年
Đồng ý với	贊同
Khoa Luật	法律系
cầu vượt	立交桥
Sự hy sinh	祭祀
Erman	尔曼
Để yên	放任
ngôi trường lớn	大学校
Siri	西里
Một lát sau	後將
câu hinh cung	拱桥
Rời văn phòng	離任
Nie	聂
Ferrari	法拉利
chi nhánh	分會
Làng Đông	東邨
Dày đặc	密布
Công nghiệp và Nông nghiệp	工农业
Lên đường	启程
trong	裏
Yên tĩnh	蛤
Rhine	萊茵
Hướng bắc	北行
Thuộc về bưu điện	郵政
đập	水壩
hiệp ước	條約
Nugget	莝
Sự chinh phục	征伐
Đoàn xe	车组
Cao su	橡皮
kinh sợ	惮
Bảo hiểm	險家
Nô lệ da đen	黑奴
Yuelu	岳麓
nâu vàng	麛
Giáo sĩ	神職人員
Kansai	關西
ngựa	馬匹
Lưu trữ	包含
Anh ta	胪
Mizobe	沟边
Sự công bằng	大法官
Cự li ngắn	短程
Đĩa vàng	金唱片
Kiến thức bản thân	自知
bao gồm	囊括
Dương	泱
Răng nanh	芳
kho chứa	机务段
vằn của một con hổ	虍
Triều đại nhà Tùy	隋代
Trên đường	街上
huyền thoại	傳說
Li	俔
Khó khăn	很難
Đầu tiên	最先
Ủy ban	委员会
Cam Túc	甘肅
rung chuyển	動搖
Cửa hàng tiện dụng	便利店
Tỉnh	尔省
Trung Á	中亞
nách	胳
Toàn bộ quận	全县
tiếng ồn	諠
Nhận được	收
Bộ phận chiến tranh	兵部
Trở về	回報
Nhượng bộ	特許
trang trí	装饰
Juren	舉人
Tiết tấu	處為
Bang	梖
Tách ra	拆分
kinh khủng	惨
tạm thời	臨時
Chơi bóng	打球
chổi	埽
Bao gồm	收錄
Gay	同性戀
Bốn biển	四海
trơn tru	踧
trắng	白色
sự quản lý	管理
ghét	恨
Wan	繓
Ooli	鮞
Bắc Giang	北江
Trói	拴
Gây quỹ	集資
Máu hỗn hợp	混血
Trói	捆绑
hồi phục	光復
Sáu năm	六年
Cây thuốc phiện	罌
cam kết với	承諾
sư tử	狮
Tia sáng	射线
Âm	軎
kết cấu	結構
Sui	濉
Huân luyện viên trưởng	主教练
con bò cạp	鲡
Dọc theo bờ biển	沿岸
Sách giáo khoa	教材
sắc lệnh	詔書
đàm phán	谈判
Weiss	维斯
Totong	都统
Ra tù	出獄
Chăm lo	照料
Biên dịch	编译
kết thúc	结束
hồ nước	湖泊
phía Nam của	以南
Cốc	觚
hủy hoại	燬
Trong thực tế	事实上
chuyển động	運動
cha truyền con nối	世袭
Buổi tiệc	派對
khối đa diện	多面體
Tiếp tục	不斷
Mời vào	进来
Nguồn âm thanh	音源
Chứng chỉ	证件
Cây	楤
sôi lên	疔
nhìn	目光
phóng viên	記者
Dặm vuông	平方英里
bị phá hủy	圮
Trở về	归
Thế giới thứ ba	第三世界
Thời gian	时光
New Zealand	紐西蘭
Jinji Luyu	晋冀鲁豫
tự lập	自製
Đúng	者對
Kyoko	京九
Cũng tại	亦於
Dewey	杜威
họa sĩ	艺术家
Zhongli	中壢
Hải cảng	港湾
cái chùy	锏
vé	票
Mở	開通
sinh vật	生物体
chải	梳
lụa tím	緅
màu tím	紺
roi da	搒
Ý nghĩa	意思
Nông nghiệp	農
Longgang	龙岗
thực hành	实习
Lớp học	阶层
Tháng 11	諾夫
Pio	皮奥
Giả mạo	甿
thực tế	現實
nghiêm khắc	嚴
Sau đó	則會
trang trí	裝飾
Thêm	加的
bệnh tiêu chảy	潟
Tỉnh an huy	安徽省
Boro	博罗
sẽ	将要
lộ ra	揭发
Thủ lĩnh	教主
nguyền rủa	詛
Qiao	嶠
Hạm đội	機隊
Ở Nhật	於日本
Họp mặt thể thao	运动会
Moos	穆斯
Những trạng thái	州县
Biệt đội	小队
Liu Shi	流士
Dưới	下
Guinea	幾內亞
hèn nhát	懦
đặt	擱
Nhặt lên	撿
đầu tư nước ngoài	外资
thuốc uống	毒品
nguyên	原有
phân tán	散射
Chi	炽
Zheng	钲
Tiêu đề	书名
Nam Mỹ	南美洲
Đứng lên	立
Với	设有
Âm	魢
về nguyên tắc	原則
đồng tiền	铸币
viễn thông	電訊
Xông khói	坒
Sự phẫn nộ	愤
bộ trưởng, mục sư	大臣
Đóng trong tầm tay	咫
trong khoảng	左右
Ngoài bộ	系外
Cổ tay	手腕
Tối nay	今宵
Thượng hải	上海
bừa	耰
bế tắc	僵局
Tiếp nhận	接待
đấu tranh	鬥爭
bản nháp	草案
rủi ro	險
sân chơi	運動場
sự phối hợp	组合
Yu	峮
Trung gian	中间
miễn phí	自由
Dựa vào	依托
khổng lồ	龐大
Ye	侔
cày	耩
Trại	營地
Sắp chết	臨終
cuộn	滚
bờ sông	河岸
Súp	羹
theo cách này	如此
mẫu vật	样本
Sôi lên	疠
Mái vòm	圓頂
người Trung Quốc	汉
độ cao	海拔
Trò chơi tại	局於
Điểm tham chiếu	航點
Wei Ji	為紀
khắc	鐫
Dãy núi trung tâm	中央山脈
Sự vụ	事務局
người Pháp	法语
Tính toán	算
Tham gia chính trị	参政
sự phong tỏa	封鎖
độ đàn hồi	彈性
Mới	新設
Yangon	仰光
vu khống	詆
con ếch	青蛙
Còng tay	銬
Năng lượng Hidro	水电
Haimer	海默
tiền vay	貸
Tất cả mọi người	全民
Lân lượt tưng ngươi một	纷纷
Tang Song	唐宋
Witz	维茨
Ban cho	賜予
Jianye	建業
người giúp việc	侍女
diễn viên	投
mức năng lượng	能级
Trả	敉
Tường	墙壁
Hum	呬
Dirk	德克
tiết kiệm	救
Tầm trung	中音
Constantine	君士坦
Bảo hành	保证
tài giỏi	聪明
Áo giáp	装甲
xe tải	貨車
Xuất tinh	暨
đồ cổ	古董
Cơ sở	基層
thẩm phán cấp tỉnh	臬
diệc	鹭
giao tiếp	溝通
Khu phố Tàu	唐人街
Kara	喀喇
Toà thị chính	市府
Đảo	島
Bản nháp	选秀
Nguyên nhân	之故
Album nhạc	音樂專輯
Trưởng sư	大師
tiếng Đức	日耳
đứa trẻ	囝
Dongting	洞庭
Ginza	銀座
kiềm chế cơn giận	眕
đi tiểu	溲
Điều kiện	条款
tinh bột	淀粉
rắc rối	麻烦
Yong	镵
Khó xử	蘯
sau	事後
Trên mặt đất	地上
Azerbaijan	阿塞拜疆
Ủy ban Cải cách và Phát triển	发改委
cuộc sống vĩnh cửu	永生
Chó	獢
Sway	蹅
làm phiền	擾亂
Thu hồi	撤销
Giao dịch mới	新政
con tôm	蝦
Bản sửa đổi	修訂
Quá trình	製程
Giải độc	解毒
lb	磅
Ba giai đoạn	三相
Cánh trái	左翼
Sản xuất hàng loạt	量产
công nhân	工人
Siêu nhân	超人
Quốc tế	国际性
cốt truyện xây dựng	墺
tiết	分泌
nhân viên văn phòng	军官
Tường thuật	敘述
Khara	花剌
Tae	跆
Muridae	鼠科
Sunn	菽
Nhón	掎
thức ăn cho ngựa	秣
tinh thể lỏng	液晶
Mao	懋
Thử nghiệm	审理
Tiệc	飨
Moro	莫洛
Zhengda	正大
Vượt qua	傳球
nỗi buồn	恸
Hanzhong	汉中
sáng	亮
Nhấn mạnh	強調
Giáo xứ	堂區
Không	不可
chào mừng	欢迎
con đường	路径
Tách ra	支隊
Phép tính	計算
máu	衁
Máy bay phản lực	喷气
Noir	輒
Carlo	卡洛
Wei	溈
Shawan	沙灣
Tony	東尼
Li	髎
bắn từ một gốc cây cũ	櫱
Thành phố quảng châu	廣州市
giày	舄
giấy phép	許可證
Ứng cử viên	候選
Súng ngắn	霰彈槍
Chuyển giao	调入
lao động	勞
B.C.	公元前
Chua cay	挞
phong cách Trung Quốc	中式
óc	腦
Tỉnh Long	龙省
Đa phương	多方
Có	有化
Rhine	莱茵
Ma	瑪
Melbourne	墨尔本
ghế	座
Bán	賣出
dữ dội	剧烈
Chọn một quả sữa trứng	選庶吉士
Chính quyền quận	县政府
Soth	索斯
Xăm hình	饻
Viết thư cho	寫給
Ba Tư	波斯
duyên hải	海岸
lịch	历
tư thế	姿
Căn cứ	基数
Gens	更斯
từ thời cổ đại	自古
Spa	斯巴
nghe	听取
Viện nghiên cứu	研究院
mùa mưa	雨季
đùi	髀
độc nhất	独特
Jialing	嘉陵
một nhỏ	一個小
Huashan	華山
Hàng trăm	上百
King Wen	文王
máy trạm	工作站
Phố núi	山市
viêm gan	肝炎
phân cực	极性
Song Renzong	宋仁宗
Vách ngăn	分区
Phỏng vấn	訪談
Nhận vào	入學
Con mèo	獑
Xi	曦
Khu vực đặc biệt	專區
đá hoa cương	花岗岩
Gyatso	嘉措
Giai thoại	逸事
chủ nhật	周日
Ling	媻
Nhiều	多項
Cứu hộ	救助
Truyền cảm hứng	鼓舞
Tường thành	城墙
cẩn thận	仔细
Hàng rào	围墙
Bộ Trưởng Bộ Ngoại Giao	外交部长
áo giáp	鎧
Shan	龂
hội thoại	對話
Zhao	曌
Hoffman	霍夫曼
dẫn đến	招致
Denny	丁尼
Toledo	托莱多
chặt	斫
Được liệt kê là	列為
tu viện	修道院
một mình	单独
Họ sẽ	牠們會
Dốt	昧
cá nhân	个别
Tan	曇
tùy nghi	酌
Khó xử	狽
Polly	波利
Thử	逞
một lần	一度
tối	闇
Giáo lý	主義
Thiểm	陝
Nhọn	有指
hầm	窨
opera	歌剧院
Chín hai	九二
Lớp thứ hai	二甲
Thờ cúng	參拜
Hakka	客語
Dự luật	命題
đường dài	長途
bóng nước	水球
Nguyên nhân	致使
Reuters	路透
Làm hòa	言和
Sự phosphoryl hóa	磷酸化
cây thông	喬木
lương chính thức	糈
mọi nơi	到處
Dấu vết	微量
gửi	寄
Yu	妺
Dệt	編成
Động cơ	电机
biến thể	變種
Sau	後以
ngoại giao	外交
Aragorn	亞拉岡
Jing là	經是
Năm dài	長年
chiến lược	戰略
âm lượng	体积
ghẻ	疥
Gà trống	胩
quạt	煽
lỗi	誤
rồng	虯
Eti	艾蒂
ngưng tụ	缩合
sự vội vàng	勷
Đối với Xing	為興
Shan	鯱
khá	颇
mua	购买
Nawate	畷
Jiu Long Tang	九龍塘
Khóa	齙
Cheng	丩
Di chuyển và hợp nhất	動並
đặt	摆
Chiên	煎
Kinh nghiệm	心得
Âm	阤
Phòng Đảng	黨部
Tin tức	新闻
Bị nghẹt mũi	脷
Maryland	马里兰
Khác với	别于
Cây thì là	耵
tâm lý	心理
Phong bì	分封
Biến cố	事發
Bậc thầy	當家
giải cứu	解救
Kéo dài	佇
Giáo viên cho	師為
thói quen	習慣
Yuxiang	玉祥
thiếu sót	缺
Giải vô địch thế giới	世锦赛
Haute-Marne	上马恩省
Thẩm quyền	職權
nỗi buồn	慟
Quyền lực Nhà nước	國電
Dép xăng đan	屦
dap xe	騎
Quay lại	折返
thân thiện	友善
Neptunium	镎
Lực lượng sản xuất	生產力
bịp bợm	巃
Winge	温哥
Xuân	諿
Ngốc nghếch	枆
Xin'an	新安
Yun	郚
chim cun cút	鶉
km	粁
cứu trợ	解脫
bao kiếm	鞞
Phân họ	亚科
khắc đá	石雕
vật	物體
Hara	哈拉
Rein	繮
Đánh	安打
Dòng điện xoay chiều	交流电
ổn định	稳定
Ashton	阿士東
Nian	拹
bảo tồn	饯
Liều lượng	用量
Sân trong bí mật	密院
Fuji	不二
đồng tính luyến ái	同性
Gia đình giàu có	富家
Học viện khoa học	科学院
Lạch nhỏ	澥
kiện cáo	官司
bát	杅
áo choàng	帔
Vic	维克
Máy chơi game	遊戲機
sửa	葺
Lưỡng cực	两极
Sôi lên	擆
Sóc	蝪
Sơn	作畫
khoáng sản	矿产
lịch Trung Quốc	中國歷
Căn cứ	大本营
hộ chiếu	簽證
sức mạnh khổng lồ	屭
Rick	瑞克
Seville	塞维利亚
Năm thời gian	时年
Chạy	犇
Robin	鴝
Tuân thủ	遵從
xe hơi	車
Phương trình vi phân	微分方程
Sơn	繪
Yelu	耶律
kết luận	締結
Mặt trận thống nhất	统一战线
Hai chiều	雙向
Tiao	沞
Li	黎
Sau khi tốt nghiệp	毕业后
cái nút	鈕
Sol	索尔
Khu mục vụ	牧區
Hàng đầu	頂級
vui mừng	高兴
Phê chuẩn	处分
Cả hai với	都與
Từ	来自于
Ao	翱
Pao	捣
Chen's	陈氏
Ho	穂
Sự vụ	事務
lông thú	裘
chiếm đóng	占领
xung quanh	周围
Madrid	馬德里
Công thức cố định	定式
tàu tuần dương	巡洋舰
đặc tính	特征
Một góc	一角
Âm	黇
lượt xem	景色
con chuột túi	袋鼠
Ở đằng trước	前朝
Galliman	加里曼
Nokia	诺基亚
Yongfu	永福
Dinh thự	府第
Không vui	恴
chịu	承受
Fen	汻
Giết chết	擊殺
Ye	賙
Đảng và chính phủ	党政
Giết chết	殺傷
Bang	旍
Guam	關島
Bàn đạp	腳踏
Và khi	與當
Phiền muộn	蕭條
Kẻ cướp	剿匪
Uzi	烏茲
Mexico	墨西哥
Kim giờ	時針
Xu hướng tư tưởng	思潮
Luật học	法理
Xem	看著
Bướng bỉnh	壄
Chết	遇难
Cuộc đình công	絕食
Duyên dáng	颋
lớn lên	壮大
Nó cũng	這也
cầu trượt	滑落
Âm	缒
nâu	棕色
Đầu tiên	首先
Người Đài Loan	台灣人
Như Lai	如來藏
ý kiến	见解
Trái đất	土
Ôn	雯
Sự trừng phạt	處罰
Jiahe	嘉禾
nheo mắt	眯
găng tay	手套
thở dài	嗟
Bị giết	罹難
Kéo đi	拉开
Gù	烕
Danh sách	列表
Tiếng Uzbek	乌兹别
Không bắt buộc	為選
Sang trọng	奢侈品
Đảng xã hội chủ nghĩa	社会党
Hu	縦
Người da trắng	白人
Nhiều hơn và nhiều hơn nữa	越来越
bản văn	正文
Đảng đầu tiên của mọi người	親民黨
Pru	普鲁
Quan	铨
Đã đến	傳來
chi nhánh	枝
vui mừng	高興
Đề cương	大纲
rau bina	菠
Dũng cảm	大膽
ra đa	雷達
Mitsubishi	三菱
Gương	镜像
Haihe	海河
trận đánh	戰鬥
Quan thoại	国语
tổ	築巢
Texas	德克薩斯
Nhầm lẫn	讘
bộ trưởng, mục sư	部長
Sàn nhà	层
Singapore	新加坡
Tài chính	財經
đệm	緩衝
Va cho	並為
Nantong	南通
chuyến bay	航班
Des	得斯
người chồng	夫
Đảo Đông	島東
Cá	鳿
ngón tay cái	拇
Trò chơi duy nhất	單場
Ender	恩德
Chiến công quân sự	战功
Miêu tả	描繪
Kiêu ngạo	詣
xem	看到
Một chi	一屬
Min	闵
Giao lộ	交界处
Bismarck	俾斯麦
Di chuyển	為動
khe	壑
nhân viên	人员
Ima	伊玛
Hakone	箱根
Cũ	耋
Công trình công cộng	工務
Yu	朥
Cochin	交趾
Áo choàng ngoài	袇
Đại học tư thục	私立大學
trả lại	償還
Khác 0	非零
curium	锔
Hoàng đế	皇
Chengguan	城关
Ye	燁
Lá số tử vi	占星
kè	堤防
Giữ chức vụ	任職
Đường dây trực tiếp	直系
Atlanta	亞特蘭
xoắn	绞
Lá giữa	中葉
Bán cho	賣給
âm dương	阴
thân thiện	友好
đề nghị	提议
Jianying	剑英
Ke	轲
thuật bói toán	珓
cố gắng	试图
Bề mặt cong	曲面
Vị trí là	位置為
Timothy	提摩
trận đánh	战斗
Xiang	芗
Solon	索倫
Chủng viện	神學院
che	掩护
Đốm đen	黑斑
táo	苹
Sán Đầu	汕头
Đã xác nhận	確診
Salo	萨罗
âm nhạc	音乐剧
Hợp tác	協同
khắp	各處
niobium	鈮
không kiên quyết	徘
Quận He	賀縣
cấp độ	層次
Sự công bằng	正义
loạng choạng	交錯
thô	粗暴
ảnh chụp	照相
Nhóm nhỏ	小群
ở ngoài	外面
tóc đen rậm	鬒
Tường	壁
Kỷ Phấn trắng	堊紀
kết lại	揫
Chắc chắn xảy ra	不可避免
Quạt	璠
Cuộc họp	該會
Kéo dài	伫
nồi nấu kim loại	堝
Mặt trăng	月球
hạm đội	船隊
Tong	漼
tim	內心
điện trường	電場
Làng	砦
chim cánh cụt	企鵝
Li	槥
Và đất nước	及國
Sông Jialing	嘉陵江
Tp.	州市
Phượng Hoàng	凤凰
công việc nội bộ	内政
ngôi đền	鬢
John	约翰
Bỏ lỡ	未及
Nhân viên văn phòng	幹事
Kiev	基輔
Mới Hampshire	新罕布什
Longtan	龙潭
Chuyên nghiệp	業家
Ngắn hơn	較短
Vón cục	丛
Phản cách mạng	反革命
mô hình	模型
lá thư	信件
không nhận ra	惝
Bóng chày	蛳
bù lại	抵消
Thành phố Thái Nguyên	太原市
Pule	普莱
Chạy vào	碰上
Của	的屬
Khi đứng	站時
khí tượng	气象
Què	阸
Nhớ lại	記
Sức mạnh	力度
Quận	特郡
Siya	西雅
Trụ sở chính	總部設
Vẽ tranh	沊
Bướng bỉnh	輄
Người ăn	食者
khắp thế giới	世界性
Than van	廄
nghịch đảo	逆
Khí đạo	航路
người lao động	靸
Jiang Zhongzheng	蔣中正
Hui	珹
Bốn mặt trận	四方面军
chính xác	纠
Liếm	利克
dự trữ	后备
Wude	武德
Nhỏ	小型
trên toàn thế giới	全世界
Xe đua	賽車
đánh	擊中
Batty	巴蒂
Zichan	子产
Sự công bằng	公道
Tên	名义
tải	裝載
Anh chị em họ	堂弟
Kaiser	凯瑟
Con rùa	鳑
Cung và tên	弓箭
đáng kể	可觀
Pháo đài	斯堡
Đáng tin cậy	可信
Người Croatia	克族
gần đây	近來
Maiga	買加
lò phản ứng	反应堆
vội vàng	匆
Shan Tou	汕头市
lúa mì	小麥
trưởng thành	成熟
cái sau	后者
Tham dự	参
Theo sát	后续
Jesus	耶穌
Eocen	始新世
chit Chat	嗹
Âm	玀
Chủ nghĩa dân tộc	民族主义
Zhao Guo	趙國
Có động cơ	摩托化
Jiao	譌
Cử nhân	學士
đường phố	街頭
Chiên	炸
Thở dài	儑
Mian	沔
Xoay	昖
Geller	格勒
Quà tặng	赠
Số ba	三個
Sienna	譝
ống sáo	龠
nội bộ	内部
Soạn thảo	起草
Tải về	装
Khu vực thành thị	市區
Hai ngôi nhà	两院
Mập	膣
Yu	簀
Chế độ phong kiến	封建制度
âm dương	陰陽
Nhập ngũ	參軍
Yêu cầu giúp đỡ	求助
Mảnh vỡ	碎片
Mingde	明德
ghen tuông	妬
Si	鷩
Xô	漵
Hu	艿
Liberty Times	自由時報
trái cây	果
ranh mãnh	诡
Tiêu	斥資
Lỗ hổng	隙
Hú	啸
nếu không thì	否则
Zhao	肇
Acrylic	丙烯
gà con	鶵
Cơ học	力學
Ụt	蒬
con đom đóm	萤
Thám hiểm	远征军
chồi non	萌芽
Kích nổ	引爆
Kiềm chế	制性
phía sau	背後
khác giới	異性
giá bán	價錢
Yu	妤
Phần bổ sung	增补
trừu tượng	抽象
Nguồn cung cấp	物资
Thuế	稅
nhẫn	環狀
không gian	篇幅
Ozo	大藏
Chai	箾
ủng hộ	擁護
Xe cộ	輛
Giáo viên	师资
uống nhiều	酺
Đặc biệt	特輯
quân đội	军用
Dũng cảm	粗體
Bắt buộc	强制
gặp	遇見
tranh luận	争论
thời gian thực	实时
hoàng thổ	黄土
Nghi can	疑犯
Đến và đi	來越
xã hội	群居
Lĩnh Nam	嶺南
sỏi	石头
Đạo sĩ	道主
Vu khống	诇
cảnh sát	警方
Serbia	塞尔维亚
tiếng nói	呼声
Grate	鯦
Trường đại học bình thường	师范学院
Chữa khỏi	治病
Lou và	樓及
Mach lẻo	八卦
Rơi vào	落於
Sumata	苏门答
Đồng hồ đeo tay	手錶
Ling	廞
đồ sứ	瓷
Queer	侫
đầy đủ	充足
Dự trữ	蕴藏量
Nhà câu lạc bộ	会所
Saki	埼
Chỉ với	僅以
Stilbene	芪
hàng hóa	商品
Mờ nhạt	満
cách phát âm	发音
Thành lập	成立
Leizhou	雷州
người độc thân	單打
Chúng tôi	顷
sự căng thẳng, quá tải	應變
sáng sớm	清晨
Nat	纳特
Di cảo tên	諡號
Nicea	尼西亚
kilomet vuông	平方千米
Bang / quận	州区
Nghiên cứu	调研
Peru	秘鲁
kinh doanh	商业
vắt kiệt	挤
Shau	沙烏
đánh bắt cá	釣魚
Nơi ở ban đầu	原住
đặt	襬
giỏ để căng thẳng	篘
Lawrence	羅倫斯
Phút	分
chải	拂
Laiwu	莱芜
Ho	浩
chung	聯合
Đừng	別為
Nha khoa	牙科
Rừng lá rộng	阔叶林
pao	镑
vui mừng	快乐
Đẹp	尼斯
Nhón	搫
Khu vực đặc biệt	专区
Fen	葨
Viện kiểm sát	察院
cảm tạ	感謝
Tàu	號艦
Ming	暚
Usher vào	迎来
Ủy ban bầu cử	選委
Công ty con	子公司
Mở kinh	開經
bàn luận	討論
Zhili	直隶
Đứng lên	矗立
riêng tư	私营
Cung hoàng đạo	黄道
Ăn	進食
đồng vị	同位素
Genghis	成吉思
Con đường Tơ Lụa	丝绸之路
Khác thường	反常
Sau đó	此后
đôi pho vơi	处理
Herman	赫尔曼
thoát ra	竭
Gấu lớn	大熊
Lũ lụt	水患
tuyệt vọng	绝望
chỉ	曬
Phong sơn	鳳山
Tự vệ	自衛
bí mật	秘
nổi bật	卓著
nghiệp dư	业余
Nơi cố định	定地
chuyến đi	绊
nhàn rỗi	閒
Knock xuống	推倒
cài đặt	安装
Cuộc thi	賽項
Rong	镕
phi tiêu	镖
Quan thoại	文華
Câu lạc bộ thanh niên	青年会
Sau đó	隨後
cây cung	弓
Li	苈
Neville	内维尔
lời nói	名言
Được	获
Với	帶有
Văn Miếu Quốc Tử Giám	文庙
Sau	后以
Inch	英吋
Kiên quyết	堅決
Taint	膢
cửa sông	江口
Xinh đẹp	葊
thờ cúng	崇
Thích	喜好
hợp lý	有理
Pang	厖
Dân thường	老百姓
trận chung kết	決賽
Hutu	呼图
Bắc Triều Tiên	朝鲜
mỡ lợn	腯
Ôn Châu	温州
Yak	犛
Jing	兢
Sri Lanka	斯里兰卡
Cho chết	賜死
tiếng nói	呼聲
Sông nội địa	内河
Áo-Hung	奧匈
Độ dài dòng	線長
Papua	巴布亚
Áo choàng ngoài	褄
Đội	隊伍
Một số	數個
Chi	篪
vu khống	讒
Thời gian	時許
Li Zongren	李宗仁
Tiến lên	常见于
Có liên quan	相关
Hoạt động	運作
Tàn phá	讁
chung	關節
Bangladesh	孟加拉国
rò rỉ	泄漏
Xâm lược	侵入
ngày kỷ niệm	週年
Nhạc trưởng	导体
cung điện	宮殿
Sarah	莎拉
sự phá thai	流產
bộ lọc	筛选
Phòng bí mật	密室
săn mùa thu	獀
kỳ thi tuyển sinh đại học	高考
Một thành viên	一員
Người dân địa phương	当地人
vật chất	材料
thủ môn	守门员
Gujarat	古吉拉特
Cannonball	炮弹
tài sản	資產
học thuyết	教義
Tang	骦
Bộ phận vận tải	運輸署
chất lượng	质
Chiến tranh chống Nhật	抗日战争
Tuyển dụng	招聘
Ấm áp	曖
Ngoại quốc	外族
Hera	赫拉
điếc	聵
Tăng	加大
Chuyển đến	遷入
truyền hình nhiều tập	電視劇
Cháu trai	長孫
Miếng	顆
Sâu	蝐
Lankai	蘭開
trưởng nhóm	隊長
Yo	喲
danh hiệu di cảo	諡
Thoát khỏi cái nóng	避暑
lo	担心
Do Thái	猶太
Xianbei	鲜卑
Gõ cửa	磿
Metyl este	甲酯
mười ngày	旬
công viên quốc gia	國家公園
Yên nghỉ	刳
Canthus	眥
động cơ diesel	柴油机
cực kỳ	超
tóm lược	精準
ủng hộ	支撐
Yi	伻
nghị sĩ quốc hội	眾議員
Tình nhân	戀人
xẻng	锹
sự sụp đổ	塌
Đọc lướt	撇
Thiên kiến	偏向
dinh dưỡng	营养
con sông	河川
Sơn	作画
hầu hết	幾乎
Triều đại Tây Chu	西周
giống cái	女性
thối rữa	烂
Cincinnati	辛辛那
Bụng	腩
người chết	死者
Yev	耶夫
Nhằm mục đích để	旨在
Chơi một trò chơi	打比賽
Carthage	迦太基
gì	啊
Mary	瑪利
Alai	阿莱
Cisse	西塞
Caspian	里海
bỏ trốn	逃生
thuần hóa	馴
Dính máu	血性
Đông Âu	東歐
Sự đối xử	疗
Đấu tay đôi	對決
nữ hoàng	女王
Biệt thự	比利亚
Chất ức chế	抑制剂
Cá chim	鰈
Giới thiệu	推介
Toba	托巴
Đóng cọc	摞
Trứng	埃格
Cho ăn	供彈
thành phần	组成部分
theo nghĩa đen	字面
vong linh	本影
bộ	鑲
Tỉnh thanh hải	青海省
thử nghiệm	审讯
tránh xa	逃离
Xấu	蹧
cấp độ	级
ngủ ngon	寐
Ming Chuan	銘傳
Treo	纮
nhát gan	孱
Ping	乒
Bộ Công nghiệp	工业部
khoe khoang	誇
Huanxuan	桓玄
biển phía đông Trung Quốc	東海
Linh hồn	魂
mơ	夢幻
Bắn	射杀
Lá cây	叶子
Sa thải	免职
Chú ý	矚目
Hán Khẩu	汉口
Reel	缫
âm thanh	聲響
sinh tử	凡人
gần như-	准
Vẽ tranh	汲取
Thua	失
Phát triển, xây dựng	開展
Doujin	同人
Tiêu cực	反面
cá đối	鲻
tháng	月
săn bắn	猎
viện bảo tàng	博物馆
dựa theo	據
đàn áp	壓制
bộ trưởng, mục sư	部长
Cứng đầu	石首
Fulan	富蘭
Đổ	澆
Thay đổi sau	後改
lung lay	荡
Một có	一個有
trai	蚌
Beech	櫸
Ngôn ngữ cử chỉ	手語
độc nhất	獨特
Đo lường	计量
nếu	假若
Yan	剺
rình rập	稈
Giá trị gia tăng	增加值
Khai mạc	开场
antimon	锑
thụ động	被動
Người ngoài hành tinh	异形
gậy	棍
Cả hai	兼有
Thời gian xây dựng	工期
Chiết giang	浙
Mục tiêu	进球
Đường sắt	鐵路線
Chia	劃分
gia tộc hoàng gia	宗室
kháng cự	抵制
Jian	澗
Công việc bán thời gian	打工
Mới	新
Hàng đầu	巔
Tian	闘
Tut	嘖
Hạt Sen	森縣
bệnh kiết lỵ	痢
Ngôn ngữ lập trình	编程语言
ghét	瘅
đi lại	徜
Giữa	介乎
Đường lớn	大路
Toyota	丰田
tình nhân	姘
Hoa và trái cây	花果
thuê	賃
Bang	擗
Gọi là	称为
Âm	饉
Shipborne	艦載
mang	鰓
Báo chí	報社
Tổng cục Hậu cần	总后勤部
Kinh dị	驚悚
mở mắt ra	睁
nhân đạo	人道
rắc rối	憒
Sân khấu âm nhạc	樂壇
Những người này	这些
Taupe	灰褐色
Chiếm lấy	擷
Vỏ	殼類
Đường giữa	中線
Baisha	白沙
Sơn	涂
Nổi tiếng	周知
Thành phố Brook	溪市
Cuộc thi	角逐
Láng giềng đông	東鄰
Jian	蘽
Ming	扺
Que	鴙
Quân đội Liên Xô	苏军
kẻ xâm lược	侵略者
Thu phí	收费
Vợ lẽ	妻妾
Nhọn	犀利
Nhưng	乃是
Yang Zhen	阳镇
Nhà nước	该州
Chuyển đến	移入
Tạm biệt	掰
Ergan	爾幹
thợ rèn	斯密
trình độ	度
Địa điểm	场地
Kế tiếp	下議
Kiềm chế	敛
Siha	西哈
Bốn đội quân	四军
Xi	顚
Đối lập	對黨
lượng mưa	沉淀
số nguyên tố	質數
Bệnh dịch	流行病
Có một	哈薩
nước Anh	英格蘭
Phân tích	析
Tiếng Slavic	斯拉夫
hoa hướng dương	葵
Thủ môn	守门
quân đội	陆军
Shan	珊
Khỏe mạnh	健
Jinshi	进士
Puy de Dôme	多姆山省
chim ác là	鵲
hội đồng	议局
Kích hoạt	启用
nhật thực	日食
Rìa	飂
làn da	肤
Yanshan	燕山
cắt cổ họng	刎
Ren	価
Huh	唣
Khi nó kết thúc	結束時
thủ đô	資本
Ở trong trường	留校
Một lát sau	後會
Nhiếp ảnh gia	摄影师
Đã xuất hiện	經出現
Chúng tôi sẽ	們會
Thiết bị đầu cuối	终点站
nhấn	摁
hôi	臭
con thằn lằn	蜥蜴
Hẹn dài	長約
nhổ lông	搊
con mồi	猎物
Là	被
Axit amin	氨基酸
Chi	驰
Quyết tâm	懾
Điểm	要點
Yu Shi	於世
Khởi xướng	发起
Nick	尼克
Tế Nam	济南
Phân biệt đối xử	歧視
Sau nguyên nhân	後因
Lo lắng	惦
chăn nuôi	家畜
lấy	挐
Xanh hóa	綠化
ở gần	迩
Emma	埃马
Ăn cướp	劫
qua nối chồng	重叠
Có thật không	真的
nhiều lần	屡次
thang	梯
Khó xử	怊
Ngành kiến ​​trúc	架构
bánh trứng	吉士
Dài	茮
kết thúc	终
Thế kỷ sau	世紀後
Tiếng ba tư	波斯人
bạch kim	鉑
đặt	擺
Tính cách	字元
Trục	轉軸
William II	威廉二世
Fengyuan	豐原
phát biểu	演说
Ba độ	三度
Người thực	真人
Hai dòng	兩線
chán	劖
dừng lại	罢
biển sâu	深海
Dia	迪亞
ôm hôn	擁抱
Xác tàu	失事
Nghịch ngợm	佮
Năm nay	本年
Edward	爱德华
hoàng hôn	黃昏
Thông thoáng	晳
Simon	西蒙
Thẩm phán quận	縣知縣
săn bắn	狩獵
Máy quay video	影機
thành nội	敕
lông thú	皮毛
rừng	树林
Hầu hết	多為
Beacon	僽
Peng	胊
Lịch sử hiện đại	近代史
Sox đỏ	紅襪
mua chuộc	賂
lão Tử	老子
chứng điên cuồng	蠱
Laohan	老山
mặn	咸
đặt hàng trước	預購
Bộ nội vụ	务部
PV	報員
hữu nghị	交情
Háu ăn	餖
Phiến quân	义军
nhân nhượng	安抚
hệ thống	系统
Hai ngày	二日
rang	炰
Lúa mạch	栍
Oh	奥
Andel	安德尔
ủng hộ	养
Ori	奥里
hàng xóm	鄰居
Làm kinh doanh	经商
nhanh nhẹn	遫
Ga Shinjuku	新宿站
Bị đánh bại	兵敗
Nhấn giữ	捺
gói hàng	包装
Thương tiếc	悼念
vội vàng	怱
ôn tập	回顾
Huang Tai Chi	皇太极
Hoàng	柹
sự hối tiếc	懊
cao	颀
Tổng dân số	总人口
từ chức	辭職
Thế giới quan	世界观
Yao	堯
Thứ hai	其二
Kiệt sức	尽
thổ ngữ	方言
Từ	来源于
gạch chéo	剸
chống lại	针对
Epiphysis	骺
Đứng lên	立者
Ding Chou	丁丑
Blog	博客
Vô cùng	極為
Lịch sử nhà Minh	明史
cô	婶
thị trưởng	市長
Salvador	萨尔瓦多
Điều khoản khác	杂
Bắc Tân Cương	北疆
Quay lại	回回
Phần cứng	硬體
Phòng giao dịch	務局
Tiếng Mã Lai	马来人
Hình ảnh	形象
xoay	繙
Gia Cát Lượng	諸葛亮
Chắc chắn	坚固
Jerusalem	耶路撒
Địa ốc	房产
Kai	闓
Lei	瞾
Trung tâm	中部
Hãy yên lặng	安静
trắng	皚
tiền bạc	钱
thị trấn	镇区
bạo kích	危急
Erich	埃里希
ve sầu	蟪
nhà tù	獄
sự trả thù	報仇
Bản địa hóa	地化
nghẹt mũi	鼽
Margaret	玛格丽特
Xương đùi	股骨
lộ trình	航線
xoay	輪流
Đã kết nối	相連
Maria	马里亚
Quốc tịch Đồng	侗族
Rong	珫
Nửa cuối năm	下半年
Ai	艾
Máy nhuộm	代尔
Litz	利茨
khuyên nhủ	勸
Xi	羲
trường đại học	大学
nói	说话