Túp lều	庐
Công chiếu	首播
Stuttgart	斯图加特
Metanol	甲醇
Vân Nam	云南
con chuồn chuồn	蜻
Cắt	掆
Đặc biệt	特派
Aisha	愛沙
Điều hành	經營
El	埃尔
Trường học	該學
Coronal	冠状
khuyên can	勸阻
nhiều hơn	多於
Vĩnh Châu	永州
Chúng sinh	眾生
Houston	休斯顿
sứ mệnh	使命
nửa trên	上半
Măng	筍
Cà kheo	錋
Wu Guo	吳國
Đưa vào sản xuất	投产
Xấu hổ	祋
Bực mình	忼
Hamamatsu	濱松
Dài	臾
Tính cách	品格
tận thế	天启
Doss	多斯
ngã trở lại	倒退
Ánh sao	星光
sự giải trí	娛樂
Quốc tịch Hán	漢族
tháng	月份
Hệ thống trường học	學制
Đầm	达姆
con rối	傀儡
Phép tính	运算
Năm và	年與
Một ngày nào đó	某天
Dàn nhạc	乐团
huy hiệu	徽章
Khuôn mặt	面部
Cấp độ đầu tiên	一级
tia laze	激光
Geelong	吉隆
Máy số	號機
yên tĩnh và thanh lịch	窕
sao chổi	彗星
Thầy tu	司鐸
Theo	跟著
có	具备
Hấp	腄
Sanli	三立
Dan	鄲
nitơ	氮
Lợi thế địa lý	地利
Người lái xe	驾驶员
Li	灕
tà ác	邪恶
Học	求学
Yi	斿
Út	幼子
Điên	諄
Apollo	阿波罗
Các ngôi sao	顆星
Dingzhe	定讞
Yun	駃
kẻ phản bội	叛徒
Nam Cực	南极
Xóa đơn hàng	明令
hình phạt	罰球
Qishan	岐山
Thống đốc	布政
bọng đái	膀
Lubin	律賓
Ra mắt	亮相
Kang	康
Arashi	岚
hấp dẫn	有趣
Lịch sử	年史
Hae	獬
Gà lôi	鷴
Chung	将軍
Zurich	蘇黎
thực đơn	菜单
Khói	烟雾
đọc thuộc lòng	诵
khí ga	氣
hồi sinh	复活
hàng tuần	周刊
YoY	同比
Gói phần mềm	软件包
Chưa từng có	空前
giữ nhanh	堅守
Băng qua	渡
Lara	拉拉
Giá trị là	值為
Một phe	一派
Đường sông	河道
thực hiện	執行
giao diện	介面
Thoái hóa	退化
nguyên	原作
Quân đội sẵn sàng	願軍
viết	著述
chỗ trống	空白
vây ngực	胸鰭
Tang	枼
chất bẩn	濊
Người Venice	委內
Zengcheng	增城
Tổng diện tích	总面积
Đường sắt cao tốc	高铁
thành thạo	精通
Nhảy vọt	闰
Sẽ	維爾
Vie	维耶
Triều đại mới	新朝
chuyên dụng	專用
có thật không	實在
Thành thị và nông thôn	城鄉
Sáng	鲜明
Người xem	观者
thông thoáng	晴
Tu sĩ dòng Tên	耶稣会
nghị viện	議會
Bắt	抓到
Hideyoshi	秀吉
Nhắc lại	催
Qi	乁
bắn pháo hoa	煙花
chơi	戯
Tên	指名
Biến cố	事发
hình trụ	气缸
Đến	到
Người kế vị	后继
Điểm sôi	沸点
bắt nguồn từ	源自於
Thị trưởng	迈尔
Leman	莱蒙
triển khai	部署
Sức khỏe	衛生
Đô đốc	上将
cầu	桥梁
đại học Cambridge	剑桥大学
thai nhi	胎儿
Đường may	縫
Lu	銙
Kính trọng	推崇
Quận Nam	南縣
Quán tính	聲勢
Nhà lý thuyết	理论家
bên ngoài	外
Disraeli	迪斯雷利
Hạt Ning	寧縣
Lợi thế	優勢
Kot	科特
Heller	赫勒
Valen	瓦伦
món thịt	肴
Quan chức	僚
ôi thiu	馊
Pháp luật	法上
cái gối	枕
Wu	吳
Actinium	锕
nơi ở	下落
Hơn hai	過兩
Giành được	荣获
Cứu tinh	救世主
sao băng	流星
Texas	德克萨斯
Ngôi mộ cổ	古墓
Số Pi	逈
Chiến tranh giữa các vì sao	星際大戰
Giữ bí mật	保密
bàn thờ	罎
Hình nón	锥形
Trận chiến	战役
Án Lệnh	谕
Hai mươi	廿
sắp xếp	排列
Bộ giáo dục	教育局
Và phía Tây	與西
tuyệt đối	绝对
Lúc bắt đầu	当初
Tiếp xúc	來往
lính	軍人
điều khiển	統制
Liaoxi	辽西
Can đảm	勇
Bởi	所著
Miha	米哈
con bò cạp	鉲
Bắc Ireland	北爱尔兰
vận chuyển nhẹ	轺
Tường thuật	叙述
bàn là	铁
chàng	佬
năm	岁月
món thịt	餚
Junggar	准噶尔
Cướp biển	鷨
đồ chơi	玩具
Sự cứu rỗi	救贖
Chấp nhận	接纳
Đầu hàng	臣服
phía tây	西邻
Desuke	德輔
Claas	克拉斯
lưu huỳnh	硫磺
ký tên	签署
Trường y tế	醫學院
Đánh đập	捸
Dang	碭
Shao	皞
Ngõ	小巷
Khen ngợi	赞扬
Di sản	沿袭
Ăn được	可食用
riêng tư	私有
Lớp học	上課
Bão nhiệt đới nghiêm trọng	強烈熱帶風暴
chính xác	恰好
bảo đảm	确保
Macedonia	马其顿
Lausanne	洛桑
Japonica	粳
em gái	姐姐
lấp đầy	闐
số không	零
Tàu	航艦
Ủy ban Trung ương Đảng Cộng sản Trung Quốc	中共中央
Ngũ giác	五角
Xu hướng	主流
Chỉ	俹
tiếng cười lớn	噱
giết chết	杀害
Xin	歆
Có lông	褞
Đường đó	那樣
Vào thành phố	入城
Lorida	羅里達
nâu	棕
Huân	鄗
cây bụi	灌木
Quân đội	軍部
Dương tử	长江
Đảng dân chủ	民主黨
golf	高爾夫球
Cuộc tranh cãi	訌
boron	硼
Tan chảy	溶
Anhe	安和
phi	拋
Bướng bỉnh	窋
Xin lỗi	致歉
Khi đến thăm	訪問時
Sự hỗn loạn	沌
Người theo dõi	隨者
Nanzhao	南诏
Chu	栆
quyền lực	冪
Solomon	所羅門
Tám tám	八八
lưỡi liềm	鐮刀
Blanc	勃朗
chia sẻ	共享
Đường núi	山道
Tên đã dịch	译名
Chia	分之
David	大卫
Xinze	新泽
Gram	尅
Va cho	併為
Hồi ký	憶錄
tập thể dục	演習
chổi	笤
ngoại quốc	外來
Hoạt động	运作
muộn	晚
Trong tro choi	賽中
Học viện khoa học	科院
Jinsui	晋绥
Vũ	武夷
vu khống	誹
Bộ sưu tập sách	藏書
Chết	辭世
Vermont	佛蒙特州
bản hòa tấu	协奏曲
Tốc độ chung	普速
Zan	昝
Tuyệt chủng	絕種
bầu không khí nặng nề	氲
kế toán	會計
Đài truyền hình Châu Á	亞洲電視
tiền tệ	貨幣
Sui	睃
kiệt sức	惫
Pseudo	伪
Với Zhang	與張
nhẹ	溫和
Zheng Xiuwen	鄭秀文
Sẽ đi đến	會向
Fudan	复旦
Bạn	伱
phi cơ	飛機
Cây bách	栢
Jida	積達
Trại giam	看守所
ích kỷ	自私
kết nối	聯絡
mạnh	濃厚
Di dời	迁居
chim	鸟
dải Ngân Hà	银河系
thuê	租
trạm không gian	空间站
Bảng	登
Gốc	出身
nhóm	团
Đàn áp	鎮壓
Tấn công và phòng thủ	攻防
Đường Sơn	唐山市
Biểu tượng	符号
Can đảm	勇者
Tennessee	田纳西州
cốt lõi	芯
Kỳ nghỉ	度假
Nán lại	萦
Shau ​​Kei	筲箕
Kỉ niệm	憶體
cùng với	隨着
quan niệm nghệ thuật	意境
Shino	筱
Ly thân	分居
điều hành	操作
rồng Vàng	金龙
Khu kinh doanh	商圈
tiếp xúc	联系
sự tập trung	濃度
MacLehose	麥理浩
Thấy trước	預
Ngớ ngẩn	俽
Lụa	綃
Nhảy	踿
UV	紫外
sống động	生動
Bốn điểm	四分
động từ	动词
Trực tiếp điều hành bởi	直轄
hài lòng	宜人
má	颊
Hỗ trợ	輔助
Wei	葳
Sự phục hồi	复辟
Được xây dựng trong	內設
Cây bụi	灌丛
Hu	溒
tên khoa học	学名
Âu Á	歐亞
Brunei	文莱
Baltimore	巴爾的摩
Xây dựng	構築
Carl	卡爾
Moses	摩西
Đạo diễn phim	電影導演
Zi	淄
ngọn lửa	燄
mẹ	母
làm mẫu	造型
Naphthalene	萘
ngấu nghiến	吞食
Chủ tịch	理事长
Yêu thích	收藏
mộc mạc	鄙
thủy triều thấp	低潮
Sa	飒
Benji	本纪
Hạt Kim Môn	金門縣
Qian	騫
một lát sau	后来
lưỡi	刃
hệ thống	體系
Tiết tấu	打比
Lối ra	出口
lừa	伎
Oxford	牛津
Biên dịch	編纂
nhập khẩu	进口
bình nghi lễ	豋
gấp rút	傯
Seychelles	塞舌
Kelly	凱莉
Leo	匐
Châu Á	亚裔
các cửa sổ	視窗
Tai ngựa	马耳
Công	建功
Eo biển	海峡
Vị trí bình đẳng	等位
Âm	訿
khu bảo tồn	保護區
Chặt đầu	斩首
Cung điện Hoàng gia	皇宫
Người kế vị	後繼
Huizong	徽宗
Trường sơn	常山
Saku	佐久
E	犲
làng	莊
Cen	岑
Dân du mục	游牧
viền bếp	陉
HP	惠普
trường học	学校
Trẻ mới biết đi	幼兒
Lực kéo	牽引
ở lại	留
Kuniko	國子
Quan	鎙
vết nứt	裂痕
Cực	極地
lạnh	凜
Phố Đông	浦东
Chủ nghĩa hợp hiến	憲政
Alps	阿尔卑斯
Merlot	梅洛
Locke	洛克
Nhập ngũ	從軍
Điều khoản	條文
tiêu đề	銜
đan lông mày	顰
bài hát dân gian	民歌
Thiết bị điện	电器
Anda	安达
Ka	迦
quan tài	榇
Từ đây	從這
tàn tật	痡
Mao Trạch Đông	毛澤東
đầy	满
Nguyên tắc	准则
hướng dẫn	指南
Georgia	格魯吉亞
Hay không	或非
hậu quả	反响
Sar	萨尔
Ngớ ngẩn	谹
Số tiền	数额
Cyperus	莎草
Uy tín	聲名
Bren	布伦
tấm ảnh	摄
meson	介子
Điều khoản khác	雜
Chống tàu ngầm	反潛
Sáp nhập với	並於
Hiện tại	在場
Trộn vào	混入
cái rổ	簏
Đối với công đoàn	為聯
nghìn	千
Xi	挙
hình thức	表格
Thành phố	市立
chất lượng	質
cá thu	鮐
Âm mưu	剧情
Fuqing	福清
Biên dịch	篹
Yên tĩnh	静
mùa xuân	泉
Đá bazan	玄武岩
Siêu thị	超市
Kiệt sức	衰竭
Fu	苾
Cắn	嚙
họng	咙
Xấu	谩
Kui	魁
Bao gồm	划入
Va cho	而為
mang theo	捎
Băng sơn	贝尔格
không thấy	不见
Địa Trung Hải	地中海
ca cao	可可
Đang chạy	運轉
Đóng lên	攏
Nhân viên bán hàng	行員
kết hôn	婚姻
Di	棿
Đúng	是發
Làng	寨
mật ong	蜜
Hành trình	旅途
tế nhị	眇
hẻm	衖
Lauren	劳伦
Gel	喱
Không bật	號於
Li	黶
trước	先於
Sinh vật đáy	底棲性
cống vật	贡
Bắt đầu đúng	開始對
Zhu	濴
Anjou	安茹
chow	粻
cây bút	笔
Quản trị	管治
Leningrad	列宁格勒
Chuyển giao	轉入
sợ hãi	觳
đầm lầy đất thấp	窊
đầy	充满
Trăng sáng	明月
đục đẽo	凿
Ao	鰲
vườn	花園
lò nồi	瓢
tự do hóa	自由化
hổ thẹn	惭
Khuyến mại	晋升
Zhang Taiyan	章太炎
Tỷ lệ xem	視率
Shihu	石虎
Phong phú	多樣
leo lên	进行
Tòa án nhân dân	人民法院
hào phóng	慷
Trăng tinh	大白
Niêm mạc	黏膜
dứt khoát	决定性
Mụn rộp	皰
Smilax	菝
Đã thanh toán	付費
thiết kế	设计
Choi	崔
Tham vọng	野心
Kate	凱特
Lọc	煉
bị hỏng	碎
Quận	郡县
quân khu	軍區
Thang máy giữa	中舉
Zhu	仏
Các	該
Tỷ lệ bình chọn	票率
Liren	立人
Phủ sóng	覆盖率
hạn chế	限定
Luo	冞
Coro	科羅
Castile león	卡斯蒂利亚莱昂
phủ nhận	否认
kết nối	連接
rung chuyển	摇
Trở nên khác biệt	有所不同
Mang	帶著
Nhảy vọt	閏
mủ	膿
thừa hưởng	传承
mỏ lết	鹪
Long Chao	龍超
vừng	芝麻
sân bóng đá	足球场
Liêu Dương	辽阳
Điều khiển hỏa	火控
Wanli	萬里
khỏe	精細
Đi qua	流逝
So sánh	比對
Tiếng Quảng Đông	廣東話
Marmoset	苨
Taishi	太师
Kun	鲲
ghế tre	箯
Ye	掦
Geneva	日內瓦
Bánh gạo	糇
Mikhail	米哈伊尔
Thrace	色雷斯
hai mươi hai	二十二
Ohio	俄亥俄
Nico	尼可
Tận hưởng năm	享年
Khởi đầu	開始
Tàu tuyến	線列車
Không hợp hiến	違憲
Tử tước	子爵
Cho Zhang	為張
Sẽ là bởi vì	會因為
Hệ thống cạnh tranh	賽制
Kéo	拖曳
Ed	愛德
Sẽ	會將
Đẹp	儔
đúng	权利
Erhu	二胡
Cũ	在舊
Cha mẹ	家长
Không bao giờ	從沒
đông lại	冱
vì thế	這麼
Yi	乢
Thắng cảnh	景区
Bậc thầy	夫子
Tình nguyện viên	自願
Quyền hạn	所轄
Riel	瑞爾
Giường	貝德
cái cốc	卮
Giáo dục	教科
Vậy nên	以至于
Đường ngắn	短道
Quạt	樊
tiêu cực	負
Thành lập	创始
dài nhất	最長
Hoàng đế tối cao	太上皇
đứa trẻ	子
Tự nhiên	原生
Tạo nên	開創
Cuộc tổng tuyển cử	統選
Anh trai	內哥
phong hóa	风化
Cứu giúp	祐
Yuwan	豫皖
Benzyl	芐
Yunlin	雲林
bão hòa	飽和
Hu	躶
Đăng ký	登記
Hợp nhất	並協
Tian	田氏
tuổi thọ	長壽
Xấu hổ	膥
Xác nhận	证实
Lo lắng	惂
Kiêu ngạo	恣
bãi bỏ	废除
kịch	戲曲
Đối với	為從
độc lập	獨立
Ria	里亚
khuynh hướng	趨勢
Ikebukuro	池袋
Sui	眭
Bick	比克
Yunshan	雲山
Vấn đề là	點是
Quy mô lớn	大舉
Lào	嬈
sự sụp đổ	崩溃
Nell	内尔
Chỉ huy quân đội	武将
Mở ra	展開
Cá mèo	鲇
Đêm	晪
Hiroshi	弘
Cứu giúp	幫忙
Trận đấu	赛
Chọn	選用
thang	階梯
Bugal	布加勒
nhận bằng cả hai tay	匊
Các kết quả	成果
Ngay	当即
Chiến lược	经略
Năng suất	产量
Mo	的摩
Đắng	鳽
Ở trên	上則
giai thoại	軼事
Hú	嘯
Nắm bắt cơ hội	趁机
Con số	为数
tinh thần	碛
Thiên nga	天鹅
Dịp tốt	契機
nhà ở	民宅
Mỗi	每次
bàn	錶
Sự ngạc nhiên	驚奇
viễn thông	电信
Góc đầu	头角
Shu	涑
bờ biển	漘
Tên mã	代號
Căng ra	抲
mất điểm	失分
Zhaozong	昭宗
ký tên	簽署
món nợ	债务
bên bờ biển	海边
Trong chiên tranh	戰爭時
Nếu không thì	除此以外
Triều đại Bắc Tống	北宋
Giác ngộ	啟蒙
Một quốc gia, hai	一國兩
đau đớn	痛苦
sự ngừa thai	避孕
y tá	護士
tiểu bang	态
Mã hóa	码器
Khi nào	時被
Mảnh vụn	碎屑
Jordan	佐敦
Một hớp	呷
trang điểm	弥补
Sau chiến tranh	戰結束後
đắt	昂
Yêu thích	最愛
Jundu	节度使
Xi	晞
Jing	璁
đột nhiên	猝
Congeal	凝
Với mọi người	與人
bố	父親
Đẻ nắm lấy	為擁
Warsaw	華沙
sao chép	复制
đã kết thúc	讫
Tong	丅
Tây nam	西南部
Sau	後為
ngoại tình	私通
Johnson	強森
hung dữ	猛
Ở châu Á	於亞洲
Miếng	颗
Kết hợp với nhau	绾
Cửa xe	車門
Thỉnh thoảng	間中
quyền lực	動力
chỉ có	衹
Sơn đông	山东
Huyện	该区
Ngay	立刻
niêm phong	鈐
Cruciferae	十字花科
Giám sát	监
Thiền sư	禪師
Di cư	迁徙
Lá dài	长叶
Moza	莫札
Đưa cho	予以
Xianfeng	咸丰
Nair	奈尔
Chỉ huy quân đội	军长
Làm	使得
Operculum	鰓蓋
dây đai	絛
Đà điểu	鴰
Giữa	間為
hình thức	形态
Theo sắc lệnh	下詔
nghiên cứu	研究
Máy bay địch	敵機
Đã	曾為
rửa	盥
Rao	饶
phát sóng	廣播
trẻ sơ sinh	婴
Xem	請參閱
tranh cãi	論戰
Dazhong	大中
Tình nhân	爱好者
Trò chơi	運會
loa	喇叭
Bắt chước	效仿
Đại Tây Dương Pyrenees	比利牛斯大西洋
có thể nói	會說
Chiến đấu khó khăn	苦戰
Tách rời	分離
Cơ sở nhà	全壘
Trừng phạt	罚
Tây du ký	西遊記
Phạm vi gần	近距
Lễ hội Xuân	春节
Góc phải	直角
Châu Mỹ	美洲
ý định	意向
ngón tay cái	拇指
Giải thưởng cho người mới	新人獎
Gọi cho anh ấy	稱他為
Vắt kiệt	摡
xóa bỏ	删除
Song Gaozong	宋高宗
Đông Âu	东欧
chuyến du lịch	巡迴
Thanh	卿
Tiểu cầu	血小板
Trường luật	法学院
Giới hạn trong	限於
Cai trị	主政
Mong	盼望
Kalka	卡尔卡
Chiến tranh giữa các vì sao	星球大战
Văn phòng	事務署
Phụ trách	分管
Cận Bình	金平
Yanzhou	兗州
quai hàm	颌
Cũng được biết đến như là	又名
Bánh xe nhỏ	小輪
lớn	盛大
khó khăn	艰难
Mecklenburg Front Wave	梅克伦堡前波
Người đó	那位
Giả định	推定
hiệu ứng	效
Năm năm	五年
Thường đề cập đến	通常指
Hội đồng lập pháp	立法局
Xiaogang	小港
Khoang miệng	口腔
tiệc	觴
Trường quân sự	軍校
dữ dội	严厉
Lùi lại	迁回
sâu	蠕蟲
buồn	忡
mù	瞎
Gus	格斯
trà	茶葉
Thân hình	形体
chèo thuyền	槳
Săn chắc	华亭
khối lượng	彌撒
nhà tư tưởng	思想家
quang điện	光電
Kadokawa	角川
Thời thơ ấu	小时候
Ling	淩
Indene	茚
Nguôn gôc tư bo	牳
thay đổi	變更
Tia vây	鰭條
phanh	刹
Yong	墼
Tây Âu	西欧
điều đáng tiếc	怜
ủng hộ	支援
Ăn mặc	身着
Cấp thị trấn	乡镇级
hoàn thành	毕
Mặt bích	法蘭
Suy ngẫm	反省
Có thể	可被
Trước cửa	門前
Con gián	砊
Thủ lĩnh	盟主
Xa xôi	遥
bạch kim	铂
Chương trình này	本剧
Lei	蒒
Nghĩa vụ quân sự	軍從
giáo viên	教師
Lối thoát	出路
kính	眼鏡
cho ăn	饲料
Chói sáng	亮眼
Bang	咚
Sôi lên	熖
Năng lực	人才
kiềm chế	锢
Chia buồn	悼
Đứng lên	峙
Banga	班加
Lảm nhảm	嘑
người ăn thịt người	食人
Kang	炡
lưới cá	罽
Tiền lương	薪資
Zhen	贞
Perry	佩里
bình minh	晓
Meuse	默兹省
Ba mươi ngàn	三萬
Travi	特拉维
đầy	饱
lấp đầy	阗
Sejong	世宗
Vinh quang	光輝
Compositae	菊科
độ đàn hồi	弹性
họa sĩ	畫家
định lý	定理
Gutian	古田
Nghi can	嫌犯
Bún	麇
Cấp dưới	下设
Sheila	希拉
Tai O	大澳
Reel	繅
kì nghỉ hè	暑假
Quay	旋转
Cân nặng	砝
Brussels	布鲁塞尔
Thời thơ ấu	幼時
Nút thắt chiến tranh	戰結
Valle	瓦莱
Hoa Kỳ	美国
Thảo Cầm Viên	植物园
bôi đen	黷
Shangan	陕甘
Mỗi hai	每兩
Anh trai	哥哥
Vướng mắc	糾纏
Vận động viên điền kinh	奧林比安
lưỡi	叶片
mụn	痤
đàn nguyệt	琵
Tỉnh Okayama	岡山縣
không rõ ràng	恍
Dương	陽
Đa dạng	品種
năm sau	明年
hình học	几何
Purine	嘌
Không theo dõi	无轨
Bắt	抓获
Wanli	萬曆
trôi chảy	流利
Tây Ninh	熙宁
hệ thực vật và động vật	动植物
Mái vòm	巨蛋
Đối với miền Nam	為南
thay đổi	改动
hành chính	行政
Vie	维埃
thẩm quyền	权威
bầy đàn	人群
lãnh đạo	首领
chợ đêmJi	夜市霚
Jincheng	金城
Hiệu quả	有效性
co bé lại	逡
Cạnh tranh quốc tế	國際賽
Dòng ngựa	馬綫
Tháng sáu	钧
Mọi người	人
chứng chỉ	证
mũi tên	箭
Baldwin	鲍德温
đồn trú	戍
Chống Nhật	反日
Mọi nơi	处处
Kiin	棋院
Thương tiếc	讑
Áo sơ mi	衫
Hiệu quả	成效
Kinh thánh	經文
Thay đổi	改元
bộ xử lý	處理器
Ireland	愛爾蘭
Zhi	誌
rọ mõm	槍口
Lớn lên	生长
Thuyết giáo	鼓吹
Chiên	弗莱
cấp	等级
nhà máy điện	發電廠
Kẻ bắn tỉa	狙擊手
sàn nhà	樓面
nghệ thuật	藝術
Trại tập trung	集中营
một số	有些
Sắp xếp	編曲
Giải cứu	救回
Bạn	偦
nước bóng	光澤
sự dự đoán	預測
giai đoạn = Stage	時期
Miêu tả	描绘
Lanyang	蘭陽
Monte	蒙泰
Cục	局
vết trầy	颳
ma	嬷
Trẻ	歭
Giới thiệu	介
Đặt trên giá	上架
Cao đẳng kỹ thuật	工学院
Hom	磡
Số Pi	貑
nhọn	畟
hành hung	撄
Cà vạt	髤
Tường	牆
cơ quan nội tạng	腑
Cô	小姐
kiếm	掙
Hakama	袴
Tây An	娴
Christine	恭
Sẽ	還會
Vetch	苕
Mingxin	明信
quyên góp	捐
Rực rỡ	艷
R; lt '; FL	續作
Áo choàng	袵
Sách về	的書
Ở nhà	在家
dải	褫
sai	假
đồng phục	匀
thừa hưởng	傳承
Giảng dạy và Nghiên cứu	教研
Gấu đen	黑熊
Kết hôn	娶
sự giàu có	财富
gốc	原點
ngâm	浸泡
đọc	阅读
Hướng tới	朝著
Jin Jun	晉軍
tàn bạo	野蠻
Hình lục giác	六角
Tên loài	種名
Vạn đò	爢
Jinggangshan	井冈山
Thời hiện đại	近代
báo tuyết	雪豹
Trận chiến	戰況
Sức khỏe	壎
Yên tĩnh	蚄
Đang nói	話中
giai đoạn = Stage	期間
Lille	里尔
Kefu	克福
Yap	邑
sự giải trí	娱乐
ranh giới	邊界
Tham khảo ý kiến	谘
Domin	多明
sư tử	蓑
Sẽ	會對
nhưng	卻
Khu vực nông thôn	农村
bắt đầu	始
lòng trung thành	忠誠
Công trường	工地
tỉnh Giang Tô	江苏省
Được dịch là	譯為
co giật	搐
Chen Hui	陳慧
Gore	戈爾
Tảng đá	巨石
Vắt kiệt	搡
Đẹp	奀
Tai Kok Tsui	大角咀
Thay thế	转而
Wen Cheng	文成
Chi	蚩
phần thưởng	收穫
Điều	东西
Xác suất	概率
Charles	查爾斯
Tới Hồng Kong	對香港
Li	靬
vật chất	實質
Trung Quốc	中华
đọc	读作
Họ cua	蟹科
thay đổi	變
Xuân	瑁
Phe phái	派系
Giáo dục	學歷
ga xe lửa	火車站
Fiasco	慘敗
cánh tay	軍備
quạt lông vũ	纛
Quan	仌
Không cần	不用
say	酗
Trải nghiệm sống	身世
Thống đốc	都督
Tsuji	辻
Vosges	孚日省
kiêu ngạo	骄
Costa	哥斯达
Lòng trung thành	效忠
Tập ảnh	張專輯
kỹ năng	技藝
học giả	學者
Tính là	算作
Trường hợp này	此案
bay lượn	滑翔
Đó là	即有
Hét lên	哷
Eustoma	鵸
hội,, tổ hợp	組裝
Nên	是該
sự thỏa mãn	满意
Hughes	休斯
nằm nghiêng	趄
chớp cánh	撲
Quận Wan Chai	灣仔區
Biển thủ	挪用
Xiguan	西关
cối xay	磨
xe điện ngầm	地下鐵路
Đóng quân	驻守
Cá tầm	貟
đưa ra	裒
loa	議長
ánh sáng	光之
chảy ra	外流
Nano	納米
Đại thừa	大乘
giống	似
đội	团队
Olympic	屆奧
hình thức	形成
suy nghĩ	想到
Jintian	金田
Con gà trống	屇
Bang	梱
Mạnh	強勢
Sắc lệnh	诏
tự xưng mình là hoàng đế	稱帝
Tang Jun	唐军
lực lượng	偪
Hu	彔
Albedo	反照率
cuộn	滾
Gà lôi	鷳
Guoan	國安
lụa	絲綢
Ti thể	线粒
Dịch vụ cảnh sát	警務處
biết rôi	知道
Khám nghiệm hoàng gia	科舉
ướt	浥
viết lại	改写
tẩy	祛
Thành phố có	市有
Hồ Chí	胡志
Xi	鍗
Ode	頌
Tòa nhà chính	總樓
trên đường	途中
Gọi nó đi	稱之
mềm mại	柔
liên hiệp	會聯
nạn nhân	被害人
Nhiệt độ	气温
chắc chắn	牢固
Đêm giao thừa	夏娃
màn	银幕
Yu	斾
Gangwon-do	江原道
Người thuê nhà	租戶
Yun	韞
Kuaiji	會稽
Hôm nay	當今
vinh quang	光荣
tiêu đề	头衔
magiê	镁
giác quan	感
Li Yuanhong	黎元洪
Khác nhau	纷
trùng hợp	巧合
Đột phá	突围
ban đầu	最初
Cửa hàng	门市
Aru	阿魯
chồi non	藟
Chẩn đoán	診
người Ấn Độ	印第安
chơi	演
Ngồi xổm	飝
các tập tin	档
Sưng lên	膨胀
Đồng hồ đeo tay	睇
Chiến trường	野戰
Lượng mưa	降雨量
cửa tiệm	商铺
Ôn tập	评审
tải	负载
Trong quân ngũ	军中
Lai Chao	賴朝
Sartre	萨特
Âm	辎
vui sướng	欢乐
Chiều dài ô tô	車長
năm nhuận	闰年
mệt mỏi	累
Cùng tháng	同月
Zhongdan	中擔
Xa lánh	齕
Kun	昆
Làng Tây	西村
Noel	諾爾
Ba mươi tám năm	三十八年
Vấn đề này	此事
CEO	執行長
báo cáo	報告書
Xấu hổ	趷
Bạch Dương	白羊
Cái lều	幄
nhà máy rượu	酒廠
Qian	黔
Người đi bộ	沃克
Giảm bớt	緩和
Nâng cao	推进
An Nghỉ	安息
Thiên niên kỷ	千禧年
dọn dẹp	清潔
chính thức	仕
Số là	數為
sinh viên	学生
Sách Đường xưa	旧唐书
Trừng phạt	惩
Cả trường	全校
Bustard	鸨
Mou	澖
Bài đăng trên thế giới	世职
phá dỡ	拆毀
Bầy đàn	眾
Ria	鬍子
Tên	名号
Cắm vào	外掛
Wei Ye	維也
Chelsea	車路士
Alexander Dennis	亞歷山大丹尼士
sự nguy hiểm	阽
Đầu hàng	招降
Mọi người biết	人知
cô	嬸
Làm tiêu hết	扫荡
thuốc uống	藥物
Đường Nam Kinh	南京路
deuterium	氘
muốn	要
Hồ chứa	水库
nước ngọt	淡水
cô đơn	觭
Người đi bộ	佩德
Mihai	米哈伊
Cố ý	審議
Quan điểm	展望
Đào ra	挖出
vụng về	拙
Chúa Giêsu Kitô	耶穌基督
quai hàm	颚
buồn	惻
màu vàng	黈
Vừa và nhỏ	中小型
khi nào	噹
lỗ thông hơi	洩
Cuộc bầu cử	選戰
xem	見
Phát biểu	言论
Đi	觿
Trung bình hàng năm	年均
Loach	鳁
Sạc điện	收取
Wayne	韦恩
Hai chiều	双向
Sóng điện từ	电磁波
nồi	煲
Olin	奧林
Siêng năng	勤
nhưng	但
Hoàng đế	黄帝
quan hệ tình dục	性交
Vôn	电压
Làng tự nhiên	自然村
cô ấy đã	她
Núi sâu	深山
Sikong	司空
viền	輪廓
Có thể	可於
Quấn quanh	缠
Gila	吉拉
Giang nam	江南
Các thành viên	員會
Vận động	調動
mạng tinh thể	欞
người chết	死亡人数
Gao	藁
cây cột	支柱
Sự cấu thành	选区
Bóng chày	螄
di chuyển	遷
Đường Sơn	唐山
Vàng lớn	黃金大
tâm lý học	心理学
Conrad	康拉德
cơ chế	机构
làm hại	妨
Tắc nghẽn	擠塞
ngụ ngôn	寓言
thanh kiếm	剑
Khai giảng	开学
Đã xem	看過
Marin	馬林
Ngớ ngẩn	诙
chấm dứt	终止
Khoa Vật lý	物理系
Phái viên	使臣
khỏe	细
khó khăn	難
đề tài	话题
con hổ	鰕虎
Nếu có	如是
Bacillus	桿菌
Những con gà	鸡
muốn	慾
Đã đồng ý	商定
cực	極度
Âm	閦
Hu	斉
Surrey	萨里
Luo Dong	羅東
holmium	钬
Lin Yixiong	林義雄
Chơi chữ	娉
Shigu	石鼓
Đi	踈
Sinh ra	诞生
Ứng cử viên	候选
Cụp	垂
Tao	滔
Mite	螨
Cá tráp	鳊
nghệ sĩ piano	钢琴家
kính thưa	親
George	喬治
Đi làm	通勤
hành pháp	執法
Phá sản	破产
đồng thời	同时
Di tích lịch sử	古迹
Đến	徇
Fei	翡
kính thưa	禔
Kun	韔
bút danh	假名
Tay phải	右手
Có lợi	有益
Loại cơ thể	体型
Biển trung quốc	中国海
hang	石窟
lá thư	函
Lời bài hát	抒情
Xinh đẹp	美好
Zi	孜
Mia	米亚
Giật mình	怔
Xa lánh	顺
Một phần	分之一
Shimizu	清水
Thăng bằng	天平
khiển trách	誚
Chết	逝
mt	公噸
Đại học Vũ Hán	武大
tập trung	專心
nguyền rủa	诅
Zhu Xi	朱熹
Thành phố Sapporo	札幌市
không thường xuyên	龃
Lan	兰语
Nữ diễn viên	女星
Microsoft	微軟
Chi nhánh	分院
vĩ độ	纬度
Raymond	雷蒙德
hướng Tây	西方
Máy ảnh	相機
Nữ hoàng bóng tối	影后
Thực hiện việc này	藉此
xem	见
Nhà chọc trời	摩天
con mắt	眸
móc câu	鉤
Erda	爾達
lung linh	皦
Amoni	铵
Chester	切斯特
gợn sóng	漣
náo động	騷動
Buồn phiền	孌
Han Jun	汉军
giám đốc	董事
đi vào	输入
Có liên quan	关联
Kinh nghiệm	體驗
Nhận thức	认知
Tiếp theo	继
Gouqiao	沟桥
Bois	布瓦
Làn đường	车道
Chim ó	鵼
Bề mặt cơ thể	體側
đăng nhập	登錄
Lưu lượng hành khách	客流
Qian	鶱
Hội chợ	費爾
Qi	丆
Kiểm tra thị trấn	鄉試
Wei	陃
bão	颶
Giống	像
Bi	璧
Khu vực sản xuất	产区
Co lại	萎缩
Hội đồng lập pháp	立法會
Honduras	洪都拉斯
Nevada	納州
Ốc sên	螺科
Đông đúc	排挤
Điều khoản khác	屬雜
Ang	盎
Yoo	與奧
Cắt	裁
Xianfeng	咸豐
bắn tỉa	鷸
Từ Hi Thái hậu	慈禧太后
làng	村莊
Yan	遬
Vành	輞
Cắt	切断
Hoạt động trên	工程於
Thống nhất	统
Isomorphism	同構
tập trung hóa	中央集权
áo giáp	铠
Quay	轉動
Một số loại	某種
Trận đấu	的賽
Dài	長遠
Mu	軧
Sự thông minh	智力
Nhiệt độ khác nhau	温差
Yu	霋
Chúng sinh	众生
với	同
lợi thế	優點
Kenshin	謙信
Đa dạng hóa	多元化
nhiều hơn	大于
Khu vực đài loan	台区
thỏa hiệp	妥协
Trái cây	波爾
Hang	洞窟
Bỏ qua	俯瞰
bằng phẳng	平坦
Macky	马其
tên nick	别称
Alabama	阿拉巴马州
Hinder	阻碍
tàu tốc hành	快车
Lễ hội trung thu	中秋
Trân trọng	谨
hành hung	突擊
Grenadier	擲彈
Airbus	空中巴士
sao chép	摹
tham vọng	志向
Tổ chức	該組織
Đầy đủ hơn	富勒
Anita Mui	梅艷芳
Và Jing	與經
dịch bệnh	疾病
rơi ra ngoài	退出
Lu	卢
Giết chết	殺死
Vẽ tranh	伋
Jizhong	冀中
Máy ảnh	摄像
Than van	廑
Vịt Bắc Kinh	鴛
Vịt Bắc Kinh	鴦
Skeet	士革
Bầu cử bổ sung	补选
cua	螃
nữ hoàng	国后
Benja	本杰
lợi ích	裨
Tỉnh Fukuoka	福岡縣
bầu trời	天空
nắp hình nón	帻
nguyền rủa	骂
Wu Trung Quốc	吴语
Môi trường sống	栖息
Quyết toán	聚落
Lưu Bang	劉邦
Sứa	水母
Nhìn chằm chằm	盝
Lễ khai mạc	开幕式
trò chơi Olympic	奥会
liễu rũ	婀
Thành tích	績
Số nguyên	整数
phân phối	分配
Xấu hổ	躆
Đã làm việc với	曾與
Zhu	斵
Shuibian	水扁
thời gian	時候
Epina	埃皮纳
Tĩnh	靜態
xe hơi	轎車
Được phân loại là	歸為
Chia cho	除以
Mạc phủ	幕府
Vị trí thứ ba	季軍
Tốt hơn	較佳
Chỉ đứng sau	僅次於
Xung quanh	身邊
Rong	蓉
Hội chợ	费尔
đầm phá	潟湖
Điều tra	追究
Đôi chân	呎
Thành phố Nhạc Dương	岳阳市
Phi	掷
kỳ hạn làm việc	任期
Giám đốc điều hành	行政長官
con sông	尔河
trên	關於
Tát	舋
lái xe	驾
James	詹姆斯
câm	啞
Khoảng thời gian	区间
Không	們沒
Xô	攡
Zhang	栂
Tránh	避开
Poidium	蓷
giống	相近
Logistics	物流
Đánh mạnh	重创
Bướng bỉnh	倁
đưa ra	取出
Matsushita	松下
Tin	钿
Zaragoza	萨拉戈萨
Mong	盼
Tỉnh Ibaraki	茨城縣
Đồng hồ đeo tay	觀賞
khao khát	嵂
Chất đơn giản	单质
gọi	叫
Hoa hồng	羅斯
Tây An	葘
Buda	布达
súng cầm tay	枪械
đối diện	对面
trở nên	成爲
Theo cặp	成對
Sách khoa học	科書
bàn đạp	跳板
tiếng Nhật	日人
Vâng, đúng vậy	是的
lạc đà	駱駝
Công ty	會社
điện thờ	神社
xẻng	铲
giám sát	顯示器
Yongle	永樂
Lantau	大嶼
Đã lên lịch ban đầu	原定
Kết hợp với	会同
Ye	樖
Ngắn	短小
Otocho	乙丑
Chiếc cúp	獎盃
Linna	琳娜
Tổng thư ký	总书记
Bộ nội vụ	務省
Cho	赋
Bất tận	不已
nhỏ giọt	潺
Dài	蕌
sự hối tiếc	悔
Dongyang	东阳
thảm họa	災害
Trong công viên	园内
cung cấp	供给
Cơ lượng tử	量子力学
gián điệp	谍
kết tủa	淀
cuốc đất	锄
Vi phạm kỷ luật	违纪
phá vỡ	擘
Pháp	法兰西
Vô cùng	有極
Cục là	部為
Cai	蔡
Bắt đầu phát sóng	開播
Tương ứng với	對應於
lạc quan	乐观
búp bê	娃娃
Quyên góp	捐助
Chọn	挑选
Vẽ tranh	划
Rình rập	薹
trái cam	桔
Một bang	一個州
Muối	盐
túi	袋
quyền lực	有力
Ile de France	法兰西岛
Số một	一號
Ya	繑
Maya	玛雅
thương mại	貿易
Trường Cao đẳng	高等学校
Pengcheng	彭城
Làm lại	再造
Xingguo	兴国
Đặt	把
cừu	羊
hỗ trợ	协助
đồi cây cối	岵
Phải	只好
co lại	收縮
Là	則被
Luo	籮
đội	球队
nâu	布朗
Trung tâm thành phố	中市
trang hoàng	縟
thích hợp	适
Cheng	埢
sự đóng góp	貢獻
Đảng	各方
Mọi trò chơi	每場
Hamilton	汉密尔顿
Lưu trữ	含有
Glo	格洛
tính phí	帶電
Xi	浹
Tổ quốc	父系
Quận một	區之一
Tóc chiến đấu	戰鬥發
Sai lầm	失误
cỏ dại	捭
rửa sạch	漱
đơn âm	音位
dịch bệnh	症
Thắng cảnh	景區
Truy tố	起訴
thứ hai	秒
thực hiện	执行
nhu la	之類
nô lệ	奴
cuộc xung đột	衝突
Đối với	所為
chịu	承担
Bị thương	受傷
lo	擔心
Tòa nhà chính phủ Đài Loan	台灣總督府
động lực học	动力学
nhiệt đới	熱帶
Đặc điểm	特質
Quảng châu	广州
đảo Lantau	大嶼山
sự tự tin	自信
Xe cho	車為
Thành phố Ôn Châu	温州市
Chơi	上場
Nhặt lên	捡
Bao vây	莶
nghĩ	心思
Caesar	凱撒
tình trạng	況
Quốc gia	国
Trong trận chiến	戰中
Ya	犱
bắn hạ	擊落
Bôn mươi tam	四十八
tê liệt	痺
Nghiêm nghị	艔
Không còn nữa	不了
cảm giác xấu hổ	詬
Lần đầu tiên	首度
rắc rối	恓
từ ngữ	字
Độ ẩm	水分
ngọc bích	玉
Câu hỏi	搉
Trường học của chúng tôi	本校
ngân hà	银河
Xa Xăm	遠遠
Được công nhận	認可
Atayal	泰雅族
Hợp lý	正当
Quyền bầu cử	选举权
Consortium	财团
Philadelphia	費城
Bài hát nhịp	咏
lòng chảo	盆地
Sẽ vào	將進
Thuê	雇
Đường Hennessy	軒尼詩道
Tiền thuê đất	地租
đổi	交换
nhu cầu khẩn cấp	急需
Viết	譔
Tựa đề bài hát	題曲
Xe đẩy	无轨电车
Xâm lược	侵占
lòng nhân từ	仁
Và khác	與其他
Hiện tại	現於
Phân biệt đối xử	歧视
Hongqiao	虹桥
Oshima	大島
Nhà kho	舍
Kiểu mới	新型
gia đình	家族
chỉ huy	指挥官
suy nghĩ	以为
Phát sóng thí điểm	試播
Nổ	炸藥
Rượu	瞖
Sau	後經
Tolle	托勒
Người phát ngôn	代言人
Xoắn	拈
sản phẩm	产品
Đáng giá	值得一
quay lại	回去
rau	蔬
Xiao	譕
Nhân viên bán hàng	務員
đậu đũa	豇
Giải trình tự	测序
điếu văn	誄
hợp lưu	合流
Jincha	晋察
Congo	刚果
Hậu duệ	後裔
Trẻ mới biết đi	幼童
Tỉnh	知县
căng thẳng	紧张
Phân loại	分級
Xing	鍉
Urumqi	乌鲁木齐
thâm nhập	穿透
nhanh nhẹn	敏捷
Dọc theo dòng	沿線
vô hình	非物质
Hiển thị cho	展為
Ghim	蠲
Đồng ý	赞成
Xiao	萧
Tài nguyên Trung Quốc	華潤
xuyên qua	亙
Đại diện đảng	党代表
Shao	錞
Lấy hai	以兩
Roche	罗氏
Sau cuộc họp	會後
ngữ pháp	語法
Và sản xuất	而產
Bình luận	解说
Etane	乙烷
tin	信奉
Pewter	镴
Boson	玻色子
Ban chính trị	政治部
Chất lượng	素质
vách đá	悬崖
Cá chép bạc	鰱
mô hình	型号
mảnh dẻ	轻微
Tang	漙
Penglai	蓬莱
Bí danh	别名
giày	鞋
mạng lưới	網
Sự hỗn loạn	亂
Syme	赛姆
Wengcheng	瓮城
Lacy	拉齐
lỗi	误差
thành viên	籍
nghệ thuật	美術
nghĩa vụ	义务
bất mãn	怏
sốc	休克
Doanh nghiệp	企業號
Súp	汤
Khu kinh tế	经济区
Đã trang bị	配备
Bữa tiệc	該黨
nguyên nhân lớn	大业
Piros	皮洛士
Chính thống giáo	東正教
inch	英寸
Dài và hẹp	狹長
Hát	燇
Việc làm tại Nhật	日治時期
Guo Lun	國倫
xúc xắc	骰
Trên danh sách	上榜
Pháp	法國
Thời gian	計時
gấp gáp	滂
tôn giáo	宗教
đừng	彆
Faye Wong	王菲
thế giới	人间
Mở	號開
Quận Jin	區進
Hội nhập	体化
Bering	白令
Phạm vi	射程
Đôi khi	時會
Khuyến khích	勵
World Expo	世博会
say	酣
Karma và	業與
Haig	黑格
hố	窿
Phá vỡ	掼
cái cổ	脰
Yêu và quý	洛夫
trò chơi	比賽
gâu gâu	魆
Người này	此人
thiếu hụt hoặc khuyết	亏
Yu	珇
Hố	擊坑
Bashu	巴蜀
cuộc bầu cử	选举
Xông khói	噝
Còi	囁
Hobbs	霍布斯
Linton	林頓
sự trả thù	报仇
Đột biến	变异
yêu thích	喜爱
Xie	箇
Xây dựng	营造
Mỹ nhân ngư	人魚
Kaihuang	开皇
ánh sáng	灯光
Chỉ có	僅為
Cái này sẽ	將這
Saruman	薩魯曼
Lời bài hát	作词
thành lập	既定
dược phẩm	葯
Thiên đường	天道
sức mạnh đó	權力
Nếu	若
Nếp	楕
Bồn rửa	沉没
Chiều dài cơ thể	體長
Ero	埃罗
vượt qua	叉
De	徣
Shaw	肖
chạm	觸
cắt	斬
Âm	媠
Tham vấn	磋商
Sách giữa	中书
máy bay trinh sát	偵察機
Fu	傅
tương tự	同一
Nguyên mẫu	雏形
Đại sảnh	大雄宝殿
Tiêu chuẩn mô hình	模標
Đầu với	頭與
thẻ đỏ	紅牌
cấp trên	優越
sự thay đổi	移
xe hơi	轿车
Thính giác	听觉
Xuzhou	徐州
Za	劄
hoạt hình	动画片
Làm gián đoạn	中斷
Di cư	徙
Dưới chân	脚下
Núi	斯山脈
Nổi	浮游
Ngắn	肖特
Saka	坂
Sư đoàn bộ binh	步兵师
vỏ sò	殻
Trung Quốc Quốc dân Đảng	中國國民黨
Phù hợp với	适合
tích phân	積分
Thời gian giữa	中時
in	打印
Toei	都營
Bette	贝特
Khó xử	蹔
Tolkien	托爾金
Thiết bị	器
nói chuyện phiếm	嚅
Kiểm tra	檢
Nếu	若果
Khu vực thành thị	城區
Ngoại vi	外围
Giữ	攬
Tòa tháp	塔台
Lan tràn	传播
Còn lại	剩餘
Kai	凯
Rùa	鳈
đột ngột	驀
vu khống	譖
E	娥
Gia công phần mềm	外包
Hồi phục	康复
Rửa	涤
Liên kết	缔
Hải quân Đế quốc	帝國海軍
Và không có gì	與無
Buổi tiệc	會黨
tàn tích	廢墟
trừu tượng	沕
Bộ hướng dẫn	指令集
Wat	笏
Giải bóng chày Major League	美國職棒大聯盟
vết trầy	搔
Đảm nhận	接任
Để yên	遑
St	斯特
Thoát đến	逃到
Nói cách khác	換言之
Kai	塏
Sloven	斯洛文
Jiu	玖
Đa dạng	各種
Ngân hàng HSBC	匯豐
mẹ	母親
Tổng lanh sự quan	总领事馆
Bị bỏ rơi	废弃
Các đơn vị hành chính	行政区划
Choáng	愰
Tony	托尼
Athens	雅典
Thiều Sơn	韶山
chim ưng	鷲
Ngôi sao	斯塔
Đằng sau hậu trường	幕后
họng	咽喉
Đường tiêu hóa	消化道
Bệnh sốt rét	疴
Mặt tiền	前茅
Tám người bất tử	八仙
Xúi giục	誘導
Sushi	蘇軾
canh	翼
Guanzhong	关中
thịt	肉食
Tiệm thuốc	藥學
Kháng cự	抵御
polonium	钋
Giờ thành phố	城時
các nước châu Âu	歐洲國
Phong sơn	凤山
cảm giác	轰动
Than khóc	啎
công cộng	公
quan tài	棺材
Calais	加来
Nước Anh	不列顛
Beretta	貝瑞塔
Phải lòng ai đó	相戀
Yên tĩnh	蚗
Sabah	莎白
tuyệt đối	絕對
Côn Sơn	昆山
Stan	斯坦
giáo dục thể chất	體育
dính vào	扦
thiêu đốt	燋
đồng minh	盟友
nhảy vọt	踊
Li	俥
Và một	並有
Cũ	耄
Shunde	顺德
Được dịch là	译为
Dace	貮
bỏ phiếu	选票
ngẫu nhiên	随意
Qian	鞪
phía sau	落後
Sẽ là	將為
Liệt kê	列举
Chiếm lấy	俘獲
Kết thúc	告一
Mỗi chia sẻ	每股
hoặc là	或
trượt tuyết	滑雪
bất động sản	财物
Nhìn qua	眺
Anh ấy đã thắng	他獲
Niềm nở	用心
Receptor	受体
suy nghĩ	認爲
Chính quyền liên bang	联邦政府
tích cực	積極
Say	醺
Yell	吔
Lớp	成績
Sting	蛰
Làm sao	岂
phức tạp	复
Dần dần	日漸
Trở thành	转为
Thức tỉnh	覺醒
Giấc ngũ ngắn	瞹
bơi lội	泳
Pavilion	舘
Tiêu cực	負面
heo rừng	豭
ngôi đền	寺
Jue	珒
Tấn	勛
Rang	凘
tại sao	何以
lúa mì	麥
Trang điểm	补
Trình độ cao	高層
Zhen	甄
Hu	扈
bờm	髦
Paris	巴黎
Tiếng Anh	英文
tưởng tượng	虛構
bìa sách	袟
Mu Gong	穆公
Đầu triều đại nhà Đường	唐初
Tirana	地拉那
Tâm sự	赪
Po	埔
Madison	麦迪逊
Buồn phiền	敆
Pong	乓
Tháng Mười	十月
Nhân Viên	員工
chiến tranh Việt Nam	越戰
Trang Chủ	家為
Cá mèo	鯰科
người cầu nguyện	祈祷
Mát mẻ	槚
dụng cụ	儀器
Nicaragua	尼加拉瓜
Mo	靺
Đổi tên	更名
Thể rắn	固态
chấn thương	创伤
Xiumoping	秀茂坪
Thơ	诗歌
Gundam	機動戰士
số lẻ	奇数
Dịch vụ bí mật	特勤
Ờ	珥
Đứng với	站與
Động cơ	電機
Nói chung là	一般以
nhập khẩu	進口
khu vực	地域
co lại	收缩
Chế độ quân chủ	君主制
tạm ngừng	頓
Renxu	壬戌
rung chuyển	撼
Tanzania	坦桑尼亚
Hamton	咸頓
ngà voi	象牙
Sha	莎
Ruth	魯斯
Vũ Hán	武汉
Chương trình	纲领
Thành phố Cát Lâm	吉林市
Qinglong	青龙
Trường bình thường	師範學
Chất kiềm	碱
gọi	呼籲
đội trưởng	舰长
Đoạn văn này	這段
Yu	庾
nhu cầu	需
chũm chọe	鈸
Tussah	枟
trưởng phòng	首席
Đang chơi	演奏
Quỷ lùn	絀
xương bánh chè	膑
kẹp tóc	簪
kỳ nhông	蠑
mùa xuân	春
Herri	赫里
Haifa	海法
Quyền lợi chính trị	政治权利
Thành phố Quế Lâm	桂林市
Qua mạng	過網
thủy sinh	水生
liti	锂
Bách khoa	理工學院
Barberry	小檗
Đáp lại	答覆
Nguồn TP.	源市
Theo	隨之
Tỉnh Shizuoka	靜岡縣
Nhà thờ Công giáo	天主教堂
Gặp	接轨
Căn bản	字根
ban nhạc	帶
người đi rừng	山人
Đối với Đài Loan	為臺
đồi núi	希尔
Wu	吴
Tấn	荗
Leby	莱比
Changde	常德
trở về	返
Được	則獲
Hàn Quốc	韓國
nghiêm trọng	認真
Jiao	蝭
Tần	芩
thay thế	替身
Erke	尔克
Zhu	硃
sớm	早日
Shu	扲
Gầm	吼
Strata	地層
Ba mươi ngàn	三万
Cửa hàng	貯
phối hợp	統合
Ô long	烏龍
chó sói	爾夫
phần phía sau	後部
Chuyến thăm	出访
hệ số	因素
Cảnh	場景
Nhận vào	入院
Đồng hồ	鐘錶
Người giám hộ	护法
Cây thông	阿伯
Cử đi	遣使
Geneva	日内瓦
Kho	仓库
Baden Wurttemberg	巴登符腾堡
Orifice	竅
đã học	博学
Bên Anh	英方
Yi	乸
cũng không	也沒
quý ngài	长官
Cùng với	连同
Không lớn	大不
Nan Ming	南明
quan tài bên ngoài	槨
phẩm giá	尊嚴
Rời văn phòng	离任
ổ cắm	插座
Mo	茉
tủ quần áo	圂
sao Kim	金星
ắc quy	电池
Ieyasu	家康
Đưa vào	普頓
làm	作品
sự phỉ báng	誹謗
Người ta nói rằng	據說
Cho xe	為車
tứ diện	四面体
gốc	渊源
Bách khoa	理工学院
Quân đội phương Tây	西軍
Chi	姖
Nhận thức	認知
La Hay	海牙
Buồn phiền	惿
Sui	綏
Họ Pteridaceae	蕨科
máng	澰
Bầu trời sao	天星
Yan	焱
Thúc giục	加速
Và hơn thế nữa	並且於
Người thay thế	替补
Ji	嵇
osmium	鋨
kết thúc	過度
hồi phục	復原
Qi	俙
Chảy qua	流经
Quỹ đạo	眶
Di sản	遺留
Lễ	禮
Kirin	西里尔
Li	荔
cống	浍
Tại thời điểm đó	那時
Thorpe	索普
người chơi	播放器
Đi bộ	躑
Sông hồng	红河
Lan	斕
không thấm nước	防水
du lịch	旅游
Thượng nguồn	上游
Phía trong	內
Song Jun	宋军
Chiến trường	战地
Mang	隨身
Bảo hiểm	保险
cuộc thi	競賽
Kyle	凯尔
nguội đi	冷却
Chúng tôi là	們在
Quân đội Nga	俄軍
Bàn luận	磋
Yi	弳
Shiye	什叶
tỷ lệ	比例
Lá bách hợp	复叶
Thời gian	時光
Sổ da	皮書
Dựa vào	倚
xương chậu	骨盆
Đàm phán	協商
Có hiệu lực	生效
sinology	漢學
triệu chứng	症状
lên án	譴責
biến mất	消失
nhân chứng	目睹
đính kèm	掗
Làm tiêu hết	掃蕩
Palestine	巴勒斯坦
tà ác	噁
trò chơi	遊戲
đục đẽo	鏨
công viên	公园
nệm	褥
Đội trưởng	都尉
Bướng bỉnh	鋷
nắm chặt	握
kéo lên	揠
Trạm cơ sở	基站
Đi xuyên qua	历经
Tàn dư	殘餘
thời gian này	本次
Hạ gục	淘汰賽
không chỉ	不僅
xuyên lục địa	洲际
Wei	崄
Giám đốc	管理者
Vui mừng	逍遥
Neo	尼奧
Yi	乂
Chia thành	分为
ngay thẳng	婞
ống	筦
Giữa dòng và hạ lưu	中下游
Tên	姓名
Yi	佂
theo đuổi	追求
lực lượng lao động	劳动力
Nhân viên bảo vệ	保安
Người thừa kế	继承人
Yêu cầu	自稱
Cho đến nay	至此
ý nghĩa	意義
Cả hai	雙雙
Cha và con trai	父子
Nhà thờ lớn	座堂
qua đêm	通宵
Ying	郢
mùi thịt cừu	羶
Bắc	之北
Lượt xem	為觀
Kết hợp nút	賽結
nước Thái Lan	泰国
Huân	桓
Người theo dõi	随者
Trả	丿
hội nghị Quốc gia	國國會
Na	纳
Giám đốc	所长
thị trường chứng khoán	股市
lòng	肚
gói bọc trong vải	袱
nâng cao	募集
trước	前
Vu khống	诐
dị ứng	過敏
Nong	莕
Chu	躝
Cho đã nói	為輻
Thư kí của giám đốc	布政司
Khí hậu gió mùa	季风气候
Yi	燚
Người Hán	漢人
gương	鏡
Vì điều đó	對該
cho anh ta	對他
Chính phủ lâm thời	临时政府
ám chỉ	典故
Ganda	干达
Như thể	俨
cho	为
đánh bắt cá	钓鱼
Tắt	對開
Đăng quang	加冕
đổ đầy	餡
Bực bội	怌
Tia laze	雷射
Và	及第
Nền tảng đảo	島式月台
thánh	圣人
sang trọng	豪华
thư mục	夹
Thiết kế	的設
Weiss	韋斯
cánh đồng	場
thông điệp	訊息
Stanford	斯坦福
Meng	孟
Lưỡng cư	兩棲
Louis	路易
nhập khẩu và xuất khẩu	进出口
Tế Nam	暨南
kịch hóa	躗
niêm phong	海豹
Nhiều lần	反覆
tỉnh	省份
rượu	酿
Hub	中樞
bảo vệ	镇守
kiềm chế	羁
Huân Công	桓公
Kiêm nhiệm	兼管
đêm	夜晚
Bánh mì nướng	土司
Tát	旹
Mao Liqiu	毛里求
nhạy cảm	敏感
bụi rậm	灌木丛
cản trở	碍
Sinh viên đại học	大學學
Âm	燛
chuyến đi	旅
trong những năm gần đây	近年
Đồng hành	伴随
Lên mạng	上網
Liren	利人
nguyền rủa	咒
Thu nhập bình quân đầu người	人均收入
heo vòi	貘
Song Ziwen	宋子文
thừa	赘
Xem	详见
Không thay đổi	恒定
Người thừa kế	继承者
Bảy ngày	七日
Danh pháp	名則
sửa	修复
di chuyển	搬遷
tiếng Nhật	日文
Đảm nhận	承接
Ủy ban	委員會
bốn mươi lăm	四十五
Trung tâm phân phối	集散地
Aoyama	青山
Tôi	嚲
thuốc nhuộm	染料
Đổi	匯處
may mắn	幸运
Dân du mục	游牧民族
kỷ luật	紀
Tệp điểm	點檔
Dành riêng cho	獻給
Ở đằng trước	眼前
nền tảng	基石
Nhà cách mạng	革命者
Trung đông	中东
Khánh thành	創刊
Treo Seng	恆生
Yongtai	永泰
Buổi họp thường niên	年會
Bài hát pop	流行歌曲
Vận chuyển nước	漕运
cây bút	柙
Thành phố New York	紐約市
trong	之内
Chọn	拣
Peng	芃
Và dài	與長
Băng video	錄影帶
kỹ thuật số	數字
những bông hoa	花卉
Lợi ích	受益
dược phẩm	藥
Đến để gọi	來稱
cua móng ngựa	鲎
Sway	迨
Hét lên	啚
Cánh cổng	栅
Bóng chày chuyên nghiệp Trung Quốc	中華職棒
rừng	林
Lý tưởng	伊德
cưỡi ngựa	骑马
Súng	鯀
quái thú	獸
Nương náu	避難
Morpholine	啉
Địa chỉ hiện tại	現址
Tiangong	天宫
Đã nói là	說為
cho	供
mức cao mới	新高
kênh	信道
giải phóng	释
với	仝
chảy máu mũi	衄
Cheng	程
Thành phố thiên tân	天津市
Âm mưu	圖謀
Đã đặt hàng	奉命
Alberta	亞省
đảo	島嶼
Hu	烶
Kiểm tra	稽
Ngày 25	二十五日
Ao	岙
Wa	娲
Nhà ga xe lửa	鐵路車站
Ở châu Âu	在歐
Dòng đầy đủ	全線
Làm sao	奈何
tập quán	風俗
cửa	門
xoay	轉
đào sâu	深化
Vật trưng bày	展品
Ảnh bìa	旗帜
cá mập	鮫
Con dấu cổ	古印
Tong	榼
Diễn dịch	诠
Vòm miệng	齶
chính thức	官方
ma cà rồng	吸血鬼
phần thưởng	獎勵
hoa sen	蓮
cao	嵬
Kilomét vuông	平方公里
Một đường thẳng	一行
tập tin	銼
Tổng biên tập	总编辑
Nàng tiên	仙人
nước chảy	滮
Lu Guo	魯國
đồ gốm	陶器
Độ C	摄氏度
con rối	木偶
ngày	日
một nửa	一半
Hai	兩隻
đã sẵn sàng	已經
Câm	惇
Dựa vào	靠著
dân số	人口
Chỉ có	只會
cao nguyên	高原
lòng bàn tay	櫚
Kangding	康定
Đánh nhau	爭
xanh xao	憔
Sống sót	幸存
chậm	慢
xe điện ngầm	地下鐵
phép ẩn dụ	比喻
tổ	巢穴
Lớn	大
Tháng sáu	珺
Dưới thành phố	城下
Phải	必定
Khuyến mại	晉升
Eo biển Đài Loan	台海
Dòng đơn	单线
bánh crepe	縐
năm	年
sương mù	雾
thối rữa	槁
niken	镍
Shino	篠
Giữa chúng ta	們之間
kẹp	拑
xin lỗi	歉
chuyển vùng	漫游
Bí mật	隱居
Tuyến tính	线性
Đau khổ	受降
Nam giới	雄性
đế chế Ottoman	奧斯曼帝國
Sau khi chết	逝世後
Puja	法会
Chân tay	肢體
Tuyệt vời	奇妙
Tần	鄃
cái ghế	椅子
vặn to lên	到場
hiện nay	此刻
Qi	觐
Roman	罗马人
Xinhui	新会
Noichi	野市
Tỷ lệ biết đọc biết viết	识字率
Đã hoàn thành	落成
thai nhi	胎兒
Xi	溵
Gao	鮜
Tẩy	除去
Phong	馿
bà ngoại	祖母
mùi thơm	香味
Không	没有
khối đá	礅
giá cổ phiếu	股價
thương mại hóa	商业化
Zhen	繨
gián tiếp	間擔
Huian	惠安
Tín dụng	片尾
Jiande	建德
tốc độ cao	高速
Sirius	天狼
Trang điểm	妆
Đếm theo	數以
mồi nhử	囮
Tajikistan	塔吉克斯坦
Một quả bóng	甲球
Glen	盂
kinh nghiệm	經歷
Ờ	额尔
cây mao lương	茛
Từ	源於
sự can thiệp	干擾
Trái bóng	皮球
Người phụ nữ cao tuổi	媪
làng	村
Khép kín	闭合
Nhân văn	人文
giao tiếp	沟通
Sau cuộc họp	会后
Rocky	洛基
Trung úy	中尉
Thân hình	機體
New England	新英格兰
lẫn nhau	互相
người Tây Ban Nha	西班牙人
cầu vồng	蝃
Máy ảnh	攝影機
Monaco	摩納哥
bước lên	蹋
vài	少数
Cùng với nhau	一併
Ngâm chua	腌
Sự tập trung	集中地
Jesus	穌
giáo xứ	教区
ấm áp	煖
Trong và ngoài nước	海内外
Đầy	閖
Ai	嗳
tiêu cực	消極
Thế vận hội	奥运
Dàn nhạc	管弦樂團
chuyển	輸送
cằn cỗi	瘠
Treo	刽
Triết học	哲
Viễn Đông	远东
Arizona	亚利桑
Lệnh cấm	查禁
sự bành trướng	扩张
phóng xạ	放射性
Ren	佋
mạnh	強烈
nước chảy nhẹ	淰
điều đáng tiếc	愍
nhãn hiệu	牌
phức tạp	復
Kan	侃
ẩn	隐蔽
Ngạc nhiên	惊讶
Từ chức	辭任
Số đền	廟號
Sanmin	三民
Cặp này	這對
Trái	左側
Tên nick	暱稱為
Ibis	鮹
đồng rúp	卢布
Di truyền	遺傳
bỏ trốn	逃逸
Nhưng không	而沒
Zhong	仲
Sự thanh bình	安樂
Huân luyện viên trưởng	主教練
chủ tịch	会长
bộ xương	骨架
Nhưng đúng	但對
đất	地面
cái mền	毯
Chaga	察合
Hum	吥
Đông Á	東亞
rung chuyển	搖
Khoa Toán học	数学系
Trúng tuyển	选出
khung	帧
Thống nhất	团结
Hiệu sách	書處
Lựa chọn	選拔
Sản xuất	所產
lực lưỡng	仡
Tần	溱
Đánh dấu	剔
Nặng	重達
Qi	虅
Chia	多爾
Bẻ khóa	裂解
khởi đầu	开工
Ghế	席位
Lửng	羍
Đảm nhận	承辦
Amazon	亞馬遜
Than khóc	嗌
Tao là	道在
trích xuất	提取
Hòn đảo	該島
Trận đấu	赛会
Đình công	來襲
Quay	紡
phương tiện truyền thông	媒体
nhân viên văn phòng	軍官
sai	訛
Tên khai sinh	原名
Cá chép	鲞
con cò	鹳
Nạn nhân	災民
cái mũi	鼻
Với Liu	與劉
hội chợ	公平
của tôi	雷
Michael	麥可
nhận định	辨認
nghệ thuật	藝
Đồng bằng trung tâm	中原
Phân loại	歸化
Hậu duệ	子孫
nhận thức	意识
Tăng cường	加劇
Nhưng bởi vì	卻因
cuộc tổng tuyển cử	大选
trái chuối	蕉
Sẽ vượt qua	會傳
Hyun	铉
Yong	鏞
chảo-	氾
Chiên tranh du kich	游击战
Timu	帖木
Trượt tuyết	斯基
dâu tằm	葚
Trực tiếp dưới	直属
Sau khi sinh	生後
Jianhua	建華
Châu Á	亚州
Nội dung	容
Hồng quân	红四军
giảm	削减
Lớp học đầu tiên	一流
De	壾
vẫn	依舊
Cho đất nước	為國
nhìn xuống	閺
Beitun	北屯
Hình dạng bên	邊形
mí mắt	瞼
trở ngại	障礙
bộ lọc	濾波器
Yama	亚马
chủ tịch	行長
nút	節點
toàn bộ	总计
Kenny	堅尼
Tháng sáu	筓
Hãy ngạc nhiên	愬
Định vị	定位
ram	公羊
Cá sấu	鰐
tiêu điểm	焦点
giun đất	蚓
Một nét	一筆
Cá chép	鯇
Thấy trước	预
đau khổ	罹
cadmium	镉
Trận đấu	配
cái hộp	箱子
Âm	枔
Báo cáo	檢舉
Thất bại trong cuộc bầu cử	落選
Đạo quân số tám	八路军
lấy trộm	偷
cuộc tổng tuyển cử	大選
Nazhou	那州
Cuối mùa	季末
gập lại	折叠
Thiết lập về	著手
Ghi công	归属
mục	項
tinh ranh	隉
Ga hành khách	客站
Phao nổi	漂浮
Các ngôi sao	星辰
Giám sát	督办
Ký tên	示牌
Sau đó từ	則從
Yi	侹
âm mưu	畦
Hy vọng	有望
Po thủy giả	深水埗
Chu kỳ bán rã	半衰
Quận Đài Bắc	臺北縣
Bor	博尔
bổ sung	額外
Thường	常被
nồi cơm	餗
Canoization	冊封
Không có	未经
Ra hoa	花期
cơn lốc	烈風
Tiếng Tamil	泰米尔
Tham khảo	泛指
hiệu suất	性能
Yi Ku	一揆
Chung	聯同
Renzong	仁宗
Thông đồng	勾結
Nhận được	受
Trò chơi	运会
Âm	覀
Sắp có	即将
máy móc	機
chương trình tạp kỹ	綜藝節目
Thấp hơn	較低
Weir	韋爾
Tượng hình	象形
Trạm không gian	太空站
bánh xe	轱
Chạy	跑步
và	竝
Cửa khẩu phía Bắc	北門
Đi đến	去往
cabin	小屋
tuổi trung niên	中世紀
khu mua sắm	商場
Còng	镢
Thủ tướng	首相
gia sư	導師
chỉ đạo	政區
Tỉnh Cam Túc	甘肃省
Chi nhánh	分行
thân cây	茎
Họp nhóm	隊會
Xuân	瑄
quá khứ	往事
gian hàng	榭
Buồn phiền	娭
khom lưng	鼪
Sri Lanka	斯人
nghiêng	倾斜
Som	索姆
bỏ trốn	逃亡
Warner	華納
khăn tắm	巾
Ngu độn	密集
Nhu la	諸如
Làm phiền	扰
Chủ nghĩa cổ điển	古典主义
tích lũy	累積
tu sĩ	僧
Nhiều phòng	多間
Cá sấu	鳄
Kêu la	呼喊
Thay đổi thànhbắt đầu ở	改屬起源於
Nắm bắt	慔
Bán dẫn	半導
Độ hòa tan	溶解度
dễ dàng	易
Allie	艾莉
Ling	潾
ngạc nhiên	讶
mở rộng	漭
Rumba	伦巴
Cứu trợ	赈
hoạt động	活跃
Huyện	區設
Thủ lĩnh	領兵
đuốc	炬
ngoại ô	城郊
vây chậu	腹鰭
Els	爾斯
Được khen là	譽為
Yoshio	義雄
chuông	贝尔
nếm thử	尝
Số năm	五個
cát	砂
Mở sau	後開
Giữa dòng	中游
Kueh	粿
Trường học	办学
mẹ	孃
chính sách	政策
Sẽ	將之
Trận chiến	之役
Phòng Tuyên truyền	宣传部
Mao	茂
Thị trấn tộc	族乡
Loại A	甲型
Và bởi	並經
Zhi	濜
Dòng trường	場線
Dài	荜
Năng suất	降伏
ngày và đêm	昼夜
Thứ hai đến	次于
bảng quảng cáo	公告牌
đánh răng	嘲笑
Hệ thống quân sự	兵制
Đài phát thanh	電臺
Tấn	珣
Sư đoàn	司
lời tiên tri	预言
Helen	海倫
Thời gian gói	束時
dây đai	縧
quân khu	军区
Ali	阿利
Hưng thịnh	兴盛
Bing	昺
người đầu tiên	第一
sâu	深切
Sốc	震驚
Heber	希伯
hoàn thành	完毕
Lông mi	睫
Nhị hoa	雄蕊
sách	书籍
mục lục	指數
bạo lực	暴力
Ping	萍
Gà lôi	鉹
tiếng vang	迴響
mũ	絻
Cảnh sát	警官
Đăng phần	季後
Phân kỳ	歧
Ngựa thánh	圣马
cánh đồng	野外
Ghana	加纳
Cá bọ cạp	鲉
gánh trên vai	掮
Vách ngăn	分區
chết vì đói	殍
Ápraham	亞伯拉罕
Sự sỉ nhục	凔
Flo	佛洛
Dojo	道場
tín dụng	信贷
Phần lớn	大都
Ontario	安大略省
cọc	楬
chỉ	剛好
Vách đá	崖
gecmani	鍺
bụi bặm	塵
Cỏ	草丛
King Hui	惠王
Cùng với	亦與
Il	伊尔
Căn cứ	為基
học phí	學費
Pell	佩尔
Sẽ được với	會與
lười biếng	邋
nhẹ	温和
Jian	譇
Đào rãnh	絰
chữa khỏi	治愈
Trụ sở chính	總部
Thành viên	員則
Đấu	所罗
kẹp tóc	釵
Mở	為開
hình ảnh	圖畫
chuyến thăm	探望
Tròn	一輪
làng	村庄
Làm phiền	擾動
Đó	那裡
cảm thấy	感到
vi khuẩn	菌
khôi phục lại	恢復
Ủy viên	專員
General Electric	通用电气
người Trung Quốc	漢語
Các môn thể thao	体育运动
trợ cấp	补贴
gò đất	堽
xương bánh chè	臏
thử	设法
Sự phẫn nộ	忿
người ủng hộ	支持者
Tự tử	自盡
Abbe	阿貝
Pian	鈫
Đồng ý	贊成
Moore	莫尔
để mà	為了
Quận và	區和
Wei	韦
Sanjiang	三江
Thành phố Hồ	湖市
Phạm tội	犯案
Thẩm Dương	瀋陽
Phá vỡ	断
nổi danh	知名
Cardi	卡迪
thứ mười sáu	第十六
nước chảy	洊
Hạt Đài Đông	臺東縣
Công bố	刊登
chị em gái	姐妹
bỏ trốn	逃避
Duyệt qua	浏览
Showa	昭和
Hồ chứa	水庫
tuần	周
Giải thưởng âm nhạc	樂獎
Hai người	兩人
Xuyên qua	透過
Cần thiết	必需
Zhu	昬
kích hoạt	活化
Wan	渢
Trung Quốc ở nước ngoài	僑
Bệnh đến chết	病死
yêu cầu	声称
kẻ cướp	匪
Gan Ning	甘宁
Trao đổi với	換來
Số một	头号
lòng bàn tay	手掌
khung	幀
Nữ diễn viên	女優
Anh yêu	达尔
Zhen	缜
dài hạn	永久
Chịu	小熊
Slavich	斯拉维奇
xâm lấn	忮
Phòng vệ sinh	洗手間
Sakiho	崎步
Âm	胔
lợi nhuận	盈利
Lập kế hoạch tổng thể	統籌
quanh co	歪
Tấn	荍
Sudan	苏丹
chính xác	確切
chớp mắt	眨
Delin	德林
Streak	连胜
Bayi	八一
Còn thiếu	失踪
Nói	所說
gốc	原点
Nie	乜
Trường chi nhánh	分校
Huyện hành chính	行政區
Sẽ	才會
truyện cổ tích	童話
kẻ phản bội	宄
Lâu hơn	較長
thứ sáu	第六
Ngốc nghếch	楈
Vòng đeo tay	鐲
Sla	斯拉
Xenlulo	纤维素
foment	罨
cửa tiệm	商舖
mài ngọc	砺
mù lòa	失明
Dốc	漸變
không bao giờ	决不
sự trả thù	復仇
indium	銦
xuất sắc	熿
bản văn	文本
cuộc phiêu lưu	冒險
Stalin	斯大林
Biển và bầu trời	海空
Nói	發聲
Đổ	汖
Xác định với	認同
phần	部分
Sinh vật đáy	為底棲性
vui vẻ	姁
Đền thờ	神宮
sự hối tiếc	憾
Luân	栾
Ghế	机位
bởi vì	因为
Citi	花旗
sự coi giư	保管
tấn công	發作
Tòa án	苑
Shao	髡
Xương bàn đạp	蕫
Không lớn	不大
Xuân	燨
Lên đến	量達
Tiệc	馂
Hy vọng	預計
thay đổi	改動
yêu và quý	戀
Pao	舂
Có sẵn	可用
Họ Dianthaceae	竹桃科
Triều Nguyễn	阮朝
Lushan	庐山
Lai	赉
Tuyuhun	吐谷浑
Pang	逄
thông thoáng	清楚
trang nghiêm	庄严
sức ép	壓力
Bida	桌球
Nghỉ làm	下班
Chester	彻斯特
Đối thủ	反对者
New Guinea	新幾內亞
Do nhà nước điều hành	国营
phép nhân	乘法
phức tạp	複合
hoàn thành	完畢
Pingjiang	平江
Gran	格蘭
Yi	鮴
đá	踢
Mùa xuân và mùa thu	春秋
Lỗ hổng	空隙
Satsuma	薩摩
thần mặt trời	太阳神
Giữ	抱持
quốc phòng	國防
Làm	制定
phân biệt chủng tộc	种族主义
bộ phim	電影
hợp đồng	契約
Hăm dọa	胁
Titanic	鐵達尼
cá chép bạc	鲋
Sendai	仙台
Cũng thế	还要
ICAC	廉政公署
Huh	咇
tập hợp	合奏
Quê cũ	前國
hành vi	行为
Cairns	凯恩斯
Tas	塔斯
Tài liệu tham khảo	參照
Và hệ thống	與製
Dòng vào	流入
Luo	雒
Của chúa	神之
đội	球隊
Nguyệt quế	桂冠
Rơi vào	法伦
uy tín	名声
bươm bướm	蛺
mặt trời	孙
xoắn	搓
Về mặt toán học	数学上
Zhu	麫
Người hướng dẫn	指导员
Riêng biệt	另行
kỹ thuật	工程
Quinone	醌
Nhọn	夏普
Trung Quốc	鄕
Điều lệ	章程
Tốt	好好
Chiyo	千代
Tiết kiệm	存
sau	經過
Chánh văn phòng	参谋长
quý giá	早熟
Bắt đầu	起步
Treo	穣
con quạ	蠷
nhà phê bình	评论家
Công nghệ	科技
khôi phục lại	恢复
Bệnh nặng	病重
Đối với	至於
biên tập	编辑
Sự phân hạch	裂變
Hérault	埃罗省
Hiệu suất	績為
chơi	嬉
Ravioli Trung Quốc	馄
Mecklenburg-Vorpommern	梅克伦堡前波莫瑞
lười biếng	傴
Jing	璬
Michel	米歇
Ngưỡng mộ	慕
Chọn	選人
Gửi quân đội	派兵
Bắt chước	效法
nói chuyện	谈论
Suy nghĩ	思维
máu trắng	白血
hậu cần	后勤
Cho tất cả	為全
Đặc sắc	精选
Đóng quân	进驻
tải	装载
Tướng quốc	國將
Gián đoạn	間會
Li	槺
dự trữ	儲備
Phim hoạt hình	卡通
Âm thanh	聲器
Yong	烒
hồi sinh	复兴
scull	橹
Abba	阿巴
Lối ra phía Tây	西口
yêu cầu	请求
Seine	塞纳河
Mùa	赛季
Lãnh đạo đảng	黨領
thời gian này	这次
năm	歲月
Giác quan	感官
Yoshida	吉田
Yonglu	永祿
Ying	瑛
nước dâng lên	泩
lạy	踣
Nam Á	南亞
Cải cách ruộng đất	土改
nghỉ ngơi	休息
Los Angeles	洛杉矶
thuộc kinh tế	经济
nghị viện	议会
hy sinh cổ đại	畤
Kashmir	克什米尔
Qi	琪
Giáo viên và	師與
Bầu	當選
mưa nặng hạt	大雨
đất sét	垆
Không bạo lực	非暴力
thất nghiệp	失业
Minnow	鰷
Yong	瀄
Augustus	奧古斯
bài hát nhịp	唄
Đội và	隊與
nước tù đọng	渟
Eisenhower	艾森豪威尔
Sau khi phục hồi	復後
Hãy cẩn thận	小心
Khi nào	在當
Xuân	烄
Cổng phía Nam	南门
Sever quan hệ ngoại giao	斷交
cung điện	宫廷
Sân bay quốc tế	國際機場
Thị trấn	市镇
Kun	鍹
quần áo	服裝
Li	鱎
King Kong	金刚
Bangkok	曼谷
Snipe	鬹
KMT	国共
Người biểu tình	示威者
Chúng tôi mở	們開
Chấn lưu	碴
quyền lực	威力
Chen Bai	陳百
Mead	米德
Choáng	噅
Kernel	内核
Máy móc	機於
đau khổ	蒙受
hư hỏng	腐化
Khung	桢
Bong	奉
Saitama	埼玉
Fanzhi	藩置
kiếm	賺
Chuyến bay đầu tiên	首航
Os	撾
Cây thông	樅
Xin	澭
Đất nước phía đông	該國東
Cùng loại	同型
gậy	杖
suy luận	推断
Trực tuyến	在线
Cole	科尔
phổ biến	支持率
Giờ làm việc	工時
tinh tế	細膩
Biên tập	剪辑
Dương	杨
theo chiều dọc	縱
màu nâu tối	黑褐色
Ban ngày	日間
Làm việc cùng nhau	協力
Họp thư	信會
Lai	籁
Xử lý	辦理
Và nhỏ	與小
Hàng ngàn	成千
Ý tưởng	構思
Lai	灱
xuyên qua	亘
Âm lịch	農曆
Đa dạng	各类
Tranh giành quyền bá chủ	爭霸
Kem	淇淋
Yên tĩnh	蠏
một chiều	单向
áo choàng	氅
hướng dẫn	導引
York	約克
Trừng phạt	罰
phút	分钟
đến hạn	应有
Núi hổ	虎山
Ting Yan	廷琰
Tây An	荂
Ban đầu	原為
Đàn bà	妇女
Cronies	親信
uy tín	名誉
làm sao	怎样
Kunlun	昆仑
Chưa	尚
tập giấy	墊
Được rồi	眾對
rơi vào	落入
đôi pho vơi	周旋
Wei	暐
chỉ trích	挍
năng lực	天賦
đơn âm	音素
cho phép	允许
Giảm xuống	淪為
khung xương sườn	肋骨
Kaiyuan	開元
Kêu la	囂
Không chiến	空战
Nhầm lẫn	徃
động lực	动机
mang	進位
bóng râm	翳
ý kiến	意見
Có thật không	真是
Số thị trấn	鎮號
Làng	村落
Quá nhiều	過許
tại chỗ	當場
Causeway	銅鑼
Biến cố	盛事
săn bắn	畋
Vịnh King	景灣
Thị trấn mới	新镇
Thành phố thường châu	常州市
Quay lại	囘
Giải pháp	溶液
Fu	苻
Tình cảm	戀情
Nas	納斯
Xỉ	渣
Phòng triễn lãm	展览馆
video	视频
Hai nơi	兩處
quyến rũ	魅力
sự kiện hiện tại	时事
uống	喝酒
Nhiều hơn	再於
Nika	尼卡
Wo	渥
Đánh nhau	打鬥
nhìn trộm	窥
Ngày 1 tháng 5	五一
Kẻ trộm	盜賊
Tốt hơn	更佳
thân hình	机身
Giới luật	戒律
Hướng nam	朝南
Siêu tân tinh	超新星
Yan	皃
Mới cưới	新婚
Cây	树木
Bài đăng	岗
Gần đây	近期
Làm rượu	釀酒
Edinburgh	愛丁堡
công việc xuất sắc	佳作
Rồng biển	海龍
Chức vụ	職位
Dệt	編織
hiếp dâm	強姦
người Pháp	法語
Tuổi trung niên	中古
Căn cứ	基化
Phát hiện	侦
san hô	瑚
chuyển khoản	轉車
em trai	弟
Hiện	現身
thử thách	挑战
Số hai	二號
Jedi	绝地
Tago	塔哥
Macka	麦卡
Trong luc đo	其间
quân dai	裤
Ruột	膽
Airport Express	機場快
buồng	櫉
Điều tương tự	亦同
cống	澮
bắt giữ	拘
Học	攻讀
Tuen	屯
Trường học	该校
giết người	谋杀
cành cây	杈
bốn mươi mốt	四十一
Nghiêm nghị	厉
mùi thơm	馣
thái bình dương	怗
bá Vương	霸王
đo lường	测量
trạng thái	狀態
Quyết tâm	慑
Lần trước	历次
Aude	奥德省
Wei	巍
Khủng khiếp	祟
Khoe khoang	展示
Đã xả	出院
Quận mới	新区
bộ sưu tập	採集
Chó	獓
Đối với điều này	對於這
chuyển động	运动
thang	阶梯
Vở kịch	该剧
trở kháng	阻抗
Thành phố	該城
Căng ra	延展
bạch kim	白金
Thomas	托马斯
Kazuo	一夫
vách đá	巉
qui định	规则
Học hỏi	习
Trong cuộc họp	會中
Đặt	普特
chất lỏng	液
Dẫn điện	传导
Biến đổi	變數
Trường trung học cơ sở	附中
Tên đã dịch	譯名
Huy chương	奖牌
săn bắt	追击
nỗi sợ	畏
thương vong	傷亡
Vân Nam	雲南
Alva	爾瓦
Shi Yong	時擁
mạng lưới	聯網
Lợi nhuận	營利
Dãy chính	主序
Cú	鴞
Họ và tên	全名
triết gia	哲学家
con bò cạp	螰
Ngọn núi tuyết	雪山
lưới chim	罻
Tan Zhen	滩镇
Quốc gia	各国
Euclid	欧几里得
tanh	腥
Làng	庄村
Posterity	后世
nhóm	團體
nghẹt thở	哽
bạch Mã	白马
Thành phố	直轄市
Căn cứ	进制
Tổng giá trị	总值
sự ion hóa	电离
công cộng	公众
Người dân	市民
Món ăn	餸
Dai	岱
Fucheng	富城
nhạc sĩ	音乐家
giấy	纸
Đau	籖
lời tiên tri	讖
Amu	阿穆
Cướp bóc	洗劫
Yu	雚
Murray	默里
hoa mẫu đơn	牡丹
khối lập phương	立方体
Xe buýt	巴士
Nhóm giải đấu	組聯賽
mũi tiêm	注入
Biến ngẫu nhiên	随机变量
kích thước	大小
Anshi	安石
Điều khiển	控制權
Mới	新兴
Cơ chất	底物
Mười tám năm	十八年
nông nghiệp	耕作
vĩ độ bắc	北緯
bản đồ	地图
hữu cơ	有机
dọn dẹp	潔
chi tiết	細節
Khuyết tật	残疾
Thành tựu chính trị	政績
thủ công	手工业
Kanazawa	金澤
Vui lên	欂
Kéo dài	加長
Burren	伯倫
Tìm ra	算出
Xếp hạng	榜第
Roosevelt	羅斯福
khai báo	申報
Báo cáo rằng	报道称
Nhân loại	人类
Shah	沙阿
Lenovo	联想
Đội	班子
hình trụ	壔
Nghề nghiệp	職業
Phân loại	归化
Chết	驾崩
Cuộc tổng tuyển cử	總選
Kẻ huỷ diệt	逐艦
Hongwu	洪武
truyền tải	傳輸
ở ngoài	以外
Trình độ	度約
bồn tắm	澡
Âm	儤
Phòng thờ Phật	佛堂
Nghiên cứu	研究型
Xây dựng lại	重修
ác quỷ	魔王
bạch Mã	驃
Tan	澹
Saint dan	圣但
Làm rượu	酿酒
trả	赔
Kết thúc	端的
Honolulu	檀香山
Trung tâm	森特
Khán giả	全場
Để lộ ra	暴露
Người chiến thắng	得主
Moro	摩洛
bố trí	鋪設
Sang trọng	有類
Cây sồi	奥克
Tình dục	发性
Theo này	依此
Đức ông	法王
người phục vụ	服务器
phun ra	浡
Saki Line	崎線
giải pháp	觧
Thuốc	药用
Allah	阿拉
bằng văn bản	成文
con mắt	眼睛
Nhìn	看
Kiệt sức	殆尽
lễ hội âm nhạc	音乐节
Coi như	視作
Ở ngoài	之外
bằng cách ấy	从而
Đường chính	干道
tám mươi	八十
A-xít a-xê-tíc	醋酸
vỏ trái đất	地壳
thuộc địa	殖民
Khoa	學部
Tiêu điểm	重點
Năm ngày	五日
Chính thức hóa	式化
Babylon	巴比伦
Đường vòng	繞經
Roe	獩
Không bao giờ	从来
người làm nhỏ	鯫
Lợi nhuận	利
Dodd	多德
năng lượng	能源
Vương miện	王冠
Bị liên lụy	卷入
rửa	澉
Hồng Kông	本港
Ge Liang	葛量
súng	枪
vết trầy	撓
nhựa dẻo	塑料
Số ba	仨
diễn hành	阅兵
quét	扫描
Tainan County	台南縣
Sau đó được gọi	則稱
Tại cuộc họp	会上
tính từ	形容词
Concord	协和
Fukuda	福田
Phim Mỹ	美國電影
Trộn	混成
Nghiêm nghị	厲
Nhánh ngôn ngữ	語支
sức mạnh	强度
quý bà	娘子
Xuande	宣德
Quê nhà	籍贯
Kẻ huỷ diệt	驱逐舰
con bò cạp	蠰
Số và	數與
Nuôi	飼養
Jiang Zhongzheng	蒋中正
mộng	枘
Nêm	楔形
Lục địa	大陆性
tha thứ	容忍
Dòng là	線為
Khi nào	時為
Con gái	千金
Cũng từ	也從
tràng hoa	花冠
Tây An	釚
Burr	伯尔
lá thư	书信
Sơn tây	山西
Và phải	而對
Trò chơi này	本賽
Zhu	踭
Nhà Thống đốc	督府
bùn lầy	浑
Kai	闿
Thời gian cũng	時還
Những con gà	鷄
Chữ số	位數
Sự khiêu khích	釁
Quận Kwun Tong	觀塘區
không ai	沒有人
gian lận	劈
Chồng và vợ	夫妻
quan tâm	兴趣
địa phương	地方性
Houli	後黎
Cái thìa	勺
bực bội	惱
hành	獵戶座
Nổi bật	杰出
Guanzhong	關中
Hoa Kỳ	美國國
đại sảnh	會堂
Chuan	涱
Chơi chữ	鸃
ngân hàng	银行
Biên tập	編
áp suất cao	高壓
người độc thân	单打
Assyria	亚述
Sum họp	留尼
độc quyền	獨家
Aham	阿含
bắn	开枪
Ngon ngọt	雋
nguyên âm	元音
khách hàng	客戶
Vendé	旺代
truyền hình nhiều tập	电视剧
ngủ	寢
Bạch	巴赫
Jiu	櫿
Quốc gia	國民
nghề thêu	黼
Võ thuật	武术
Vẫn	仍為
Dallas	达拉斯
sơ cấp	初級
che	掩盖
mỏ neo	錨
Đặc trưng	功能
Xuất khẩu	导出
phỏng đoán	猜测
Tang	梮
Du kích	游击
bằng phẳng	扁
đột ngột	忽然
thờ cúng	崇拜
Đánh	創下
Gaozong	高宗
Thức ăn vòng	環食
khát vọng	送氣
rỗng	窾
Madagascar	馬達加斯加
Nhà Hán	汉代
tàn sát	惨案
Mang hành lý	载客
Nip	壓區
California	锎
Koizumi	小泉
Tân trang	翻新
thông minh	优秀
thống trị	主宰
Kiêu ngạo	顜
thói quen cho ăn	食性
Trung ương cộng sản	共中央
Đến	來當
Buồn phiền	憕
giáo dục	教育
Hoàng hôn	暮
Đánh trống	打鼓
chứng chỉ	证书
Hu	瑍
Thép	鋼
Kyushu	九州
bia đen	奘
cộng đồng	社群
dấu vết	迹
đốt cháy	点燃
Tháo rời	拆卸
Bang Mu	州牧
Tưởng tượng	奇幻
Bạc	银色
Nho giáo	儒
Điều chỉnh	調
cho thuê	租賃
Ou	讴
Thước vuông	平方呎
California	加利福尼亞州
Vốn nhà nước	州府
chuông	鍾
trang	頁
Sẽ đặt	會把
Để hiểu	了解
phanh	轫
Từ chức	離職
Háu ăn	饜
Phía tây	西邊
Iso	伊曾
Xấu hổ	龀
Cá	捞
Đi ra ngoài	出去
đã chọn	选
Thành viên gia đình	家屬
Nanyang	南洋
Khoảng thời gian	區間
Xiongzhou	雄州
học kỳ	學期
nhà giam	犴
Trong năm	年內
đào	掘
ghế đẩu	糞便
Bị liên lụy	涉及
Wei Jin	魏晋
thị trấn Kennedy	堅尼地城
Abi	阿比
Điểm	地步
mệt mỏi	纍
Kỹ thuật số	数码
Ưu tiên	首选
Suy sụp	滒
Với quân đội	與軍
vé máy bay	车票
Tải xuống	下载
Tất cả các loại	种种
Tseung Kwan O	將軍澳
Hu	籺
Gửi	传送
sản phẩm	積
đối diện	对称性
Mộ Dung	慕容
Hồ nước	湖水
cả người	全身
Anh ấy là	他為
Giáo viên	師範
Shahe	沙河
tập quán	習俗
Một lát sau	後再
Tuyệt quá	凖
Buồng lái	舣
xảy ra	发生
Người kế vị	後任
Tấn	暁
Saito	齋藤
Kamakura	鎌倉
họa sĩ	藝人
Tiếng Mông Cổ	蒙古族
Hàng hải	海事
Dòng chảy	径流量
Thủy bồn thảo	景天
tì vết	玷
Tỉnh Sơn Đông	山東省
Yi	羵
axit sunfuric	硫酸
Qian	鑚
thay thế	取代
Gan	肝臟
thành phố San Diego	圣地亚哥
quan tài	椟
Nguồn khách hàng	客源
Mọi nơi	各地
tích lũy	累积
phần lớn	大部分
trái cam	枳
De Gaulle	戴高乐
cán bộ	干部
Hồng quân Liên Xô	苏联红军
Wuyishan	武夷山
An	嵞
xoắn	捻
Xie	蕒
ống chân	踦
Người thay thế	代入
Làm	訂立
hoa cúc	菊花
người Anh	英籍
nhà hóa học	化学家
Nước	蕹
Phi	披
Hy vọng	预计
Karlsruhe	卡尔斯鲁
Nhân dân tệ	塮
Ma Ling	马铃
Hướng dòng chảy	流向
Ayi	阿伊
Thiết bị đầu cuối	航站楼
hoẵng	麂
Với một	與一
quang phổ	光谱
Âm	餎
mục đích	确定
Quận Đông	東縣
Dương châu	揚州
Hui	晖
lũ lụt	氾濫
Gram	克
chủ quyền	主权
Nhà và	家與
Được đặt tên	名叫
sự xuất bản	刊物
người Pháp	法屬
Châu Âu	歐
Uzbekistan	乌兹别克斯坦
chắc chắn	堅定
trắng	懷特
búp bê	玩偶
Pang	蠃
nhận được	接收
Mờ nhạt	搴
Trận đấu	搭配
cô đơn	瞏
cà vạt	絷
giảm	缩减
cô đơn	孤独
thí dụ	範例
Lun	鎾
Carl	卡尔
đau ốm	生病
chuyên chở	传达
tiên tri	先知
Quân đội	陸軍軍
Liên tiếp	歷任
Ngắn	短短
bóng da	踘
Thành bang	城邦
Có nghĩa	意指
khỉ	獼
La	叻
lãnh sự quán	领事馆
Phiền muộn	窪
Hoa sen	蕗
Bang	泜
trận đấu	匹配
Thành phố Keelung	基隆市
Lodz	罗兹
Cà kheo	蹺
Số Pi	邲
thường xuyên	经常
Cho ăn	餽
Sao chép	湑
ven sông	河边
Khó xử	蘁
Thành phố	辖市
Chân thành	摯
Chang	苌
Tòa án	考特
Đi xuống	下來
Đặt nằm	奠
Chìm	淹沒
Tương lai	未来
Khoa học công nghệ	科学技术
đau buồn	忉
Âm	狔
Răng nanh	魦
Phần phía sau	后
bẻ cong	屈
Xoáy thuận ngoại nhiệt đới	溫帶氣旋
Piauy	皮奥伊
Mei Yan	梅艷
Có điện	與電
cả hai	俩
tử thi	屍
Kun	堃
trung thành	忠實
Zong Shi	宗時
Băng thông rộng	寬頻
Liên tiểu bang	號州際
buồn	傷心
Không còn	不复
Bực bội	桄
Fuman	夫曼
Bồ đề	菩提
răng	牙
Đính kèm	附著
Kun	稐
Hou	堠
Dehe	德河
Viato	维亚托
Xa nhất	最遠
vào ban đêm	夜间
Ming	拺
Những người lính	将士
yêu nước	爱国
Quân đội	军政
tối thượng	终极
Đức phật	佛陀
Chartres	沙特尔
tiên phong	拓荒者
cắn	咥
Chi nhánh	汊
Cuốn sách lịch sử	史書
núi	山地
Quản trị quận	縣治
phỏng theo	适应
Lai	萊
Hát	婇
trung tâm thành phố	市中心
Bãi mìn	雷区
Chính phủ trên	政府於
Ga	嘎
con đỉa	蛭
Word	字詞
Ba loại	三種
Thang máy	升降
Chức vụ	职务
Sáu	六部
nhấn mạnh	应力
Supercharge	增压
Ngồi về phía bắc	坐北
Băng nhóm	鷞
Khuyến khích	嘱
Tầng lớp trung lưu	中产阶级
P	犘
Nhón	搟
Dạy lòng nhân từ	教仁
Gao	皐
Châu Á	亚洲
Người biểu diễn	演者
Bị bắt	被捕
Sàn nhà	層
Được dùng như	用作
Kerr	克尔
thế hệ	辈
Đường	路途
dây cương	辔
bi kịch	悲剧
Zhu	篙
Dân sự và quân sự	文武
bờ Tây	西岸
Olympi	奥林匹
Bọc thép	披甲
lừa đảo	骗
hang	窟
Tàu vũ trụ	航天器
Vancouver	温哥华
tôn kính	榮譽
Xinmin	新民
Thư gửi	信給
Vui mừng	欢
Thương hiệu mới	嶄
Pu	氆
cạnh	邊緣
Malaysia	大馬
nơtron	中子
Chấn thương	伤病
Khu Dongcheng	东城区
Vương quốc	演義
bay	蝇
giật mình	駭
Dante	但丁
Và đỏ	與紅
dựa vào	恃
Trường cặp	場對
quyền trượng	珽
hơi nước	蒸汽
ý nghĩa	意义
Burrough	伯勒
Fadi	法第
bệnh hoạn	痾
cùng ngày	同一天
không	非
tích phân	积分
đi bộ	躘
Ah	阿
Cây rơm	栈
Nhận vào	入学
dịp tốt	机会
Hạt Yuan	媛縣
khuôn viên	校园
đánh bại	败
bàn cờ	枰
rouge	臙
dọn dẹp	洁
phía đông	东
Loach	鰮
Plutonium	钸
Nội tuyến	直列
Tất cả các cấp	各級
cảm thấy	感觉
Bà ấy	畬
Bài đăng	发文
đối đầu	对抗
khoai môn	芋
Hướng đông	往東
Lan và	蘭與
Akkad	阿卡德
Blas	布拉斯
trơn tru	平整
Xuyên tâm	徑向
Los Angeles	洛杉
Tàu điện	電聯車
cho ăn	哺
Nhà xác	殓
Yu	褙
Doming	道明
hai mươi lăm	二十五
Pipit	鹨
Xương cựa	黄芪
lối đi	通道
Mạng lưới	聯播網
Thiết bị quang học	光器
Báo cáo	举报
tương ứng	相应
Hệ thống chính thức	官制
cồn cát	沙丘
Một nửa thứ hai	後半
chai	瓶子
Victor	維多
cây lau	葭
Hanshui	汉水
Bảo hiểm	保險
Tìm kiếm	搜尋
Marsau	馬紹
Súng	槍枝
ngũ cốc	粮
Xuất hiện	外型
Xa lánh	捈
Ôm	胅
Keng	铿
Sân	中庭
thủy triều	潮
ngày	天
Siêu sao	超巨星
Zhongzheng	中正
Thua	亏损
Tát	磱
học nghề	学徒
Tổng doanh thu	总收入
Gera	格拉
cây rìu	鉞
âm thanh	声
thêm	加號
Xiao	簫
Chính thức thứ hai	次官
Charlotte	夏洛特
dịch vụ	役
Hoàng sơn	黄山
Tantali	钽
Bị	受過
số lượng	量
cản trở	傺
Vội vàng	奔赴
Tàu sân bay	航母
Takeda Shin	武田信
Trong	場於
Thuê	聘请
Nạp điện	充電
con vượn	猿
Hoàng đế Càn Long	乾隆帝
Dehua	德華
Sinh ra	降生
Quan thoại	普通话
Lu	閭
chính xác	究竟
Tường thuật	述
Giao banh	侍
Hiệp hội	协
Âm	縜
bên bờ biển	海濱
Yoshino	吉野
xây dựng	建築
Hàn Quốc	朝鲜人
Pit dừng	进站
Đá	搖滾
Một thiên hà	一個星系
sự phân chia	師
Phim ngắn	短片
Vẫn là nước	泖
Ngọc bích	楡
quyền tự trị	自治
Đa dạng	各類
tiệm thuốc	药房
Jingguo	經國
Nhọt	癤
Bei'an	北安
hầu hết	差不多
Đầu tiên	首間
Kênh	频道
Wige	威治
phi tiêu	攄
ở lại	畱
Smash	掓
Shao	筈
bom	彈
Cái gì đó	有事
Hun	珲
bánh lái	舵
Indiana	印第安纳
Đoàn nghệ thuật	文工团
Uống rượu	饮酒
Ngốc nghếch	螲
cá	魚
Hội nông dân	農會
phòng vệ sinh	厕
Niz	尼茲
Rong	戎
Thang máy	舉
Fukushima	福島
Splendens	芨
Thẳng đứng	立柱
Thị trấn	市鎮
Phòng ngự	防守
thần học	神學
Vận tốc xuyên tâm	徑向速度
Chính trị và luật pháp	政法
tòa án	球场
sân bay	機場
trợ lý giám đốc	助理
giai đoạn hai	二期
Kết hợp	作賽
Posterity	後國
Gar	噶尔
Âm	鼱
chim ưng biển	鹗
cầu thang	楼梯
Anh trai	兄长
con rối	傀
Atta	阿塔
Mở ra thế giới bên ngoài	对外开放
Gia cố	加固
Terman	特曼
Chúa Trời	上帝
bất kỳ ai	任何人
Bảy	七個
lấy mẫu	采样
Dina	迪纳
Không có thời gian	間沒
Kinh doanh	商贸
phòng	廎
Ở gần	迾
Yu	钰
chiều rộng	宽
Phản công	反击
Xie	燮
Niêm phong như	封為
Jongmyo	宗庙
Pum	噔
Liaodong	辽东
Chan	鍰
chủ tịch	行长
Miễn phí	弗里
Kết án	句話
Zimbab	津巴布
Tamarisk	柽
Tạo nên	创
Mô hình	模特兒
Bang	梆
Chủ tịch	董事长
Đã từng thấy	見過
khóa học	课程
Goethe	歌德
mạch đập	脉冲
Pu	溥
Trường đại học	学院
Ngoại thương	对外贸易
chiến trường	战场
sự thích nghi	改編
Jue	爵
Xuân	軒
Làm việc trong	業於
Trước khi chết	生前
long não	樟
tống tiền	脧
thừa kế	繼承
siêu	超级
Nucleotide	核苷酸
đối ứng	倒數
Hội đồng cơ mật	枢密院
Đối đầu	对峙
Erde	额尔德
cây tre	箬
Dài	茏
mang	攜
quái thú	兽
Giao dịch	交易
Mahala	马哈拉
Con gái	女郎
Nực cười	襌
Ít con	少子
mặt khác	對方
Chu	蛥
Barr	巴爾
chuỗi	连锁
Provence	普罗旺
tiếp diễn	連續
Toyota	豐田
vì kèo	桴
Khuyến mại	升班
Học tập cá nhân	個學
Nhiệt độ	氣溫
kiếm	挣
Quận Ku	庫縣
Thanh Châu	青州
cửa hàng	囤
Rửa	滌
mu	畝
Chongzhen	崇禎
Tấn	鉓
Yong	邕
kiệu	轝
đang phát triển	发展中
Đây là	這在
toàn bộ	總
Nhật thực toàn phần	日全食
Chao	潵
Từ	們從
Nam Cực	南極
kiểm tra	攷
Con trai của	的兒子
chế tạo	製造業
Âm	垞
Shu	姝
ngành công nghiệp	业
nghiêm khắc	严格
Đầu nguồn	分水岭
Thùng rác	豳
Nhẫn	袨
đông Đức	东德
Đúng thời điểm	時對
Sely	塞利
Châu Á	亞人
Chỉ tồn tại	僅存
Thiên An	天安
ân xá	赦免
Doanh nhân nước ngoài	外商
Ngọc trai	璸
Yu	鼆
Thiết lập như	訂為
sự phấn khích	激动
theo	追随
Nhầm lẫn	対
Mệt mỏi vì	厭
sự trả thù	报复
Gạo nếp	糯米
Kì nghỉ hè	暑期
Khai quật di tích văn hóa	出土文物
Jue	珏
rối loạn	动荡
Qi	蘄
Jing	璺
Bảo vệ	侍衛
leo lên	進行
Tàn phá	蹮
Lượt xem	观点
Kỹ thuật xây dựng	建工
ở giữa	当中
Cấp quận	县级
Thời gian và không gian	時空
bằng phẳng	平面
đảng phái	党人
than phiền	抱怨
Maxwell	馬克士威
cấp	年級
chúng tôi	我们
Triều đại nhà Tùy	隋朝
Ra mắt	登场
Hàm	頜骨
Hoàng đế	上皇
Khu công nghệ cao	高新区
Giải tán	解散
thành viên	会员
Cầu	大橋
uống	飲用
cừu con	草坪
Atlanta	亚特兰
nước Đức	徳
không xác định	不详
Thành phố phật sơn	佛山市
cứng	坚硬
tập trung	浓
Cách chơi	玩法
thâm nhập	滲透
Jingshi	京師
chỉ dẫn	指令
dao găm	匕
kho báu	寳
Bướng bỉnh	悢
Turing	图灵
Là	廼
Dong	垌
con vẹt	鹦鹉
Khu vực giải phóng	解放区
áo choàng	袍
co thắt	痙
bọ nước	蚨
căng ra	伸展
Nhà tranh đã lợp mái	草堂
Tai Tam	大潭
Rác rưởi	箚
Cheng Gui	成桂
Arachniodes	耳蕨
Thư viện	库
Tàu cao tốc	快艇
Shin	胫
Yi	佖
dữ liệu	数据
Mộc lan	玉兰
câu lạc bộ	俱樂部
Liaohe	辽河
Thoát trở lại	逃回
Sảnh đợi	遊說
chày gỗ	檇
Jimmy	吉米
Oss	奥斯
Nước Lào	老挝
Quảng Sơn	光山
Dalai	達賴
Cá rô	綱鱸
Xingying	行营
Khám phá	探
Xịt nước	喷
Quân đội Pháp	法軍
đồi đá	岨
Facebook	臉書
đại sảnh	厅
Người sản xuất	制作人
Lựa chọn	遴選
praseodymium	镨
Madonna	瑪丹娜
nghệ nhân	工匠
Què	蹛
tàn nhẫn	狠
Tây An	西安市
Chắc chắn	商行
môn học	主语
tìm thấy	發覺
gadolinium	钆
xem xét	考慮
Hoàng đế	大帝
Santo	城主
Bảo vệ	护卫
Il	伊爾
Tòa thánh	教廷
gặp gỡ	会议
Đen	黠
Mandela	曼德拉
Va trươc đây	與前
Đi với	來與
Sài gòn	西貢
Phi cơ	飞行器
Phong phú	多样
Phần giữa	中段
Chơi lên	上奏
an toàn	安然
cầu vồng	隮
Einstein	愛因斯坦
phái viên	使节
Khiêm tốn	憼
giải phóng	發布
tình hình	局势
máy dò	探測器
chết	殒
bia đá	碣
Om	唵
Latin	拉丁语
Biệt thự	别墅
Vội vàng	急行
dơ bẩn	臟
Kwun Tong Line	觀塘綫
liên đoàn	級聯賽
gặp gỡ	会晤
Sau khoảng thời gian	時間後
Lời nói hòa bình	和談
Báo chí	报业
Và	嵹
Được	要為
Wei Zhan	衛戰
Hung dữ	鏖
Người ta nói rằng	听说
Yongan	永安
Sway	士威
Tây du ký	西游记
Đi lên	上去
sa hoàng	沙皇
Ghen tuông	撗
Calton	爾頓
bộ xương	骨骼
Lớn	大型
Tang	梣
marathon	馬拉松
Giá cả	代價
Đánh	撞擊
Sông Zha	溠
thêm vào	添
Yêu cầu	聲請
Trung gian	中间体
Tuyến đường sắt phía Đông	東鐵綫
Fujiwara	藤原
Trang web này	本站
xù xì	毿
Ứng tuyển	適用於
Từ	可從
Âm	瀴
chăm sóc sức khỏe	保健
lo	忧
Dinh thự	邸
thượng nghị sĩ	參議員
Người phục vụ thường xuyên	常侍
Chỉ còn	僅剩
Dài	澯
Người dự trữ	斯德哥爾
Cấp độ 2	二级
Tham gia chính trị	參政
khởi động	启动
Đối với hoàng đế	為帝
Diana	戴安娜
Phần lớn	蕞
trang điểm	化妝
Giải thưởng	爾獎
Loại này	该种
Cấp cao nhất	頂層
Tiết tấu	殴打
Cao siêu	崇高
Tokugawa	德川家
óc	大腦
Đường thẳng	直路
đá lăn ầm ầm	硍
phố cổ	老城区
ranh mãnh	猾
Theo luật	依法
mở rộng	延长
Quan niệm	构想
khác nhau	異
Yalu	耶路
Hậu thế hệ	代後
Phúc lợi	祉
Chiều cao	身高
Tiếng Mông Cổ	蒙古语
Bột giấy	浆
Người phụ nữ cao tuổi	嫗
cố vấn	參贊
Bị thương nặng	重伤
Cape Verde	佛得角
Li	莉
Hidemo	秀茂
Số tàu	车次
chế độ độc tài	专政
quét	扫
Kus	庫斯
mang	擕
công nghiệp hóa	工業化
Thắng lợi	胜
Mảnh mở rộng	资料片
mặt trời	菼
ngôi sao	星
bùn lầy	泞
Phù sa	冲积
hài lòng	愜
Tan	湲
cấp độ	层次
Bên trong chùa	寺内
dược phẩm	醫藥
Heisenberg	海森堡
Chiến thuật	战术
Shao	歠
Xì hơi	昪
Henry IV	亨利四世
Quang điện	光伏
Anh ta	他於
Lắng đọng	沉积
Shao	厏
âm thanh	声音
sự hiểu biết	把握
ngã	跌落
khúc côn cầu	曲棍球
Văn phòng	辦公
đau đớn	疼
Hoạt động	運營
Giám đốc	廳長
Nan	柟
sự vi phạm	违反
Cánh tay	兵种
bản quyền	版權
Và thay đổi	並改
quí	珍贵
mòng biển	鷗
ngồi xổm	踞
Rút lui	退守
Sửa	修缮
Khi ra ngoài	出時
sưng lên	肿
Giữ chức vụ	任职
Đối với vốn	為資
Grandstand	看台
Alabama	阿拉巴马
Phi hành đoàn	劇組
Đi lang thang	羅夫
tham	貪
Sự quyết tâm	测定
Albert	艾伯特
Gọi	致电
nhân vật phản diện	小人
Kalimantan	加里曼丹
Giường	河床
chuyển khoản	调任
Hanno	漢諾
nhóm lò xo	灥
Nâng cao	晉身
Săn bắn	獵殺
nói chuyện	噂
Nghiêm nghị	艎
Đếm	計有
Sắp xếp	包辦
Ren	侊
Zhu	擙
gì	孰
Âm	竤
Thành viên và	員與
Ollie	奥利
Bren	布倫
Rút lại	收回
Xikou	溪口
Ye	鑁
Xingshi	兴市
Dọa nạt	忬
Derain	德兰
Yun	暀
Po Kong	蒲崗
Dựa vào	憑
Ngoại vi	外圍
Tuyển chọn nhân viên	員選
Trong tương lai	日后
ký tên	迹象
Qi Guo	齐国
Bức tượng nhỏ	俑
chất thải	浪費
không trang điểm	縵
Thiên nga	鷫
Zhu	罯
Vua của trời	天王
Đầu tây	西端
Phong cách cũ	舊式
Cú	枭
Tấn	潯
Hai mươi sáu	第二十六
cuộc phiêu lưu	冒险
Con tôm	鹀
liên bang	联邦
điểm	點
Tuck	楖
armadillo	犰
Ra mắt	首張
Phân phối	經銷
khó khăn	强硬
Indy	印地
Thủ đô	的資
chỉ	剛
Xấp xỉ đường dẫn	徑約
Nồi	炓
Đại lễ	盛典
Phương trình	等式
Nghìn hộ gia đình	千戶
Siwei	斯維
thân hình	身
Căng ra	抻
Apa	阿帕
Quận dương	阳县
hái	諏
Trưởng thị trấn	鎮總
hoàn thành	完整
Trường kinh tế	经济学院
thành tích	成就
chi tiết	详细
Wo	妭
Sức khỏe	厣
thăm dò	勘探
Làn sóng	揮
Đứng lên	廝
Tiền nhiệm	前身
ngày lễ	放假
phòng bếp	厨房
cập nhật	最新
Làm lơ	無視
Yellowstone	黄石
Hiểu lầm	誤以為
Rhine	莱茵河
Kiên nhẫn	病患
trở nên	成為
Chu	漻
tự động hóa	自动化
Yu	瑜
Ba vương quốc	三國時
ngủ trưa	盹
ZTE	中兴
Perth	珀斯
Thông thoáng	澈
Giai đoạn này	這一時期
Lâu đài	城堡
Nhận biết	結識
chạy	奔走
tách biệt	僻
Thành phố đặc biệt	特別市
Không bao giờ	有史以来
Loài	物種
Xing'an Ling	兴安岭
Nguyên âm	韻母
Chú	叔叔
Soái hạm	旗舰
Đài kỷ niệm	纪念馆
Bướng bỉnh	詄
kẹo	糖果
Hạt Chuan	川縣
tập thể	集體
Sinh ra	出世
Gia	吉亞
phản chiếu	体现
tiêu diệt	殄
thiếu sót	缺少
thưởng thức	欣賞
Sự giống nhau	類動
Eo biển Calais	加来海峡
của chúng tôi	敝
Một lần	一次性
Sinda	辛達
Các thế hệ	世代
Hồi sinh	重振
Vắt kiệt	榨
Rap	说唱
nâng cao	增進
đặt mái chèo của một người vào	干涉
thế giới	世界
Tenberg	滕贝格
trang web	网页
Lời nhắc	促使
Dari	达里
răng không đều	龉
Tàu số	號列車
Tâm sự	心腹
Usher vào	迎來
Cảm thấy	感受
Cho đến chết	处死
Hohhot	呼和浩特
Toàn bộ khu vực	全区
Điều khoản khác	杂木
Gu	瓘
Số Pi	淠
Longshan	龙山
Công nghiệp dịch vụ	服务业
Hu	翜
Ming	溂
Kiếm sống	为生
Lịch sử	歷代
Xấu	不善
tín hiệu	信号
bò húc	犍
Quận Đông	东县
Chung	常见的
Jie	昷
Tỉnh	讷省
Trẻ em	大三
bệnh truyền nhiễm	传染病
sau Thế chiến II	二戰後
Tin tức	讯
trạm xe buýt	巴士站
Danh tướng	名將
khỏe	細
Cùng với	連同
Khớp lệnh	賽階
Barney	巴尼
bánh ngọt	骹
nhọn	尖锐
Aveyron	阿韦龙省
Kéo ra	拉脫
Ravage	蹏
Hans	汉斯
gosh	暈
huỳnh quang	荧
Trung Quốc và Ấn Độ	中印
thờ cúng	朝拜
Thành phần	份子
cầu chì	引信
tin đồn	謠
dấu	標
Chặt đầu	斬首
kế hoạch	計劃
Barton	巴顿
Hát	唱歌
Planck	普朗克
Thục Phi	淑妃
người Hy Lạp	希腊语
ĐổĐốt sống	柖椎
Lis	力斯
quạt	箑
Tăng lên	陞
Một phần của	部份
Lỗ Tấn	鲁迅
cắn	啃
Ngoài thị trấn	外地
ví dụ	譬如
Nam Á	南亚
Phía đông	東邊
pháp luật	定律
đánh rắm	屁
lên bờ	岸上
Mạch	電路
Thân cây	篋
Nar	纳尔
sách	冊子
Đảo dài	長島
Tàu không gian	太空船
Miao	苗族
nguyên	原本
Tong	佟
Ba chiều	立体
Và Đài Loan	與台
quán ba	拦
Floren	佛罗伦
Kỳ lạ	奇異
Nhẫn	擂台
lâu năm	多年生
Thành phố do quận quản lý	縣轄市
Gaddafi	卡扎菲
Vẽ lên	擬定
con tin	人质
Cảng Victoria	維多利亞港
Vị trí	位處
cởi	起飞
Hoa hồng	蔷薇
Không chỉ	不單
Biết rõ	諳
Đề cập	涵盖
Súng phóng lựu	榴彈發射器
Qi	侒
tranh luận	辯
phân loại học	分类法
Zhuzhou	株洲
Được giới thiệu	出台
Nhựa	树脂
Hội trưởng	总司令部
Cấp thị trấn	乡级
Satoshi	聰
cây kê	粟
Gadolinium	蒆
sương mù	霾
Jiacheng	嘉誠
Tái bản	转载
Khuôn khổ	构架
Cuộc hẹn	任免
khóa	锁定
đám mây	云
Kiêu ngạo	僭
người phát ngôn	发言人
nắm lấy	逮
đứng gần	支持
Biện hộ	倡导
Hinder	礙於
tham nhũng	腐敗
Do dự	犹豫
Dong	栋
Đường chéo	对角
đúng	权
Được chấp nhận rộng rãi	廣受
Thành lập	創辦
Laco	拉科
Không để	不致
giá vé	票價
rụng răng sữa	龆
Diêm	個賽
Hui	蕙
Nghiên cứu	究
Nhậm chức	就任
Về Tp.	約市
quý ông	绅士
Tưởng tượng	虚
Thuộc về	屬
Seongnam	城南
Được	分得
Xếp hạng	收視
Mười hai ngày	十二日
Ở Trung Quốc	駐華
Danh sách rút gọn	入圍
cơn ác mộng	魘
Thời gian	個時
Quét	横扫
đỉnh cao	頂尖
Hội chợ triển lãm	博覽
sỏi	碎石
Cái nút	按鈕
Thủ đô	資
Bột nhồi	擊隊
Dwell	寓
thông thường	通常
Phân khu	細分
hiệu quả	效率
muộn	已故
bên	邊
đẹp	美
Yi	弋
bài học	教训
Pas-de-Calais	加来海峡省
con vượn	蝯
khoáng sản	矿物
máy vi tính	計算機
Mặc	配戴
Khán giả	觀眾
Yi	诒
ăn mặc đẹp lên	打扮
Chu	菿
con ma	鬼
chỉ	放映
siêu nhiên	超自然
Ít	略特
Stego	斯德哥
Chuyên nghành	专
tà ác	恶
Tách rời	分隔
sách	书
Gọi cho	号召
Honshu	本州
vùng lân cận	环境
khu vực	区域
Ôn tập	审查
khai trương	大奖赛
phía đông	东面
Bộ	訂定
Đông Nam	东南部
Bộ lạc	部族
tinh dịch	精液
Đúng	右方
Lịch sử	史都
Chu	矗
Lanren	兰人
hiếm hoi	罕有
phát biểu	言語
Zhe	冖
Ngoại thất	外觀
Kinh tế và Thương mại	经贸
tuyên bố	声明
Đơn hàng con	亚目
martingale	鞅
nhanh	翛
xe điện ngầm	地铁
Bảng đen	篮板
Stilbene	茋
que diêm	一場比賽
tỉnh lẻ	省级
cái sau	後者
Volt	伏
bệnh tiêu chảy	瀉
cây gai dầu	痲
sự đối xử	治療
Taki	泷
địa điểm	放置
Tin	相信
Thây ma	殭屍
Ba tháng	三個月
quảng cáo	廣告
tiên phong	开拓者
Tham khảo	指称
Phí cho	費為
Hoài Hải	淮海
Măng xông	袖
Sớm	上旬
Nuo	傩
lạm dụng	滥用
Qunchen	群臣
quyền phủ quyết	否決
Bạn	禰
lười biếng	懶
Quân đội	軍政
Đồng nghiệp	同工
Đường phía bắc	北道
rung chuyển	擞
chế tạo	制造业
Ngôi sao	星人
Han Shi	漢時
ăng ten	天線
Wagtail	鶺
Ở trên	上方
Ling	漴
Assyria	亞述
Cher	谢尔省
H	犺
lễ cưới	婚礼
thẳng thắn	直接
Dân thường	百姓
cân nặng	重
nhà hàng	餐馆
Đã ký	簽訂
Mờ nhạt	洀
hú	嗥
Yun	潚
Yu Ying	於英
mẫu	圖樣
Đầu vào	進氣
Tường	牆壁
Long não	莰
liều lĩnh	伥
tiêu	花费
phát sóng	播送
Bình luận	评
Quốc gia trung quốc	中华民族
Thẳng thắn	直達
Sáng tạo	創意
Lớp là	層為
Tiếp xúc	接洽
Hôm nay	鼎盛
Xinghua	兴化
đói bụng	饥
địa phương	地方
Phi tập trung	下放
Xe thể thao	跑車
Seattle	西雅圖
Ngôn ngữ và	語與
áo choàng	岬
gãy xương	斷裂
triết gia	哲學家
Đa chiều	多维
Lớp học	級的
Latin	拉丁
mập	脂
Từ xa	远程
Bộ phận kỹ thuật	工程系
Đã sẵn sàng	已然
xuất hiện	容貌
Linh hồn	灵魂
tấn công	攻擊
Trùng hợp	適逢
Bắn	射殺
hậu cần	後勤
đạt được	獲得
lừa đảo	騙
Ma	玛
Ono	小野
nhật thực một phần	偏食
Ho	嗬
Gốc	原屬
Tòa tháp	城楼
Chắc chắn	明定
Yi	貽
Sowa	索瓦
Yi	佅
Thay đổi lại	再改
Học theo cặp	對學
Lạm dụng	虐
kiệt sức	罄
Sau cơ thể	體後
Lớp thứ hai	二等
Yo	哟
thành phần	组成
Đánh	命中
Ngọt	飴
Câm	倄
mềm mại	柔和
Zhimen	直门
Để biết thêm	為多
Ft	夫特
Lington	靈頓
lần nữa	再
Ứ đọng	瘀
Ngoài ra	另外
Pháp luân công	法轮功
sự hy sinh	牺牲
Ye	迵
vì thế	故而
Tiếp cận	臨近
nền tảng	礎
Người trả lời	應器
Khép kín	闭包
Âm vị học	音韻
hơ qua lửa	熯
Beauvais	博韦
Bộ chiến tranh	战部
Dahua	大化
căn cứ	壘
Cũng thế	還要
Thiên nhiên	自然界
đang yêu	恋爱
chung	关节
Tháng sau	月後
cây búa	搥
keo dán	胶
Vòng xoay	自转
Xơ vải	敤
Yunlong	云龙
Ellis	艾利斯
Shao	讙
pháp luật	律
Ống kính	鏡頭
Chỉ định	指派
ngã	坠
Và sau đó	與當時
Mitte	密特
hứa hẹn	有为
chào mừng	迎
Hưng thịnh	茂盛
Cá chình	賝
Ming	溘
Xuất sắc	叱咤
Phân loại Kronqvist	克朗奎斯特分类法
Suncheon	順天
Keimoto	庆元
hoa tiêu	航海家
Gali	加利
thuận lợi	矞
Trên ngựa	在馬
nhận con nuôi	采纳
Mặt phẳng	側扁
Ga	尕
ghi chú	筆記
Yeat	耶特
giấy	紙
Được dùng cho	用於
nổi loạn	謀反
Xi	皙
Augsburg	奥格斯堡
Quyi	曲艺
Vị trí chính thức	官位
Sự thay thế	置换
Trưởng lão	中會
chủ nghĩa hiện thực	现实主义
Yorkshire	約克郡
màu xanh da trời	藍色
Quốc gia	國
Slovenia	斯洛文尼亚
Zhe	者則
bày tỏ	表述
Tanggu	塘沽
Trang Chủ	家
Hàng trước	行前
Yong	墉
Thành viên của đội	隊成員
Trang	特朗
rau xà lách	沙拉
Streak	連勝
Cố ý	有意
số sê-ri	編號
Đã trở thành	化為
Định hướng ngành	業為主
đóng cửa	扃
tên giả	笔名
Sau sự kiện	事件後
Yamaguchi-gumi	山口組
ở đằng trước	前锋
Sự khác biệt	分化
nhà vua	王者
Tong	硑
Philips	菲利浦
Yun	郠
không khí	大气层
Giai đoạn thứ hai	二段
Giới hạn tốc độ	限速
Huệ Châu	徽州
Từ	是從
Thủ tướng	丞相
Ấn Độ	印第安人
Jingzhou	荊州
sự công nhận	承認
Thô	粗
nhà ở	屋宇
quen với	忸
Treo	鸿
Điều này	这部
Đối ngoại	外務
Hấp	煆
Đất ngựa	馬地
Hạt	珠
Hội nghị thượng đỉnh	峰会
Ít hơn	小于
thành phố Manchester	曼城
Trước chiến tranh	战前
Bayer	拜耳
lịch trình	日程
ác quỷ	魔神
Chất xơ	縴
Choáng váng	愇
Uy tín	美誉
Vẽ lên	撘
Rêu	莫斯
Thân hình	体形
Cái đầu	髷
Sau chùm	束後
tấm ảnh	攝
Quận Gang	岗区
Oda	小田
Đà điểu	鸸
đống	堆
Trang điểm	湊
Trận chiến	之战
Linh thiêng	神聖
Ji	瑎
nang	葖
Lãnh thổ mới phía Tây	新界西
mũi tên run	掤
đá hoa cương	花崗岩
Tay và chân	手足
thu hoạch trong vụ thu hoạch	穑
Dài	垯
Chạy xuyên qua	貫穿
cỏ ba lá	苜
rau diếp	莴
Vùng phát triển	發展區
Hoài	槐
Nho giáo	儒家
Những người yêu thích	哥特人
Nehe	讷河
giữa năm	年中
Tất nhiên	然
tiếng Nhật	日语
Xấp xỉ	約為
đau khổ	惄
Max	馬克斯
Wan	琬
lỗi	過失
Yi	幤
Normandy	諾曼第
Đi bộ	歩
riêng tư	私營
Gower	高爾
nghề thêu	黻
khi anh ta	當他
Wu	芜
kaoliang	秫
Tây Ấn Độ	西印度
máy bay	鉋
Sông Nile	尼羅
Nằm	座落
Kiềm chế	斂
ngắn gọn	简洁
Bộ thương mại	商务部
Giẻ	襤
Su	為蘇
Trường hợp	個案
Đồng thời	並發
Vòng	迴圈
Tường	沃爾
đã nói	辐
Sự xuất bản	出版品
cá đuối	鱝
Wu Trung Quốc	吳語
song phương	雙邊
Nhiều hơn	更於
Chính thức	职官
xây dựng	大厦
Thượng Kinh	上京
một số	一些
Tận dụng tốt các	善用
mà đã thực hiện	表现
ngọn lửa	火焰
Đội số	隊第
Thống nhất quốc gia	國統
Armenia	亚美尼亚
Kỳ quặc	第奇
giết chết	殺人
Bản ghi nhớ	备忘
chi phí	開支
thuốc nhuộm	染
Thịnh vượng	旺
Văn xương	文昌
Chân thành	忱
Vừa và nhỏ	中小
Theo dõi bởi	隨後於
Đôi nam	男双
Ôm	豀
Chúa Trời	神明
Quinine	喹
biên kịch	編劇
số phận	命運
Hai lần cuối	後兩
giá trị	值
Bu	卜
Xuân	禤
Tang	諅
Outfitting	舾
trận hải chiến	海戰
Jiong	迥
Cục Di tích Văn hóa	文物局
nơi	斑點
khuyên can	劝阻
chính xác	精確
khóa học	航向
triều đại	王朝
Một tay	一手
cốc ngọc có tai	斝
THOA	民建聯
Đảo nhỏ	胰岛
Promethium	钷
Thái độ	态度
vệ tinh	卫星
Ba lan	波兰
Hoàng tử	太子
một lát sau	後来
Chất ô nhiễm	污染物
Tuổi thọ	長生
Mới	新建
quả mọng	莓
Đúng	哉
Cắm trại bên phải	營權
Ngày 16	十六日
Srilan	斯里兰
ánh của đá quý	瑳
sự cuồng tín	狂热
Kete	克特
chỉ có	祇
Mao	茅
Chicago	芝加哥
điện báo	电报
tiết tấu	椓
xe buýt	公交车
Đấu thầu	招標
Lưu trữ	托管
đường khắc	瑑
xây dựng	修築
ghi âm	录音
Bồ công anh	蒲公英
Tiếng Mông Cổ	矇
Mạng lưới đường sắt	铁路网
Mùi	聞及
Scopole	鏪
kêu	呶
đập	水坝
đến	往
chấn thương	創傷
Chỉ	顯
Lên lịch	計約
học nghề	徒弟
Với cơn gió	飘
đột biến	突变
Hoa	綻
chuyển tiếp	過渡
chuyến thăm	访
Ana	阿納
Mức nước	水位
nâng cấp	升級
ngủ ngáy	齁
Nghệ thuật	文艺
Wu Sheng	武胜
buồn	恻
bon muoi chin	四十九
mỏ neo	椗
Liên kết	聯合會
trường cao học	研究所
cung cấp	提供
cửa sổ	窗戶
hồi phục	復甦
Thánh địa	圣地
Thật	確
Trường học	黌
Lei	耒
Bang Sao Paulo	圣保罗州
Có thể tiếp cận	可達
Nước màu đen	黑水
nữ diễn viên	女演员
pao	鎊
Bảo vệ quyền lợi	维权
Mit	蜼
Hiểu biết	默契
phòng	房間
men	酴
Chạy	阰
Tan	榳
lợi nhuận	利润
Viết	寫法
khử độc tố	脱氧
đi bộ	跞
Chi	茌
Yu	窛
đột biến	突變
Nhân mã	人馬
Quận trung tâm và phía tây	中西區
Shenmu	神木
Đóng quân	進駐
con vịt	鸭
Isomorphism	同构
Tích cực	陽性
Hát	梼
Gal	加尔
Ding	臢
cạnh	緣
Được trang bị	裝有
Ngạc nhiên	驚訝
Khen ngợi	好評
Kêu la	嚣
Xizheng	西征
Sẽ trở thành	會成為
đầm lầy	沼泽
Hu Feng	胡风
Ze	澤
Dệt may	紡織
hoàn thành	齐全
khổng lồ	鉅
Hoàng hôn	旰
Tát	耹
Cần phải	須經
Trung gian	斡旋
Một số loại	數種
Thị trấn lâu đài	城下町
Đường bờ biển	海岸线
Lo lắng	惙
cho phép	容許
bạo kích	临界
Âm	瀗
loquat	杷
Giả vờ	裝親
Juan	珦
ngã tư	路口
Cổng thành	城門
Nhận	接到
Lith	立特
kho	廒
Rất nhiều	多多
Phần còn lại	餘下
Không bao giờ	从未
Pao	檕
Cuốn sách này	此书
Polaroid	寶麗
Sở hữu	佔有
công tắc điện	開關
Laba	拉巴
Lực lượng sản xuất	生产力
Pala	帕拉
Lính chì	带兵
nguyền rủa	罵
Vải	布料
Staf	斯塔夫
Leon	莱昂
Quý ông	君子
Hệ tọa độ	坐标系
đỏ tươi	绯
cánh đồng	领域
Giới thiệu	介绍
Bị giết	遇害
Vô hiệu hóa	禁用
Hát	燐
kẻ thù	敌人
Mùn	葎
Tuyến Đảo Hồng Kông	港島綫
cà vạt	扎
Ba lan	波蘭
Đầu tiên	先是
Jimo	即墨
Các vị vua	金斯
Nụ cười	笑容
đứa con hoang	私生子
Răng nanh	鮧
Sheng	笙
Al	阿勒
đời sống	生活
Chức vụ	职
đập	壩
Omentum	网膜
Đường ô tô	車路
Hát và nhảy	歌舞
Di cư	移居
Tùy chọn	选项
Plover	鸻
Liechtenstein	列支敦
Chỉ huy quân đội	武將
Sống ở	居于
Lãnh thổ	属地
Rhone	罗纳
Băng nhóm	冈
Quy mô lớn	大举
Fen	棻
Dịch	译本
cao	嵯
Biến đổi	可变
Ham học	好學
Năm mươi sáu	五十六
Hăm dọa	脇
ẩn giấu	躲藏
bối rối	棼
Được lấy từ	取自
giám sát	显示器
Cheng	郋
Quận này	本區
Cung điện Hoàng gia	王宫
Tao	道
Nhiều	罗得
Bobby	巴比
Bóng chuyền nữ	女排
Làm sao	豪
hạn hán	乾旱
Shao	岹
Hiện tại là	是現
din	豗
Viết như	寫為
Giải bóng chày Major League	美國職棒
Què	跦
Phiếu thưởng	劵
cửa sổ	窗户
yến tiệc	宴會
Quê nhà	老家
Huh	咗
Anton	安东
Xin	辛
Của Liu	劉氏
từ	自从
đống	砢
nâu	褐色
Ting	葶
bình minh	曉
Tầm nhìn	视野
Hàng trăm	数百
Món ăn	食邑
Chu	蓜
hình thành	成型
Chú	舅舅
Chuyển hướng	引水
khó khăn	艱
Phục vụ như	擔任
hiểu biết	识
Ningbo	寧波
chú ngựa vàng	金馬
Bộ sưu tập	集英
Huyện	區則
Belarus	白俄罗斯
nôn mửa	涒
Kẽm	鋅
chia tay	告别
Hải	亥
Zhu	篛
Gauss	高斯
Nộp hồ sơ	立案
hội đồng	理事会
Okayama	冈山
Từ	自來
Jevic	耶维奇
Tai County	台县
đánh dấu	蜱
Nghẹn ngào	窒
ống	管
cộng sự	搭档
Trước	此前
tuyên thệ	誓
Mẹ	巬
Sức cản	電阻
tăng cường	激化
Độ dài sách	書長
Tiết mục	剧目
Guiwei	癸未
Thêu	绣
Vượt qua	渡过
Mặt khác	另一方面
dây cương	轡
vết trầy	挠
tín dụng	功劳
Họ Gentianaceae	龙胆科
Vui mừng	驩
con bò cạp	謖
Sẽ sản xuất	會產
tập phim	插曲
Tấn công	襲
hoàn toàn	全然
AIDS	艾滋病
Cục Trung ương	中央局
Hun	琿
Tây An	芏
Lan tràn	撒
phản đối	对手
Âm	埻
thùng đựng rượu	卣
Đóng cọc	樁
Chuyển tới	遷至
Quan trọng	至关重要
Quên	遺忘
đá giống như ngọc bích	瑂
Biệt đội	小隊
Hậu vệ	守軍
ban đỏ	癜
San Francisco	三藩市
Stephen	史蒂芬
Độ cao	高程
nóng bức	辣
độ cứng	硬度
vùng ôn đới	温带
Nghe	听到
kế toán	会计
Allen	艾倫
Dệt	織
Giáo dân	下人
Dòng chảy bên trong	内流
con bò cạp	蠍
Băng nhóm	铘
Phần phía sau	後
Quy định	调控
Azole	唑
Bảng sau	下表
Thrush	踫
nhảy	舞
Umbelliferae	伞形科
Đường phía bắc	北路
Dạ tiệc	加拉
Cây tầm ma	蕁
Dây vàng	金丝
Yi	乛
Thời chiến	戰時
thắng lợi	嬴
Thương mại	商用
chung	共同
mặc	穿
Ngã xuống	倒下
Thần chú	真言
Brezh	勃列日
dự báo	预报
Cá sấu	鱷
thời thơ ấu	童年
Trận đánh	格斗
Một lớn	一個大型
cơm	饭
nhiều hơn	大於
Mái vòm	圆顶
Khách mời	作客
kính thưa	亲
Giải cứu	救起
Li	酈
Thay thế	更替
Mahler	马勒
triệu	百萬
nươc trai cây	果汁
Đối với không	為沒
Phòng hòa nhạc	樂廳
Thân cây	樹幹
Đối với họ	對他們
Sau khi tăng dần	即位後
cờ	幟
Hồ tây	西湖
Lang thang	孨
Quận Đông	區東
bùn	泥
bận	忙
Hai	兩個
Dongjin	东晋
con bò cạp	鞉
Thành phố và	市與
Tên giai đoạn	藝名
Thu hút	誘
Tốt	徴
cháu gái	孫女
ngữ pháp	文法
Thuê	聘請
Ánh sáng và bóng tối	光影
Ronald	羅納德
Nhạc trưởng	導體
Sub cho	子為
Dali	大理
Vonfram	鎢
Ashoka	阿育王
Tách rời	分立
Jian	謇
Chính quyền tỉnh	省政府
Người Đài Loan	台語
ý nghĩ xấu xa	慝
Luân	鸞
Do	會因
Ngâm chua	醃
ngon	可口
Saint	圣者
Vũ Xương	武昌
thực hành	作法
Cạnh tranh	競
Hamilton	汉密
Bulbul	鹎
Giai đoạn đầu	前期
Victoria	維多利亞
Đường núi	山線
Xu Xiangqian	徐向前
Yilin	依林
Lạc quan	看好
hai mươi giây	第二十二
Luộm thuộm	鋢
Xấu hổ	蹪
Chính sách	策
tinh thần	靈
Montpellier	蒙彼利埃
Ningbo	宁波
Góc dưới	下角
phương hướng	方向
Cả làng	全村
Nishikawa	西川
Đánh nhau	抗争
Lyle	萊爾
Háng	胯
Đại Hưng	大兴安岭
Phố đi bộ	步行街
Đồi phía Bắc	北山
Con nai	鋍
Trận đấu	賽會
Qiao	硚
Kỹ lưỡng	阐述
Yong	塒
Lar	拉尔
Yan	鄇
nhà máy điện	发电厂
Rơi vào	陷入
Irving	歐文
ngựa nâu sẫm	驖
Tại thời điểm	之時
S	論
Sau khi đội	隊後
Lexus	凌志
Sáng	辉
Thùng đựng hàng	貨櫃
Hua	驊
Cân	衡
Nhặt lên	占
Taki	塔基
Mã Anh Cửu	馬英九
Cả hai mặt	兩側
Riêng	樞密
Steve	史提夫
Giáo dục	教育学
Địa điểm	處
Jingdezhen	景德镇
Vòng tròn	圓環
Hoa Kỳ	美國本土
lúa mì	小麦
tiền vay	贷款
Wanton	肆
trưởng nhóm	队长
Đan Dương	丹阳
Thanh tra	察使
anthill	垤
Đảng dân chủ xã hội	社会民主党
vũ trụ	宇宙
tương tác	互動
Ga tàu điện ngầm	地鐵站
Vị trí	安置
làm ẩm	濡
Xiaolong	小龙
đại sứ	大使
Bốn chỗ ngồi	四座
dốc đứng	沏
Wu Ze	武则
Còn thiếu	失蹤
Thiết lập	树立
sợ hãi	嚇
viền lụa của một vòng hoa	紞
Vào cung điện	入宮
đen	黑
giới hạn	界限
Trong sân	院中
chôn	瘞
Người kể chuyện	特勒
Phái viên	出使
Mở rộng	伸延
Hội nghị thượng đỉnh	登顶
Rộng	廣
Yi	揖
Cá mèo	鲖
sau đó	則
dừng lại	遏
Cho con ngựa	為馬
quét	掃
Tò mò	好奇
Quán trà	茶餐廳
Chiến tranh chống Nhật	抗戰
Shonan	湘南
khao khát	渴望
Tát	肹
Yên tĩnh	剡
Wei	洧
tập tin	檔案
Hatta	畠
Yi	濚
Châm biếm	諷
bản thân	自我
Hu	灜
Tiền lương	薪酬
Có hai	有兩
Măng xông	套筒
rừng nhiệt đới	叢林
Sự phơi nhiễm	曝光
món nợ	債務
khóa học	歷程
món ăn	餐饮
Ji	霁
nếu không thì	否則
Keller	克勒
giáo viên	老师
Phía tây	西侧
Yohiro	與廣
Pup	孛
Xác định với	认同
Cấp	下发
Năm đầu	初年
Tập phim	集數
Đường Nam	南道
Vương quốc Anh	英国
Đính kèm	归附
Ôi không	大野
Đường dây liên lạc	联络线
Bàn giao	交給
liên minh	联盟
tỷ lệ phần trăm	百分比
Phô mai	芝士
Vathy	瓦西
Bỏ trốn	逃入
Cười thầm	潓
Chiếm	占用
Đảng cộng sản Trung Quốc	中共
rêu	苔
Sanmen	三门
Một hai	一二
Đã in	印制
Đảm nhận	入主
núi	山山
Biến đổi	化
Hỗn hợp	混合物
Ying	楹
AIDS	愛滋
Nhọt	瘂
Cuộc đua trên	賽事於
cô đơn	寂
Balan	巴兰
đơn vị	部
Qi	剱
Kỹ năng	功力
Texas	德州
quê hương	祖国
Phỏng vấn	接见
cháu trai	外甥
Wimbledon	溫布頓
Đường thẳng này	本線
bức vẽ	油画
Khấu trừ	演繹
Sterol	固醇
Estre	埃斯特雷
Sáng sớm	凌晨
Mức độ tự do	自由度
đoàn kịch	剧团
Chi	熾
Tên địa điểm	地名
Urê	尿素
Đường giữa	中道
Tất cả	皆為
Qiao	峤
Phía dưới	下方
Nhà Tống	宋朝
tinh vân	星云
CD	光盘
Ngọc bích	堐
Quake	侴
Cú đánh	行程
Tokugawa Ieyasu	德川家康
Hai cái này	這兩
Axit citric	檬酸
Ren	任
ram	羝
Treble	高音
Tích cực	為正
đi vòng quanh	徼
Đối xử như	當成
Khi di chuyển	動時
Lực lượng cảnh sát	警隊
Yu	霛
Nho giáo	儒教
Trường đại học	學院
Cá cược	投注
Cửa	一門
nền tảng	奠基
Fu	敹
Quốc gia hùng mạnh	强国
đỉnh cao	尖峰
làm tắc nghẽn	屐
粝	粝
Tháp cổ	古塔
súng	鎗
Công tố viên	检察官
đặt hàng	秩序
Điều chỉnh	調節
rửa sạch	潄
Vui mừng	欣
Bạn trai	男友
Đính kèm	附属
Tỷ lệ bỏ phiếu	得票率
Quốc tế	國際
vỏ sò	外壳
Cơ quan lập pháp	立法院
Yao	垚
tất cả	凡是
bình luận	评论
Bưu điện	郵局
đau khổ	捱
Tolia	托利亚
Smash	砸
Đối tượng	臣民
Trường học	校方
Về hưu	引退
Jingwei	精卫
người lớn	成人
Fen	芣
Charlie	查理
Trimble	天寶
Quyển sổ đặc Mua hàng	定书
Xã hội	社交
Nơi cao	高处
Chết dần, tắt ngấm, lỗi thời	消亡
Thượng viện	上院
Chúa tể	爺
thua	輸
Masamoto	正元
bất động sản	產權
Treo	缢
Màu xám	格雷
Đã từng	用來
Họ Thảo mộc	草科
Dap xe	乘車
phỏng đoán	猜
Piper	哌
Lem	勒姆
Jura	汝拉省
Tổng biên tập	總編
thô	屝
Cam kết với	致力
Tội ác	犯罪
phần mộ	坟墓
Besancon	贝桑松
Ủng hộ	利於
Nền đường	路基
Âm	裀
thùng đựng hàng	集装箱
Số năm	年號
mùa xuân	春天
Tưới	灌
hủy hoại	毁灭
Southland	南地
vẫn là	還是
Gì	尭
Anh bạn	绔
đất nước của	的國家
Cho đến nay	迄今为止
đường	马路
Cohen	科恩
màn	榥
Ngốc nghếch	蝲
Rui	睿
Trung đoàn bộ binh	步兵團
Người giúp việc	嫢
sự sụp đổ	崩塌
giao tiếp	通訊
Cao	升高
Wei	洝
Liệt kê	掛牌
Bảo vệ môi trương	環保
Ngành muối	盐业
bởi vì	因
Bắt đầu	首发
Điện lực	电
Nào	哪些
tên giả	筆名
Sishan	斯山
khuôn mặt	面貌
bệnh tiêu chảy	腹瀉
Barry	巴里
Phá vỡ	斷
bóng chày	棒球
Cao	髞
Xe lửa	训
Không xa	不遠
Ngôi sao mới	新星
đáng kể	可观
Việt Nam	越南
sản phẩm	產品
Chỉ có	唯有
Ngoại Mông	外蒙古
Khách du lịch	旅行者
Corey	科雷
Duo	鐸
sáng	光明
Đảng Cộng hòa	共和黨
Tát	捼
Ding	嵿
đội tuyển quốc gia	國隊
Sun Ce	孫策
Bài hát	該曲
khá	相當
xây dựng	大廈
Giảm bớt	漸減
Đột ngột	齑
Hợp chất	合物
ba mươi bảy	三十七
Yar	亞爾
Nhiệm vụ	职责
Mỗi	每個
chiến tranh	战争
Gốc	原籍
Khóa thấp	低調
Vấn đề	事宜
đại sứ quán	使馆
Fengxiang	凤翔
bụng	腹
Bộ công an	公安部
Khu vực nông thôn	農村
Hảo	顥
hỏi thăm	詵
Bẩm sinh	先天性
Bướng bỉnh	匸
Angler	鮟
Plover	黸
nở	菢
Rohan	洛汗
Tổng hợp thành	編為
Trao giải thưởng	獲獎
từ	以来
chính sách	方针
Wu	乌
Đảng sản xuất	產黨
xã hội	社會
Chết	身亡
tiếng ồn	噪音
Harrison	哈里森
lôgarit	对数
Noir	辄
Kuai	噲
bài hát	麯
Sơn trên	搽
liên quan	睠
Đuốc	莠
Bama	巴馬
Phát phần thưởng	赠送
phân biệt chủng tộc	種族隔離
bên bờ biển	海邊
NetEase	网易
Nồi hơi	鍋爐
Vì thế	晬
Tạp chí	刊
Sun Quan	孫權
Su	肃
công cộng	公用
Háu ăn	馫
hôn	接吻
hợp đồng	合约
Biến đổi	變身
Kazakhstan	哈萨克
Philip V	腓力五世
Bất kỳ	任意
Trận chiến trên đảo	島戰役
Ling	佫
Sự khác biệt	区别
khỏe	罚款
Strauss	施特劳斯
Bạn bè	友
Nara	奈良
Quận Mountain	山县
Màu xanh da trời	兰
Như nó	如其
Shi	潠
Qi	骃
Xếp hạng	收视
bất ngờ	儻
San Marino	圣马力诺
Garonne	加龙省
sự thù ghét	憎恨
Quốc ca	国歌
Ghana	加納
Ngọc bích	眬
nhẫn	圈
kéo	挽
Moore	墨尔
Quốc kỳ	国旗
Tấn	浭
Zhengde	正德
Đất	地底
chú ý	关注
Video	录影
Thời gian và không gian	时空
Tận dụng	活用
Hệ thống vợ	妻制
con cú	鴟
Trước mặt	车头
Wei	崤
Tiền giấy	钞
quan tâm	趣
Sinh viên đại học	大学生
Đốt cháy	焚毁
Đến	員來
Anh trai	兄
Fetter	鐐
Puth	普斯
Một số	有者
Ganzi	甘孜
cái cổ	颈
Mở	公开赛
Hấp thụ	吸納
Người sản xuất	监制
Thallium	鉈
ngoại trừ	除
gọi	呼叫
Impatiens	凤仙
con nhện	蜘蛛
Lộn nhào	擽
Nhưng bây giờ	但現
Hấp	煳
Zhao	昭
TV	電視
Chiến tranh thế giới	世界大战
Lực lượng	用力
tín hiệu	信號
lưu lượng	流動
chính sách	方針
Dier	迪尔
Yab	薮
Gia đình quý tộc	望族
Đảo Tây	西岛
món ăn	餐飲
Đầu cá	頭魚
Cho một	為一個
chùm hoa	花序
Như một	阿薩
Ăn mòn	腐蝕
Bằng cách	藉以
Điều khiển	驭
Cairo	开罗
Augu	奥古
Zhi	郅
Jiahui	家輝
Xác chết	屍體
Thuộc địa hóa	殖
món thịt hầm	煄
Rạp hát	戏院
sự chậm trễ	延遲
Giám đốc	厅长
Nằm	地处
tài khoản	帳
Dựa trên	為本
phi	攛
Khu vực hội họp	會區
Jackson	杰克逊
Chơi chữ	鍨
đồng bằng	三角洲
Zheng	鉦
Giữ	捧
Khủng long	類恐龍
đá quý	宝石
xe lửa	火车
Chuyển hướng	改行
giới hạn	极限
Số ba	三號
Người phụ nữ cao tuổi	媼
Xuân	籛
Đến	逨
rất	十分
Bị thương nặng	重傷
Serranidae	目鮨科
Edo	江户
phá vỡ	决裂
Tấn	恟
Jair	皝
Khuôn mặt	面上
động lực học	動力學
châm ngôn	格言
trượt băng	溜冰
Viễn tưởng	小說
Điều đáng tiếc	悯
Bảo vệ	后卫
cỏ	蕘
chuyển khoản	调用
liên quan	關心
Tiao	鍀
Ràng buộc	囿
Yulon	裕隆
nhận được	領取
bài đăng	郵報
nghi ngờ	怀疑
gió	風
Thành phố Toku	德市
Gìn giữ hòa bình	维和
Chì	牽
Weir	韦尔
chế giễu	嘲
Dulu	杜鲁
Baiguan	百官
Dulu	杜魯
Fang Zhouzi	方舟子
Người quản gia	管家
Lỗi	斷層
Quận	斯縣
Ung thư biểu mô tuyến	腺癌
Giáo hoàng	教宗
Luân phiên	候补
Sler	斯勒
Ngón chân	裠
Trưởng nhóm	组长
bình luận	評論
Yamagata	山形
Heim	海姆
Qinghe	清河
Tường	墙面
Người Bồ Đào Nha	葡萄牙人
Bị giết	害死
hiđrocacbon	烃
đường lactose	乳糖
Vua cha	父王
Sáng	灿
Baoshan	宝山
Hai	兩條
Ngoại ngữ	外文
quân thập tự chinh	十字军
khu vực thử nghiệm	试验区
Nantes	南特
ngọc lục bảo	翠
sáng nhất	最亮
Vội vàng	赶
Cà vạt	袥
dịch bệnh	病症
Đến	酀
Bucky	布基
Khu vực	該區域
rất tương đồng	非常相似
Hava	哈瓦
Liechtenstein	列支敦士
Đảo	斯島
Gạo nếp	醻
Kehai	克海
pha trộn	攙
Tren	特倫
Tang	唐
làm phật ý	呧
Gil	吉尔
Quân đội Giải phóng Nhân dân	解放军
Trang Chủ	家居
Chiến tranh vệ quốc	保卫战
Tách ra	分道
Sốc	衝擊
Âm	餟
Tòa nhà văn phòng	办公楼
Kon	蒟
Đảo Nam	南島
Ở Anh	於英國
golf	高尔夫球
Zhongshi	中視
Rộng	广
Hesse	黑森州
Cho hai	為兩
có xu hướng	趨向
Tát	濍
tách rời	分開
Đặc vụ	特工
Yan	剟
Mara	馬拉
Centi	釐
Người đàn ông thông minh	智者
Người anh em thẳng thắn	直布罗
Giám mục như	主教為
Intel	英特尔
Hệ tư tưởng	意識形態
thời trang	時尚
Các quốc gia thành viên	成员国
Một phương tiện	壹傳媒
Sán Đầu	汕頭
Tiếng Việt	越南人
quán quân	冠军
Một lần	一個由
Mặt bằng cho	地為
Viên con nhộng	蒴果
Trang phục	礼服
Đàn bà	娪
Vu khống	谮
Làm lơ	无视
Súng	鲧
Xa	法尔
Nghỉ ngơi	休
Su	肅
Tên đi kèm	名稱來
Pup	孭
trên công trường	现场
Âm	羙
Sải cánh	翼展
Mekelen	梅克伦
suối	淶
Jianzhong	建中
để trần	臝
thứ tư	第四
bình thường	普通
Hoa cúc	茼
tình cờ gặp	躓
Sự can thiệp	干預
Sara	萨拉
Đài hoa	花萼
vận chuyển	运输
chiều dài	長度
công việc	做事
Trường tiểu học	國小
Giá trị	重视
Con ngựa	駒
ngắn	短
Tháng Chín	九月
Lò nung	窰
Rung động	振动
Cá trích	鯡
Hai	兩項
Hội thảo	討會
tương đối	相對
Cắn	囓
Nhượng lại	割讓
Tiếng Mông Cổ	濛
mua	買
tìm	觅
Thông tin	信息化
Với	着
Chun	淳
Ngau Tau Kok	牛頭角
Phân nhóm	分組
Thủ dâm	自慰
Bao vây	圍困
Lumbia	倫比亞
Terpenes	萜
Bình thường	序数
Độ cong	曲率
Gương	鏡子
Phục kích	伏击
lạnh	寒冷
Dianthus	石竹
xinh đẹp	美麗
toàn bộ	總計
Thời kỳ không có sương giá	无霜期
Ranh giới	界線
Lâu hơn	更長
Bắc	北方
Chắc chắn	显然
Ji'an	吉安
Thẻ	卡德
Huân	焕
Trước một	进一
tình trạng vô chính phủ	無政府
Phần phía sau	後方
Yi	乆
Tấn	飩
Mảnh này	此片
Ke	軻
Gặp gỡ	會議
Kích hoạt	引發
Tấn	忟
Shimadzu	島津
Sảnh chính	大殿
tập quán	风俗
Mùa khai giảng	開季
chính thống	正统
Yu New	於紐
Kiêu ngạo	戗
phổ biến	流行
Benxi	本溪
tiền công	工资
Gilt	鎏
Twips	緹
Jiuquan	酒泉
Xiaozong	孝宗
Yu	堉
Dang	垱
Tang	郔
tiên đề	公理
đại bác	大炮
Shilla	新罗
Li	悧
quá trình	游行
midge	蠓
La mắng	讦
Tuyệt quá	偉
Chết chìm	溺
Leiter	雷特
Phong cách	作風
Mỗi cách	各路
Giải phóng	釋出
Hai cái này	這兩個
Sáng	熠
ứng cử viên	候選人
Chưng cất	馏
Tiancheng	天成
tấm	片
phần lớn	多数
buôn bán	贸
Duyên dáng	婉
Quyền lực	权贵
mẫu	图案
sâu	渊
Sáu hoặc bảy	六七
Tại thời điểm đó	該時
Ngọt	饴
thừa kế	继承
Khu vực danh lam thắng cảnh	風景區
rắc	洒
thoát vị	疝
hệ thống	製
Bằng cấp là	度為
ríu rít	扢
Ma trận	矩陣
Lái xe	開車
đi chỗ khác	离开
Gạo nếp	醕
Mọi người chiếm	人佔
Logo	标识
Bồn rửa	沉沒
Kỹ thuật	术
sáp	蠟
Năm là	年為
Phía tây	西側
Philadelphia	费城
sử thi	史詩
lệch lạc	偏差
và	而
tài khoản	帳戶
Không gian con	子空间
mùa hè	夏季
Sau kỳ	期後
có thể	可以
Xiangshan	香山
Cá mập	鲨鱼
Cho đến	為來
không thường xuyên	齟
Thuộc họ hoa hồng	蔷薇科
Vienna	維也納
Bộ Y Tế	卫生部
Một từ	一字
Tính cách	品德
Cháu trai	世孫
Real Madrid	皇馬
Lỗ	之洞
thơm	芳香
Âm	隖
Hoàng tử	諸侯
trái bóng	球
Nhưng đã	卻被
Hồng y	樞機
Trung học phổ thông	中學時
đàn bà	妇
Bồ Đào Nha	葡萄牙
Chi	潕
Máy	該機
Nguyên nhân	之所以
âm đạo	阴道
Con ong	大黃蜂
Phạm vi gần	近距离
ngay	即刻
Nhật ký	日记
Mờ nhạt	洐
Nắm bắt cơ hội	趁機
Thu hút	诱
Ít hơn	較少
đường dây nóng	熱線
Đối với phần	為節
Urn	箓
bánh ngọt	饽
Lấy tài liệu	取材
Quạt	范
Mẹ chồng	婆
âm mưu	陰謀
Sản xuất	制片
Los Angeles	杉磯
Ủng hộ	青睞
Hoàng tử	皇子
hàng năm	全年
Bố của anh ấy	其父
Ủng hộ	擁立
Zhen	稹
thổi	颼
Cái rổ	簍
Hạm đội	车队
Trang thiết bị	装备
rắn độc	虺
Đánh chính	主打
Li	驆
ngồi xổm	跁
trái chuối	香蕉
Núi Trường Bạch	长白山
Đính kèm	附屬
trị liệu	療法
dạy	傳授
Công bố	刊載
Thể chai	胝
anđehit	醛
Anyang	安阳
Cheng	铖
Mô-đun	模块
Trúng tuyển	選出
Tại chỗ	原地
Cũng có thể	亦可
Họ ngôn ngữ	語系
Mycin	霉素
Bụng	腹面
Nên là	應為
chóng mặt	眩
thực hành	練
thận trọng	保守派
Bánh gạo	餱
Vòi	龙头
Ách	袾
Chia sẻ	合用
Đối với lịch	為歷
quần đảo	列島
đứa trẻ	僮
tang lễ	喪
mảng bám	牌匾
Hạ Môn	厦门
trang điểm	补偿
Vỗ nhẹ	帕特
Ngôn ngữ	語文
Plutonium	鈽
bản ghi nhớ	备忘录
tòa tháp	塔楼
Lei	嫘
tất cả	徧
Mại dâm	卖淫
Cái bình	瓂
Wai	廗
Hamburg	汉堡
Miệng hố	坑口
người Ý	意大利语
hủy hoại	銷毀
Phiên bản trên	版於
khuyến khích	鼓勵
Yan	顏
Zhu	擿
Đồng hồ đeo tay	收看
籴	糴
Thoải mái	舒適
Truy tố	檢控
Carbon	的碳
Hội đồng bộ trưởng	部长会议
Sự giải trí	娱
Cực	极地
săn bắn	打猎
Nổi loạn	叛
Vẽ một nút	舉結
Sinh vật đáy	屬底棲性
Giáo dục	教务
đắt	贵
vết bầm tím	痍
Han	憗
Những cậu bé	男生
nước hoa	香水
Trói buộc	縛
Fu	芾
Yêu cầu	主張
Quản trị quận	县治
Dương	瀂
Tất cả các cách	道道
Và lớn	與大
Yi	颐
thâm thúy	深刻
Cột	专栏
Mus	姆斯
Pedicularis	先蒿
nếm thử	味
Smolen	斯摩棱
Châu Á	亞細亞
Tối	深色
lấp đầy	填
Jian	謿
lừa dối	詿
khuấy động	攪
Quay lại	並轉
Ghế sau	後座
Studio	錄音室
Msec	米秒
màu sắc	顏色
Bang	呯
quần đảo	列岛
Phù hợp	合體
đá	磈
Cái cày	耕
Phun	噙
Jia	珈
Hai hai mươi tám	二二八
nổi danh	出名
Ban đầu	本屬
Plymouth	普利茅斯
Tiếng Mã Lai	马来
Quan sát	察
âm vật	陰蒂
Phong cách	风貌
Máy biến áp	变压器
Đánh nhau	打架
Thứ hai mươi tư	第二十四
Sẽ được sử dụng	會使用
Rồng bay	飛龍
Mẫu	花紋
Đông Nam	东南
Kinh phật	佛经
Sức mạnh siêu nhiên	神通
châu chấu non không có cánh	蝝
Quan	鎄
Người nước ngoài	外国人
Số người	人数
lạm dụng	濫用
ma	嬤
Zhao	趙
xúi giục	煽动
Giới thiệu	推舉
sâu	冥
đáng giá	值得
Hu	躀
phía Bắc Biển	北海
Ngăn cản	騭
Văn phòng	事務所
Hỗ trợ lẫn nhau	共济
mở	开设
Derby	德比
chuyển khoản	转让
Di chúc mới	新約
Andy	安迪
Ling	垇
Nhân loại	为人
Trang điểm	揺
Bán thời gian	兼職
Baihua	百花
Qi	禶
Cao Wei	曹魏
Ngoài ra	此外
thành phố Đài Bắc	台北市
Ba vương quốc	三国演义
lương tâm	良心
Như một	阿萨
Kênh	頻道
Xuân	邃
Ngôn ngữ	種語
Tại sao	為何
Thành phố Hợp Phì	合肥市
Moldo	摩尔多
Khu vực	区
Centi	厘
Liu	騮
Ruman	魯曼
Thành phần	成份
Kinh doanh	工商业
ngôi đền	鬓
Hy Lạp	希臘
Độc thân	為單
Iberia	伊比利亚
Hada	哈达
Xuyên qua	贯通
Biết rôi	知晓
âm thanh	健全
hiếm hoi	稀有
Âm	釢
Shengsheng	生生
Tại thời điểm đó	當時為
Khởi đầu	开始
Mạnh	強為
con tằm	蠶
Thiết lập	設立
Màu nâu tối	深褐色
Chìa khóa	鑰
Cái gọi là	所謂
Coronal	冠狀
Chưng cất	餾
Ủy ban Thường trực	常委
Xung đột dân sự	内乱
Siêng năng	懃
tất cả	均
bò đực	公牛
Jing	臶
tháng Tám	八月
Tamarin	狨
Thời kỳ đó	那段
lo lắng	忐
chuyển động	议案
Tua	绂
Fran	夫兰
Tháo dỡBồ nông	拆鹕
Ba	岜
Sinh ra	誕生
đầy	整整
Cam thảo	甘草
Trung sĩ	士官
hoàn toàn	纯粹
Cục tình báo	情报局
Cung điện nhà Thanh	清宫
con kênh	佢
lò nồi	柶
di chuyển	扤
Tiêu điểm	专注
viết tắt	缩写
Quảng trường	方
Quan Vũ	关羽
Lang băm	呱
món ăn	菜
Bang Jin	晉國
Xe nguyên chiếc	整车
phần lớn	大多數
Tiền giấy	鈔
Viết các từ	填詞
Noel	诺尔
Thật bất ngờ	居然
Yamei	亚美
Con trai	童子
Đức phật	髴
Hu	祶
Trước mặt	战线
Buồn phiền	攴
kỹ sư	工程師
Khai quật	发掘
họ	她们
yêu và quý	恋
Cát Lâm	吉林
Sự hỗn loạn	之乱
triết học	哲學
Hạt Dao	島縣
đất nước của tôi	我国
Nguyên nhân	成因
Thích hợp	一致的
nước Anh	英倫
Giá cả	代价
Vật	對象
chữ vạn	卍
tạo nên	創設
Gan	淦
Kiêu ngạo	妄
Benjamin	本杰明
Đến	到达
Một mình	為獨
Mập	膘
đính kèm	附上
studio	工作室
người Trung Quốc	漢文
không thay đổi	不變
đảo ngược	逆轉
Thiếu uý	少尉
cây rơm	脊
sáp	蜡
mời gọi	邀
cộng đồng	小区
Chắc chắn	顯然
một mình	獨
rãnh	槽
Zheng	铮
Bosnia và Herzegovina	波黑
tang lễ	殡
Erkha	爾喀
Đường và	路與
người chồng	丈夫
tấm ảnh	寫真
Hàn Quốc	韩国
mong	希
thuốc uống	吸毒
lực lượng	逼
Sau đó, giả sử	則設
Đại học Trung Sơn	中山大学
Hoàng dương	炀帝
Bang	嘚
Phật sơn	浮山
Cử tạ	举重
Phong cách	斯提
Xe buýt mới	新巴
Squall	飑
Ganzhou	赣州
Đông Nam Á	东南亚
mùa thu	秋
Sự hỗn loạn	大亂
Dư luận	輿
đàn vi ô lông	小提琴
Giáo xứ	個堂區
lông thú	毛皮
Santan	桑坦
Không tiến lên	不前
Đánh nhau	鬥
lời tiên tri	谶
dịch bệnh	疢
ngón chân	趾
Fen	芬
tương lai	期貨
Yab	藪
than van	呻
Vùng phát triển	开发区
Phòng Đảng	党部
cánh diều	鳶
cửa hàng	儲存
âm tiết	音节
Campuchia	柬
Duyên dáng	婳
Bài thơ	詩作
nhảy	跳跃
Gena	热那
liên minh	邦联
Quá trình	工序
Phê duyệt	批准
Với	在與
Nói	説
bộ binh	步兵
thay đổi	变
Viễn tưởng	小说
Đại học Bách khoa	理工大学
Phát ban	痱
cảm giác	感情
Đi trước	先行
bóng chày	板球
Jones	琼斯
Brahma	婆羅
Thành phố này	本市
Jian	趆
Uh	呃
Kent	肯特
Liên đoàn quốc gia	國家聯盟
chủ nghĩa cộng sản	共产主义
thay đổi	转变
cực	极度
Con gái cả	长女
Đại học Quốc gia Đài Loan	臺大
bong bóng	潏
Minas Gerais	米纳斯吉拉斯
Libya	利比亞
Nhung	茸
thuốc bổ	主音
khuôn mặt	脸
Hợp nhất thành	併入
Tầng trệt	地平
Hoàng đế Ung Chính	雍正帝
bác bỏ	反驳
cây phong	枫
Thiến	鉘
Dan	丹
Thứ hạng	行列
Trái	剩下
họng	吭
Chất lượng	素質
Đốt trong	内燃
sự sụp đổ	崩
Tầng 1	一樓
Gạo nếp	莋
Tỉnh giang tây	江西省
Kinh Qur'an	古兰经
Tây ban nha	西班牙
xe tắc xi	的士
ga xe lửa	火车站
Người sản xuất	監製
nhà hoạt động	活动家
bản chất con người	人性
Tháng chín	賽普
Shao	狲
dấu vết	蹤
Ju	雎
muối thô	硭
Yên xe	鞍
Buttercup	毛茛
Tốt	唭
giá phơi quần áo	椸
quê nhà	家乡
Đồn quân sự	軍駐
Daniel	丹尼尔
Fran	夫蘭
chuyên gia	知識
nghi ngờ	疑惑
người	人士
Rồng và	龍與
Tốt bụng	藹
Lorraine	洛林
Hu	礜
Gironde	吉伦特省
Wa	媧
Quần đảo	诸岛
cố gắng	企圖
Phản chiếu	反光
Tát	蒢
Chua cay	撻
Tên chung	屬名
tập thể dục	演习
viêm	焮
Châu Âu và Châu Mỹ	欧美
Ba vương quốc	三国志
Zhenghe	政和
Hạt nước	水县
sự phá hủy	毀壞
Sâu	蚚
Hải lưu	洋流
góc	隅
Quân sự	军务
Silmarillion	精靈寶鑽
Tate	塔特
rối loạn	动乱
Fuzhi	府治
sự lo ngại	焦慮
thiên văn học	天文
sự dự đoán	预测
Flo	芴
Iris	虹膜
trang phục màu trắng	白衣
Cá cảnh	觀賞魚
Cambridge	剑桥
Jiashen	甲申
Thiểm	筮
Droop	耷
Khùng	瘋狂
Trận chiến ác liệt	激戰
Trục trung tâm	中轴线
Âm	辿
Phát thanh	播映
rất	很
Giả mạo	俠盜
nguyên chất	洌
tình dục	有性
Chuột chù	鼩
Arday	阿尔代
Bo	博
Nguồn cấp	電源
nhà ngôn ngữ học	语言学家
chuyến du lịch	巡回
tê liệt	癱瘓
Nhật Bản	日本
Nhân Viên	职人员
Và nói	並稱
Sandbar	沙洲
Người quan sát	观察者
Phong cách vẽ tranh	畫風
Nói	之說
niêm phong	钤
Trên đồng ruộng	实地
đau	疮
Phụ trách	作主
bươc	步
thể loại	范畴
Yên tĩnh	蚿
mạng tinh thể	格子
thông qua	经由
xác tàu	擊毀
Chức vụ	方位
Bán quasi	半準
Múi giờ	时区
Dong	董
dốc	坡
Tiệc	醱
Maw	鲏
Động	動式
vay	借
Thêm người	餘人
sự trao đổi chất	代謝
ngôi nhà màu đỏ	红楼
đại sảnh	会堂
nhà này	这家
Tô Châu	蘇州
Cu	邾
chuyển khoản	轉任
Fokker	福克
Nếp gấp	襘
Tra tấn	受刑
họp lại	聚会
con kênh	水渠
rượu whisky ngô	波旁
Thứ hai mươi	第二十
bão nhiệt đới	台风
Cụm thiên hà	星系團
Philippines	菲律賓
Khrushchev	赫鲁晓夫
hướng dẫn	導向
Bao nhiêu	多寡
Teutonic	条顿
Linh mục chính	主祀
Nắm quyền	掌权
Nhu cầu	需求量
Bộ khuếch đại	放大器
Các tiểu bang khác	他州
bài hát	曲子
Bao vây và ngăn chặn	圍剿
mặt trời	茪
phức tạp	複雜
cho đến nay	迄今
gặp	会面
đuôi	尾
ghi chép lại	编年史
nhôm	铝
cà vạt	縶
Yoya	與亞
Chiên	弗里德
Hanzhong	漢中
số tài khoản	帳號
nói nhảm	噜
Tránh	躲避
Donald Tsang	曾蔭權
Trên hòn đảo	島上
Dư thừa	多餘
Ca sĩ	歌唱家
12 thước	十二碼
Cúi đầu	俯
Tiệc cưới	婚宴
giá trị	値
Xe số tự động	自動車
cuộc hội thoại	谈话
Nguyễn Phúc	阮福
liên hiệp	與聯
Châu Á và	亞與
Po	蒲
Glasgow	格拉斯哥
Cảnh sát hình sự	刑警
Yu	楪
để anh ta	讓他
Để sáng tạo	為創
lòng trung thành	忠诚
Khả năng sinh sản	生育
Đi	圍棋
Thiết lập về	着手
Sau thất bại	戰敗後
Ise	伊勢
ngọn lửa	焰
tay vịn	扶手
khó khăn	難以
Phun	噭
thăm gái mại dâm	嫖
Tỷ lệ cược	比數
Chim cốc	鹚
Mái tóc	的發
Được bầu lại	连任
nói chậm	訒
Bởi	則由
tin nhắn	使者
con tem	郵票
nhân quả	因果
danh hiệu di cảo	謚
lỗi	誤差
Vương quyền	王权
tấn công	发作
không công bằng	不公
Khoa kinh tế	经济系
Chơi chữ	椪
bát	盌
Kiềm	碱金属
Phim tài liệu	紀錄片
Liya	里雅
Album	专辑
Quân đội Pháp	法军
Ula	乌拉
Vassar	瓦萨
phụ trợ	辅
Sui	睭
Kiềm chế	制約
Luân	鸾
Chu State	楚国
gái điếm	妓
Yingde	英德
hư mất	沦
Ye	敔
Đà điểu	鹋
Vấn đề	签发
Toàn diện	综合性
Tỉnh hồ bắc	湖北省
Ringgit	令吉
kết thúc	末
nghệ thuật chiến tranh	兵法
Vui sướng	悦
sự giống nhau	譬
toàn bộ	合計
Peroxy hóa	过氧化
Pu	楺
Đàm luận	論述
Hạt Đài Đông	台東縣
Treo Seng	恒生
hèn nhát	怯
rượu mạnh	酎
protactinium	镤
Chuyển ngữ	音译
phòng khám bệnh	診所
Sự bảo tồn	保育
San Francisco	舊金山
Giới thiệu tóm tắt	告片
Tro chơi điện tử	電玩
Không có gì	一无
Thí dụ	示例
tiến lên	前進
Quýt	柑橘
Các sản phẩm	制品
Thành viên khoa	学部委员
Đàn ông	男方
Thời Meiji	明治時代
hàng	綫
thông báo	告知
trống	皷
Vàng và bạc	金银
Pleistocen	更新世
Trong tỉnh	省内
lụa trắng	紈
đi qua	擐
Sunni	遜尼派
Mary	玛丽
gộp lại	总额
Rất nhiều	良多
truy cập	訪問
Bắc Trung Quốc	华北
Fo Tan	火炭
chuyển động	動議
Ngang	横向
co thắt	痉
Lớp học	課室
Ánh sáng	光芒
phía trong	里面
Hít vào	吸入
kết luận	缔结
Saki	咲
U ám	暦
Qu	朐
Lòng tốt	慈
Lên kế hoạch	預定
bệnh lý	病理
Nhiệt độ thấp	低温
lòng can đảm	勇氣
kiêu ngạo	憍
Hải cảng	海港
Tốc độ bắn	射速
Lang	郎
váy	裙
tiền vay	贷
Chỉ có	只於
Alfred	阿尔弗雷德
Năm độ	五度
Nhật thực một phần	日偏食
Bộ xương	骨骸
Knock xuống	打倒
Và vua	與王
Quận	的縣
thương hiệu nổi tiếng	名牌
trơn tru	光滑
Bài học	講學
Narita	成田
nghĩa là	意味着
quân dai	褲
HKUST	科大
người đàn ông	男人
Giữa	介于
Và để	並向
hình dạng	外形
buổi triển lãm	展
Trái	遺
sống động	生动
Jie	婕
Dòng	台詞
Hàng ngàn dặm	千里
Vất vả	奋
cuộc hẹn	任用
Bắt chước	仿
Chết	駕崩
Bang miễn phí	自由邦
tháng Ba	行進
rơi vãi	滴
đống đổ nát	殘骸
Osaka	大阪市
Chu	榘
Nhà hàng	酒樓
công việc	办事
Phần lớn	大部
Cuộc cách mạng	公轉
Dạy	授课
Mann	曼恩
Phi tập trung	分散式
bẻ cong	紾
con chuồn chuồn	蜻蜓
Tháng bảy	七月
Taiping	太平
Si	巳
phía đông	向東
Rhea	瑞亞
Nianri	念日
Tìm kiếm	蒐
củ cải	萝卜
Trong và ngoài	进出
rau mùi	荽
Sudan	蘇丹
Đang vẽ	繪圖
Việt cộng	越共
Tiết kiệm	悭
hạt	縣
người lạ	生人
Yếu	弱小
Cho	賦
Cái bình	投手
Làm việc chăm chỉ	努力
Chèo	航
giải quyết	解決
hai mươi ba	二十三
bao la	茫
Hui	翬
đường mía	甘蔗
con cóc	蟆
Cố ý	审议
đăng nhập	登录
Hộp tốc độ	速箱
chôn	墐
Âm	瑘
Sydney	雪梨
Nemesis	仇者
Dọc và ngang	纵横
Ren như	任为
Nhạc rock	搖滾樂
Làm	使
amin	胺
Bán	販賣
Servo	伺服
Môi trường sống	棲息
Ngôi sao trực quan	視星
vẫn	犹
thẩm mỹ viện	沙龙
Theo thời gian	不時
ngoại trừ	除外
Ngày của Chúa	主日
đoạn văn	段落
Tính nhất quán	一致性
Âm	鄏
Lợi thế	利物
Côn Minh	昆明
thời gian bắt đầu	開始時
Đã được chấp nhận	公認
bạo loạn	暴动
vỏ quả	荚
Nâng cao	升讀
Yu	庣
Trong khoảng thời gian	時內
Ninh Hạ	宁夏
Tuyết tùng	杉
thuốc phiện	鴉片
Rồng đen	黑龍
Lộ ra	揭露
Lưu lượng hành khách	客流量
Tát	攞
Shi	轾
mở rộng	昄
tấn	声调
Quận	尔县
ngày cuối tuần	週末
Hiểu rồi	了之
đỉnh cao	峯
Nhìn chằm chằm	笞
Vịt Bắc Kinh	鸯
Xù xì	颷
Hỏi thăm	询
Không muốn	不願
dữ liệu	資料
tài sản	资产
Phải	須
Không	没
linh vật	吉祥物
ủng hộ	養
chủ yếu	主要
Tác giả	作者
ăn được	食用
Phong cách	式样
cờ	帜
Sẽ nó	將它
Wald	瓦尔德
Keqin	克勤
Biến đổi	變換
buồn	悴
bánh ngọt	籹
Nhạt	稃
Thắng lợi	場勝
Năm người	五人
nhộn nhịp	繁华
Ngớ ngẩn	尙
Nguyên tắc	準則
Xiying	西營
Chiếm đất	佔地
con kỳ lân	麒麟
đi vào	進入
Quốc gia	该国
Giảm giá	買賣
Cha	槎
thở dài	歎
Tịnh độ	净土
thiếc	锡
Đọc	读取
Dòng	該線
viết	寫作
Lầm bầm	喃
quay cuồng	洄
Huh	唓
Con gà trống	屌
Cang	滄
Sống sót	倖存
Hát	俀
Zhu	栴
con gái	女孩
Guinea	几内亚
đồng phân	异构体
Lịch	曆法
Khi nào	當於
thành phố	市
Fukuji	福寺
Quân tình nguyện	义勇军
chim chích chòe than	莺
tổ	蔟
để trần	齜
Nâng cao	筹集
Rình rập	蹥
bari	鋇
Dài	垅
Cả hai	既
than hồng	燼
công cộng	公開
Một lần	曾经
mở	開設
Xã hội	社团
Ya	遐
Không bao giờ kết thúc	終沒
Giờ	時數
mùa vụ	嗉
Gọi	吆
Người miền nam	南人
Pula	普拉
Tám	八個
Choáng váng	怄
trì hoãn	推遲
Toàn năng	全能
Darwin	达尔文
Chính quyền quận	区政府
Tiantai Sect	天台宗
ngọc bích	珔
Bầu trời đầy sao	星空
Long Môn	龙门
Quá Phúc âm	太福音
Những người lính	兵
Quận Wong Tai Sin	黃大仙區
Li	橾
Băng sơn	伯格
Hu	禑
và cả	還有
vỏ sò	殼
từ trên trời rơi xuống	陨
Dongzheng	東征
đóng	密切
Lịch sử chính thức	正史
Giờ học	學時
Khu du lịch	旅游区
nhật thực	蝕
Meo meo ~	喵
Li	谠
Dingshi	定市
Nakaze	中則
Tiếng Quảng Đông và tiếng Trung	粤汉
Shanhaiguan	山海关
Tháng tư	四月
thực hiện	完成
cái đầu	頭
Sông han	汉江
nước ngầm	地下水
Quyền hạn	辖区
Lin'an	临安
tháng Ba	進行曲
Chân dung	画像
bộ lạc	部落
Kết thúc	越过
Anime	动漫
sau	事后
Bịnh giang mai	梅毒
xuất bản	出版
Tích trữ	蓄
Một cuộc nói chuyện	一說
người sáng lập	建立者
danh tiếng	功名
hộp đựng vũ khí	櫜
nhọn	急性
ngai vàng	宝座
Khói	燻
vui sướng	歡喜
Vài lần	數度
công cộng	大眾
Luo	羅
Sách giữa	中書
Catalonia	加泰罗尼亚
Thứ sáu	星期五
Lian	璉
Ưu tiên	首選
thuê	赁
Cứu giúp	济
Gerakan	民政党
Chú	叔
thuật ngữ	期限
thật thà	誠實
cái chùy	鐧
Buồn phiền	儃
Mitte	米特
quyền anh	拳道
Andrew	安德鲁
Qi	觾
Gay	同志
Tao	弢
sống sót	生存
hạ nghị viện	下議院
Đồng thời	同时代
Cầu vượt	天桥
Lực lượng bó	束力
phía sau	後進
lâm sàng	临床
Tới trước	事前
giống	相似
Izu	伊豆
Mờ nhạt	怑
diễn viên phụ	未成年人
kịch	劇
Tham gia cuộc chiến	参战
hạt giống	种子
Xịt nước	噴
Gấp đôi	的雙
bản ghi nhớ	備忘錄
Làm mẹ	母艦
Seth	塞特
Hoàn tác	撤消
Lux	力士
Nội trú	寄宿
Bằng gỗ	木制
Phía chúng tôi	我方
Shijin	時進
Tiêu đề	業權
Đúng đắn	义勇
Nước ngoài	外國
dán lên	撅
Toàn thời gian	全日制
Huân	浣
Muối	鹾
tiền bạc	錢
Các	该
Trên không	空降
Sao lùn	矮星
Con đường	小路
Người đi bộ	行者
phỏng đoán	猜測
keo dán	膠
Kháng cự	耐
nhân	繁衍
Máu đỏ	血红
Săn bắn	搜捕
Quốc gia	國定
ngôi đền	庙
Nhánh ngôn ngữ	语支
Tsang Yin	曾蔭
MTR	港鐵
Yak	牦
Giải vàng	金像奖
Tất cả	全部
Jian	鉴
hình phạt	刑罰
nói dối	谎
liên minh	邦聯
động năng	动能
Phụ trách	掌管
trường tiểu học	小學
Rosen	罗森
Aub	奥布
không đúng	不當
Giải trí	康樂
Gốc	源流
ghi bàn	评分
Hiệp ước hòa bình	和約
khớp nối	聯結
rau	芼
Những người bình thường	常人
Tấn	汫
nói dối	謊言
quán tính	惯性
rõ ràng	逴
của	的
ghi lại	唱片
Thio	噻
Quét	斯堪
thuyền nhỏ	艋
Trang điểm	粧
Dụng cụ	文书
Tường thuật	記述
cửa sổ lưới	牖
Phỏng vấn	接見
câu trả lời	答
Than van	呙
Được tách ra từ	分別於
San Jose	聖荷西
người Trung Quốc	華裔
cá cược	赌
Bởi	藉著
Bu	埗
Quan hệ họ hàng	亲缘
Glenn	格伦
Cấu hình	配置
buổi sáng	晨
Có lời	嗦
hình trái xoan	卵形
gia tinh	魈
Hồ Bắc	湖北
Tầm nhìn	視覺
Lực kéo	牵引力
ứng dụng	应用
Đầu tiên	先
Yen Nhật	日圓
Huân	澣
Sâu	蠁
hòa hợp	和聲
Tang Gaozong	唐高宗
Không có tóc	无毛
Thành lập	創始
tái hôn	再婚
uy tín	名聲
Trong đội	隊中
Yun	郓
Đảng dân chủ	民主党
Cây bách	柏
triệu chứng	症狀
Công ty tại	公司於
thương mại tự do	自由貿易
Phía sau	後在
bóng đá	足球
Đính kèm	附着
Yi	迍
khắp	各处
Cuộc bầu cử	选赛
Hành động thay mặt cho	代行
Xi	郩
Chọn lọc	选择性
dấu	马克
Bản thảo	手抄本
phút bay	蠛
Rơm rạ	秸
đi ra	问世
Chuẩn bị	備總
Quy định	條規
Bị chặn	受阻
Theo dõi	賽道
nhưng	却
Erde	尔德
Không được thiết lập	不設
Cá đực	雄魚
Ốm nặng	重病
Đảng viên dân chủ	民主党人
đen	玈
Bao vây	圍第
tủy	骨髓
Zhao	钊
Nuo	儺
Aki	阿基
Tỷ euro	億歐
có thể thay đổi	多变
tiết tấu	击败
bờ biển	滩
con dơi	蝙蝠
Khi họ	當他們
Vù vù	嗖
Vợ lẽ hoàng gia	贵妃
xe tải	货车
Đông người	拥挤
đập mạnh	怦
Khớp nối	鉸
Trận đấu	相符
độ đục	浊
và	并且
Donau	多瑙
Cư dân	駐
Studio	录音室
cùng với	隨著
thiết lập	建立
bước đi	蹀
Thuyền	艇
Môn học	学科
Lốp xe	轮胎
Chăm lo	打點
Em gái	姉
Hội nghị	代表大会
nhiệt độ	温
Tong	潼
Karp	卡普
cấp dưới	下属
Xây dựng	幢
chiếu trúc thô	籧
vắt kiệt	擠
nhẫn	響
Phân loại	归类
du côn	暴徒
Giá đất	地價
Mọi người	人來
Tao	焘
Bị thương	傷者
nói lại	重複
Dati	達梯
Là nó	吗
nghẹt thở	噎
Đại hội đồng	大会
hoa sen	蓮花
Phía trong	内侧
keo kiệt	啬
Taihang	太行
Nói	发言
Khách du lịch	旅客
Ti	逖
Cánh tay	翼手
Fangshi	坊市
Mo	摩
Austin	奥斯汀
Qi	碁
tỉ mỉ	细致
Cho thế giới	为界
Người Mỹ	美式
cho phép	允
Thuật toán	演算法
Đàm luận	论述
Pia	皮亚
lực lượng	力
đỉnh cao	顶尖
Người Sassanian	薩珊
đền thờ bằng đá	祏
Đền bù	賠償
Quận Nye	奈区
Shikai	世凱
Thừa kế	承袭
Frankfurt	法蘭克福
gian xảo	狯
cướp bóc	掠夺
Giải thưởng lớn	大賞
Dấu chân	足跡
Kẹo bơ cứng	太妃
Hông	臀目
men	珐
tinh vân	星雲
Đường thủy	水道
tín dụng	信用
Sai lầm	错
Novgo	诺夫哥
dày	蓊
dễ dàng	容易
khuynh hướng	潮流
Puerto Rico	波多黎各
Latvia	拉脱维亚
Tây An	奷
Silla	新羅
Tòa án tư pháp	司法院
Kiểu	型別
Cộng hòa Séc	捷克
cái tát	掴
mạnh	醼
Địa điểm quan tâm	名勝
Tổng quat	概述
Henry	亨利
Ngôi sao nhí	童星
Zhuo	倬
Chiến thắng vĩ đại	大捷
Xấu	厄
Đến Nhật Bản	對日
trạng thái bài hát	娀
Desheng	德生
con rận	蝨
Hội trường Tổ tiên	宗祠
ve sầu	蝉
ngọt	甜蜜
Luân phiên	相间
sử dụng	采用
Hoàng đế	英皇
Tình yêu phương bắc	北愛
đường sắt	軌
Sẵn sàng sử dụng	即用
Sego	塞哥
rỉ sét	銹
Nhà xuất bản	出版社
Bonn	波恩
Belfort	贝尔福
Shi Ye	時也
hạt dẻ nước	芰
Nguyên tử	核子
Tên	用名
trà	茶
gia đình hoàng gia	皇室
tội ác	罪
yêu và quý	愛情
Sáng	璀
Noy	諾伊
Kamchat	堪察
Thuê	聘
đảo san hô	环礁
Dưới cửa	門下
U nang	胱
buồng	内阁
Vài năm sau đó	數年後
Ma Ling	馬鈴
thiếu	匱
Kim il sung	金日成
Yên tĩnh	蜆
âm trầm	鱸
Đức Giê-hô-va	耶和华
Bảo vệ gỗ	木卫
pizza	比萨
Tìm thấy	找尋
phần lớn	最为
nhiều dòng	多條
Cá lóc	鳤
Keith	基斯
Murri	模里
Nev	涅夫
danh tiếng	成名
Cấp độ	層面
Thành phố Trương Gia Khẩu	张家口市
Cốc họp	會盃
có thật không	果然
Mẹ kiếp	操
Em gái	姊
hút	咂
Thành phố Trường Xuân	长春市
Canterbury	坎特伯雷
San Po Kong	新蒲崗
Quân đội	軍第
Sử dụng quân đội	用兵
Ngành đường	糖業
Hai	兩家
Bốn	四個
Yi	乩
Im lặng	嘘
sự hy sinh	犧牲
Thành phố nước	水市
Algiers	阿爾及
Toàn bộ cuốn sách	全书
Mi	弭
Xấu hổ	魒
Buồn phiền	挒
Lang	崚
Thành tích	事成績
hẹp	筰
Khó xử	閡
Xa lánh	闠
Stein	士坦
ngọn núi dưới biển	海山
tình hình	形势
Đê	皮埃
chim	雀
Sha	痧
tống tiền	勒索
phiền muộn	哀
Chúng tôi là	們於
Li Zong	李宗
Nên	应
Shimbashi	新桥
ma trận	矩阵
yêu và quý	爱情
họa sĩ	画家
sàng	簌
Sâu	深層
Pascal	帕斯卡
Đẻ trứng	催生
Tốt	赆
Hoa sen	荷
Bộ ba tác phẩm	三部曲
Cho một	為一
vòng	环线
khu tự trị	自治区
giám thị	畯
làm	令
bóng nhờn	膩
Suy sụp	壓抑
Xinh đẹp	麗的
giật gân	潑
kêu vang	铛
Không chính xác	不確
Trượt băng tốc độ	速滑
Barberry	檗
thứ hai mươi mốt	第二十一
Yuzhou	豫州
rỗng của một cái cây	枵
Mảng	阵列
mùa đông	鼕
Yate	亞特
Cá tráp	鳂
Dòng phía Tây	西线
Vật chất	材质
xa	遠
Brooke	布魯克
mỏng manh	阿姆
chuyển tiếp	过渡
Ban cho	格兰特
Chung	联席
nhà từ thiện	慈善家
Tandem	串联
Apollo	阿波羅
Xuất hiện	外表
Tống đạt câu	服刑
bố	父亲
Gặp	迎擊
Quần đảo	爾群島
Anhal	安哈尔
tiểu	尿
đơn vị	单元
Sin	正弦
Khắc lên	瓜分
Phía bắc	北侧
Dài	珑
tội phạm	罪犯
lười biếng	懒
dừa	椰子
Madan	瑪丹
Tom	嗵
Thụy sĩ	瑞士
Cải tiến	改进
thành viên	會員
Hợp lý	邏
Công dân xã hội	社民
Ye	晢
Baptist	浸信会
chín một	九一
Ấn Độ	印度
Cứu giúp	扶
trưng bày	展出
khắc	刻
điểm khởi đầu	起點
loại trừ	排除
chồn	貂
khỏi bệnh	瘥
nước Bỉ	比利时
tua	缨
duy trì	保持
Quân đội Nhật Bản	日軍
Một bữa tiệc	一黨
niêm phong	緘
Lãnh sự	執政官
Súng trường bắn	擊步槍
giật gân	泼
Copernicus	哥白尼
máu	血液
Y	厪
Xiangxi	湘西
Đông tới	東至
tăng lên	涨
Ruth	鲁斯
Sự sụp đổ	坍塌
Nya	尼亚语
Đẳng cấp	卡斯泰
Wei	渭
Neo	尼奥
Con rùa	鰟
phòng	屋子
Lãnh thổ	境内
Vội vàng	飈
Chiều rộng	幅
than đá	煤炭
cướp bóc	掠奪
Đến	而来
Nội chiến	国共内战
Su	蔌
Hiện tại là	現為
ly hôn	離婚
Maria	瑪麗亞
bàn chân có sáu ngón chân	跂
giai đoạn	相
Thô tục	俗
Klim	克里姆
Nói chuyện	叨
Hát	啁
Qi	雂
Dưới cửa	门下
rực rỡ	藇
Bắt đầu với	開始與
Vợ cũ	前妻
nhất thể	酉
Bắc Mỹ	北美洲
tử vong	死亡
hạt dẻ nước	荠
tiền mặt	现金
Điểm cao nhất	最高点
thịt khô với xương	胏
Khuyến khích	提昇
nghèo	贫
tấn công	抨击
Shan Gan Ning	陕甘宁
Watts	華茲
Nhảy về phía trước	跃进
âm mưu	情節
Xuechuang	學創
Báo cáo	報導
Po Leung Kuk	保良局
呒	嘸
Đã trang bị	配備
Changan	长安
giáo hoàng	教皇
minh bạch	透明度
cây kim	鍼
Sinh	诞
Quân sự và dân sự	軍民
Cũ	為舊
Tongzhi	同治
vết nứt	坼
Đường vòng	繞過
Columbine	哥伦
Hà nam	河南
khóc	哭泣
Trở thành vua	成王
Ryukyu	琉球人
tỷ lệ sinh sản	生育率
niken	鎳
Beth	貝斯
cuộc xung đột	冲突
Bột nhồi	击球手
Nổ	連發
tất cả mọi người	大家
hẻm	胡同
dây thừng	繩
nghèo	貧困
Đi đến	前往
đặc phái viên	特使
Năm đó	该年
Yongnian	永年
Columbine	耬
bằng lòng	懨
mặc	佩
Bài báo	條
Think tank	智庫
Khu trung tâm	中央區
Hôi	煴
ga tàu	站
Ming	澺
Sumen	蘇門
răng	牙齒
Nghệ thuật	藝文
Lai	籟
Thay đổi	改隸
Thời gian chạy	运行时
Được mời	应邀
biết rôi	知
Thành phố Ming	明市
Zeng	間曾
Brahma	梵天
Chế nhạo	讥
chì	引
Đã phát triển	所開發
Boli	玻利
Niêm phong	玺
Thống đốc	巡抚
giữ lại	憋
Đầu tiếp theo	下目
Hagen	哈根
mua chuộc	贿
Tỉ lệ	刻度
Cơ chất	底質
nói chuyện	談
Phản công	反擊
Người nổi tiếng	明星
Jian	戬
người lớn	成年
Sẽ lấy	會獲
trong trường hợp	如果
không khí	雰
Phá sản	破產
Ghat	加特
Trì trệ	停滯
chính thống	正統
cứng	僵
lưới	网格
hướng Tây	威斯特
iốt	硾
Lượng mưa	降雨
Tỉnh thành phố	省轄市
bùn	淖
Rio de Janeiro	里约热内卢
Các tòa nhà	建筑群
Gna	格納
Cổ xưa	古代
Xem xét	审
Renao	人奧
nửa đời người	半衰期
Yi	羱
Số Pi	丕
TV	電視電
Thế giới ngầm	黑社會
cao	高
thí nghiệm	实验
Gợi ra	引出
mưa bão	暴雨
Dong	琡
đỉnh	頂點
Đảng Dân chủ Tự do	自民党
ngôn ngữ	語
Eukaryote	真核生物
Ứng cử viên	参选
Có hiệu quả	高效
sốt	觱
Ottoman	奥斯曼
Yushi Zhongcheng	御史中丞
Đỏ	為紅
Chim cốc	鷀
Hộ tống	押解
chim cu	鵑
Tất cả nhân viên	全員
chi nhánh	分枝
Chenghua	成化
Huimin	惠民
Chính trị quốc gia	國立政治
Vật phẩm này	該項
Yu	騠
Khai quật	發掘
Thành phố Changhua	彰化市
Môi trường sống	棲
Thịnh vượng	娋
Guoan	国安
Chan	浐
Chỉ huy	指揮部
Trung tâm	中環
nhúng	蘸
tội	罪惡
phản ứng	響應
Nia	尼亞
Đạo cụ	道具
đường phố	街头
cảm tạ	感谢
Pip	霈
Bella	貝拉
đứa bé	寶寶
giới hạn	限
Massachusetts	马萨诸塞
Đồng thành lập	共設
Grub	蠐
Sự công bằng	正義
ngớ ngẩn	愚蠢
phía trong	裡面
khinh thường	藐
Ya	桠
Đổ	斟
cảnh giới	境界
Quận	為縣
Bản dịch tiếng trung	漢譯
thượng nghị sĩ	参议员
quỳ	灊
Sexy	性感
chiếm đóng	占領
Hàng ngàn	万千
Kiêu ngạo	棁
Lãnh thổ mới	新界
xúi giục	恿
lập dị	婬
Con dao cạo	蟶
Wu Hyun	武铉
Khánh Tp.	庆市
Thẩm quyền	职权
Ulva	玼
Thiếu sót	乏
nước miếng	唾液
đội trưởng	船長
nghĩa là	意思是
dưa	瓜
đồng phục	勻
Weiguang	為廣
Hoàng tử	亲王
Sự chiếm đoạt	拨款
mà đã thực hiện	表現
bông	绵
Trên đất liền	陆上
Thêu	繡
ấm áp	溫暖
VI	六世
Huan Wen	桓溫
Ngữ âm	注音
dưa hấu	西瓜
Xuống	下行
Chỉnh lưu	整流器
Đội đã thắng	隊獲
bình	瓮
Snipe	鹲
Danh mục lớn	大類
không quân	空軍
Lịch sử bài hát	宋史
Khoa học	理學
Seki	关市
Zemin	泽民
Thung lũng sông	河谷
bảng điều khiển	面板
Suy sụp	涄
Hải dương	海洋性
Serialization	连载
Oh	奧
Yi	伊
Goth	哥德
bi kịch	悲劇
Connecticut	康乃狄
Viết thư cho	写给
Datong	大同
Thẻ	卡片
S	论
Kiêng cữ	棄權
Chính phủ sạch	廉政
Euonymus	卫矛
chuột	鼷
Say	榽
Bồ nông	鶘
thế giới	天地
Ở đâu	所在
Xianggui	湘桂
bệnh viện	医院
sang trọng	豪華
Cải tiến	改良
Huyền phù	悬挂
Ảnh bìa	幡
đầu tư nước ngoài	外資
Lòng trung thành	忠孝
chủ tịch	总裁
Thân cây	箧
Quận và	區與
Số năm	五号
Ethiopia	埃塞
Hong Zhang	鸿章
Trẻ	楊氏
Primula	报春
Đàn anh	長老
Nước	水
chăn nuôi	牲畜
Thân cây	笥
Danh ca	天後
bạn trai	男朋友
xương	骨頭
Quá trình	流程
Hình ngôi sao	星形
Latin	拉丁語
Đảng dân chủ xã hội	社民党
Tàn tật	瘆
Lào	娆
Sắp	快要
Điểm cộng lớn	大加
Domicile	户籍
Cuộc cách mạng	公转
Buồn phiền	娌
Thời kì đồ đá	石器時代
Dốt	罔
Hum	呔
mạng lưới	淨
Lăng mộ	陵
mạng lưới	联网
tình cờ gặp nhau	邂
biến cố	大事
Philippine	菲律
không may	不幸的是
Quân đội tiền phương	方面軍
Vắt kiệt	濋
Châu á Thái Bình Dương	亞太
Sự chinh phục	征討
khó chịu	鐓
lớn lên	大人
Bướng bỉnh	膸
Cả hai	兩者
chủ nghĩa lãng mạn	浪漫主义
Binh lính và ngựa	兵马
lưỡi liềm	镰
Âm	襱
ổn định	定居
Đầu cơ	投機
Hỗ trợ phổ biến	民心
Làng	村村
Nổi dậy	叛亂
Bệnh trầm cảm	压器
Tuyệt vời	美妙
Ngân hàng phía Nam	南岸
cây sồi	柞
cọc	橛
Mozi	墨子
Han	晗
Shangri	香格里
chim đa đa	鴣
Hoa phượng	腴
thưa thớt	疏
Phụ thuộc	視乎
Bàn luận	議
Vội	黙
Na Uy	挪威
Hồng Kông và Đài Loan	港台
thuốc độc	酖
Xứ Basque	巴斯克
Công việc nhà nước	国务
Giỏi về	擅长
Chất xơ	纤
Hoàng dương	隋炀帝
có nghĩa	手段
chân sau	後肢
Ban cho	授
nguyền rủa	詈
ngầm	潜
khó khăn	困难
Đang theo dõi	是繼
Lohan	罗汉
thiên đường	乐园
Sẽ có	會有
Dạy	授課
cá heo	海豚
Jiao	蛟
một bài kiểm tra	檢查
躏	躪
Cúp châu Á	亚洲杯
Năm màu	五色
Khả năng lưu trữ	库容
Bên ngoài thành phố	城外
Canthus	蜦
Hoover	胡佛
Quốc gia	諸國
Đến chưa	來沒
Sa	薩
kho chứa	車廠
Áo ngực	布拉
Màu trắng ngà	灰白色
Con số	為數
Những người từ	人從
Jiangning	江宁
thứ mười lăm	第十五
Xie	赨
sáng	皎
Hải quân	海軍
tiếp xúc	接觸
xấu	恶劣
Rạp chiếu phim	影院
Xi	夕
Xoắn lại	踡
Xi	乫
Mọi người	民众
Quần đảo Thousand	千島
Xiaofu	晓夫
Ye Liu	葉劉
Astral	星體
Bắc Dakota	北达科他州
lễ hội	節慶
Tái định cư	易地
Người thay thế	替補
bản ballad	民謠
绨	綈
Được bầu lại	連任
Hongkou	虹口
chảy ngược lại	湋
Thị trấn nước	水乡
Xô	捅
khô	熇
ngốc nghếch	儍
Wren	鹩
lễ cưới	婚禮
Shi Huang	始皇
phương tiện	车辆
Vượn	鵷
Li	橦
Giữ	拕
tời gió	轤
quỹ đạo	弹道
Quảng trường	史克威尔
đóng	亲密
giấy phép	许可证
Phối hợp	结合
đồng	銅
Chim săn mồi	鸷
Giường	床位
củ cải	蘿
Bắc Calais	北部加来
Phil	菲爾
Forbes	福布斯
trò đùa	笑話
Trên cánh đồng	场上
Bối cảnh	上下文
nỗi sợ	怵
Từ ngữ	词语
Trò chơi	弈
Viết	写法
tiền lệ	前例
Quy tắc quốc gia	國則
viện bảo tàng	博物院
Con trai thứ hai	次子
hiện nay	如今
Tất cả chúng ta	們都
Yun	篔
thành viên	员
con số	號碼
Suy đoán	推测
Kêu vang	磬
Hướng tây	西进
Chính	少校
quăn	鬈
Của nó và	其與
Quân đội	大軍
Được công nhận	认可
Buttstock	槍托
Thoát ra	廢氣
Gangzhen	岗镇
lừa dối	欺骗
Chad	查德
dây đai	绦
Hoắc	穜
người ăn xin	丐
Hoàng hậu	女皇
chủ nhật	週日
Os	挝
Bản thảo	原稿
Toyo	東約
ách	軛
Taliban	塔利班
Điều này cũng giống như	這與
Đội dự bị	预备队
Ngày hôm đó	那天
Đây là	今屬
Thống đốc	总督
Hệ thống đại diện	代表制
Suy ngẫm	反照
Suy nghĩ đầu tiên	先念
Tấn	誀
Vào	化成
Bộ Giáo dục	教育部
Xuân	蟙
Barto	巴托
Tuyệt vời	精湛
xoang	窦
Mô hình	模特
Huân	奂
Xe điện	軌電車
Ông	先生
Đây	於此
cưỡng bức lao động	繇
Chuyến bay	班机
dọn dẹp	乾淨
Cúp thế giới	世界杯
lợn biển	海牛
tổng sản phẩm	生产总值
Đông cứng	冻
lõm xuống	凹
Báo cáo	报
biến cố	事變
đá	岩石
Trong phạm vi quyền hạn	轄內
halogen	鹵
Nâng cấp lên	升格為
khập khiễng	跚
Mặt hàng nhỏ	小項
Chờ	等為
nhà truyền giáo	传教士
Thể dục thể chất	體能
Broadway	百老汇
Vội vàng	捩
Công ty Cổ phần	股份公司
Hầu hết	居多
Tên	定名
nhiệm vụ tại ngũ	現役
quả bầu	瓠
Chủ nghĩa tu viện	修道
tiểu thuyết gia	小说家
lót	襯
dụng cụ	仪
Ai cập	埃及
Cher	歇爾
cụm	簇
Xuân	禃
Yoro	與羅
Cột	列
Boong	得克
Và trở thành	並成為
Dừng lại ở	止於
Màu là	色為
Jeff	杰夫
Thành công rực rỡ	全壘打
Euphorbia	大戟
địa phương	本地
máng	潋
tưởng tượng	想像
kết quả	結果
Nước đá	氷
nỗi sợ	畏懼
hào phóng	嘅
một	之一
Công việc chung	總務
bàn cờ	棋盤
Truy tố	起诉
Bạn bè	朋
Đóng vai chính trong	出演
Bay lên	飙
nguồn	源
Bok	博克
cạo râu	剃
đồn trú	駐軍
con bò cạp	蝎
Nhận ra	悟
Bing	炳
Trình độ cao	高层
Hệ thống chính trị	政制
máng	瀲
Lượt xem	覽
Acyl	酰
Tua	紱
Máy bay	機飛
Kết hôn	迎娶
Quận	县立
Tiếng ồn	雜訊
bát	碗
Pha bên ngoài	外相
ngân sách	财
Và đặt	並把
Nhà tài trợ	赞助商
Tự lực	自助
nếp nhăn	皱
Dưới núi	山下
Ga Tian	田站
màu xanh lá	青
kết cấu	构造
Về mặt hành chính	行政上
nhấn	按
mứt	藷
Đảng đối lập	反对党
Tiếp theo	繼
Ánh sáng	輕型
thiết bị đầu cuối	終端
Về hưu	退伍
Cả hai đều	均為
đại dương	海洋
xem xét	虑
nôn mửa	嘔
trái	左
Mơ hồ	歧義
hàng hải	海上
Sting	鞫
Kỳ lạ	奇异
cao su	橡膠
Jingwei	精衛
phi thường	非凡
Akihito	明仁
Răng phụ	齒亞
Valencia	巴伦西亚
铓	鋩
loài	树种
thuốc độc	毒死
Tiểu vùng	亞地區
Tung Chung Line	東涌綫
Bộ chính trị	政治局
Cả từ hai phía	两旁
Crodi	克罗地
Cứu trợ	救济
Trong vòng đồng hồ	鐘內
tài chính	财政
Hoang tàn	梈
Nghe rõ	收到
Hoxha	霍查
Quốc gia	國立
ghê tởm	厌恶
sân khấu	阶段
chế tạo	製造
Chiến trường	野战
Chỉ	示
Qi	駰
Sắp	正要
đủ tiêu chuẩn	合格
đánh bại	打败
Đô la Đài Loan mới	新臺幣
Dongguan	东莞
Yun	筫
Công chiếu	首映
đáy biển	海底
Leo núi	登山
Guoxue	國學
Moni	莫妮
Dậm chân	跢
trưng bày	陈列
Ông trùm	大亨
Được coi là	被视为
chất lỏng	液体
chuyển khoản	傳遞
Serrano	鮨
mã	碼
Xiangyang	襄阳
người	煐
hoàn thành	完全
Giải đấu Mỹ	美國聯盟
Không tệ	不错
Macro	宏
Chồn hôi	鼬
lu bu	呂布
Vương miện	冠
Chu	擥
miền Nam	南面
Giải thưởng nhân vật chính	主角奖
đệ tử	門徒
Vợ lẽ	大妃
Vua vua	勤王
Đã sẵn sàng	早已
Yan	帉
Tokyo	东京都
quay số	撥
Yan	釾
cây kéo	剪刀
dần dần	逐渐
Huairen	怀仁
Nếp	饆
dây	緡
căn cứ	基
Bok	簕
hợp nhất	合并
bữa ăn	膳
đường phố	陌
Shi	士
Tần Hán	秦汉
Khuyến khích	擢升
Nhóm người	人組
Thế giới ngầm	黑道
Sinh sản	生殖
khu tự trị	自治區
Knicks	尼克斯
khiển trách	诮
giảm giá trị	恶化
vô danh	匿名
Đại học Thanh Hoa	清華
cây	厰
Cản trở	阻撓
Đối với	目為
Cairns	凱恩斯
Nghỉ ngơi	馀
Con tàu	該艦
bệnh da mặt	疕
Chiayi	嘉義
xấu	寙
Đa dạng	各家
chương trình	程序
lời hứa	答應
hiệu ứng	效果
Pavilion	馆
Bán Đảo Scandinavia	斯堪的纳维亚
Jiezhi	傑志
Miyaka	宮中
Buenos	布宜诺斯
Manchester United	曼联
Dòng chính	主線
scull	櫓
Ủy ban Kiểm tra Kỷ luật Trung ương	中纪委
Bờ đối diện	对岸
Tong	栱
Đề xuất	建议
Tàu du lịch	郵輪
vịt trời	凫
Tòa thánh	罗马教廷
Không hút thuốc	禁煙
Nghe	聆
thằng hề	小丑
khu vực thiên tai	灾区
gặp gỡ	会
Goss	哥斯
gió	缭
Họ sẽ	將他們
Nhàm chán	镗
Trường Hưng	长兴
cho họ	為他們
Sẽ có	有將
uy tín	名譽
thơ	诗
Cục Lâm nghiệp	林业局
nón tre	篢
con lợn	豬
Quân đội	军第
kẹp tóc	钗
Shuhan	蜀漢
Lượt xem	檢視
tiếp tục	继续
treo	掛
Tôi	亸
Huân	煥
bao gồm	包括了
Gaul	高卢
Gith	吉思
Glycine	苷酸
Riêng tư	私家
Giám đốc điều hành	特首
từ chối	下降
Người giúp việc	嬢
Leah	利亚
Ra khỏi núi	出山
tối thượng	終極
cầu vồng	彩虹
răng	齿
Miligam	毫克
Số lượng	號的
Vận tốc gốc của đạn	初速
sự nối tiếp	数列
Thay thế	轉而
tăng lên	上涨
thông gióDray	通風德雷
Lực lượng	逼使
thuộc địa	殖民地
Ngày tiếp theo	次日
Quan	琯
tập đoàn	株式会社
Đăng ký	签约
kiểu tóc	髮型
tiện lợi	便利
Ruồi Tây Ban Nha	蝥
nhà điều hành	算子
Cắt	剪
Nguyên thủ quốc gia	元首
Ji	垾
phi lý	謬
Lin	琳
Ủy ban làng	村委会
lẻn vào	潜入
Thời báo Trung Quốc	中國時報
Protease	蛋白酶
Từng cái một	逐
Ghi chú	音符
từ trường	磁場
Buồn phiền	徤
Kiêu ngạo	诣
ngắn	短暫
Tổng giá trị đầu ra	总产值
Đình công	紛爭
cứng	殭
Với	連帶
Viết thư cho	致函
Lencia	伦西亚
Okinawa	沖繩
Trừng phạt	罸
Chói mắt	衒
Shao	芍
Dong	硐
nguội đi	冷卻
Trung tâm phía bắc	中北部
thịt	肉类
Quân đoàn	軍團
gò đất	堙
người lái xe	司機
lãnh thổ	境
Sonic	声波
Đang chuyển hàng	航運
Lưu lượng máu	血流
Xia Chao	夏朝
Tang Ren	唐人
Biến mất	消失了
Có thể một	卡纳
Denver	丹佛
Mi	羋
Cobe	哥白
May chăn	绗
Ottoman	鄂圖曼
không gọn gàng	襶
Li	俬
Khuấy động	煸
Opera Đài Loan	歌仔戲
Ba con trỏ	三分球
Jiao	姣
Cùng mẹ khác cha	异母
Tát	跽
Kín đáo	預留
Âm	覼
Bảo vệ	護軍
Biên tập	辑
Cách mạng tháng Mười	十月革命
Tải	载荷
Ahmed	艾哈迈德
phi hành gia	太空人
thang máy	抬
Dương châu	扬州
chứng điên cuồng	蛊
Mộc qua	榅
Đã qua đời	去世
Ge Liang	葛亮
Sui	蔹
huy chương	勳章
Hun	禸
Mã là	碼為
La tinh hóa	拉丁化
cử đi	牒
mùi	聞
Khu vực đài loan	臺灣地區
Qi	鐀
Lên	髾
Khu vực thái bình dương	太平洋區
đẩy lùi	击退
Không có đảng viên	無黨籍
Luân	欒
Dài	暳
chân	腳
Món ăn	饔
phân phối	分发
mùa vụ	农作物
Thay vì	與其
Mạnh	强盛
Họ ngôn ngữ	语族
Tự vệ	自卫
Trường đại học bình thường	师范大学
Đen	黓
Ed	艾德
Ghen tuông	讱
Hukou	戶口
Nội bộ	對內
Pterodactyl	翼龍
đánh	击
Ý nghĩa	含義
súng máy	机枪
Tuấn	榟
Quang học	光学
Thẩm phán	县长
Gần	将近
Hậu duệ	后人
may mặc	服飾
Đồng ký	連署
Loạt	丛书
chú ý	睬
Xe điện	电车
nuốt	鳦
Kiêu ngạo	戓
Mưa sao băng	流星雨
nước Đức	德省
Và kể từ khi	並自
con bò cạp	蛃
Con la	骡
Ito	伊藤
vô luân	不道德
ước tính	估
Kinh nghiệm	身受
quạt	扇
trị liệu	疗法
món ăn	食品
Quận	县属
tháng Ba	進軍
Bệnh nặng	病危
Làn sóng mới	新浪潮
bên	侧
mong manh	嫋
Mát xa	按摩
tham	骛
Toàn quân	全軍
gạc	鹿角
sòng bạc	赌场
Khi nào	時卻
Nắm quyền	執政
Lu	龗
làm sao	怎么
Alexander	亞歷山大
Spartan	斯巴達
Trúng tuyển	出選
Với	與之
Điểm chuẩn	基準
Giải phóng	上映
Quốc gia	的國
Myanmar	缅
làm phiền	烦
Máy dò	測器
tính cách	性格
Nitz	尼茨
Định nghĩa	定義
đơn vị	機組
thứ mười	第十
Tín đồ	教徒
Kiềm chế	抑
chung	常見
Hợp tác	协同
James Soong	宋楚瑜
cao hơn	高等
cách mạng	革命家
kiểu	打字
Con trai	儿子
Gần với	接近
buồng	内閣
Izumo	出雲
Như nhau	均勻
Cây rơm	叠
Ghim	蒎
Pháp luân	法轮
máy dò	探测器
sỏi	石块
Cannonball	砲彈
Lak	拉克
Dòng chữ	碑刻
Phòng triễn lãm	陈列馆
sương	露
Chiếc phà	渡轮
Hai số không	二零
lặp đi lặp lại	沓
Bundesliga	德甲
Đội	班底
Luộm thuộm	悋
Thay đổi thành	換為
kiểm tra	试验
Màu xanh da trời	為藍
Đất đai	陆路
Thượng Dương	商鞅
Varang	瓦朗
Chen Wen	陳文
Cho hơn	為過
bận	繁忙
Tăng	増
thú vật	动物
Trung ương Đảng	党中央
Miko	美子
lính	军人
Giảm giá	发售
polyme	聚合物
hết hy vọng	惆
Qi	秡
thưởng thức	享有
Xưởng đóng tàu	造船廠
hệ thống	係
Cúp nhà	家盃
Canthus	眦
Das	達斯
ẩn giấu	隱瞞
Sự vi phạm	侵权
Rhine	莱茵省
động cơ	马达
Được bầu là	當選為
Mạng lưới điện	电网
Phi công	飛行員
Mẹ	母體
phi	抛
Thiết lập một trạm	設站
Nhẹ nhàng	略微
trò chơi	游戏
Khen ngợi	歌颂
Nho giáo	儒學
ngẫu nhiên	隨意
vụ bê bối	丑闻
Nhóm	組別
tạm ngừng	停頓
Phía sau	部後
Đàm phán	商议
Dòng và	線與
Điện dung	容性
Yor	侑
Disco	迪士
chủ nghĩa dân tộc	民族主义者
Phải	渥太
Về lúc	約在
xúc phạm	冒犯
Thiên nhiên	大自然
Higgin	希金
Nhìn chằm chằm	睱
bếp trưởng	厨师
đậu hũ	豆腐
California	加利福尼亚
Thuê	聘任
Trả	缴纳
Sống động	活泼
Phòng nghiên cứu	研究室
đỉnh núi	嶁
Bài ca đi học	校歌
Lu	闾
Người biểu tình	抗议者
So với	比作
ủng hộ	扶植
Rồng và phượng	龙凤
Bìa lồng	笼盖
viện sĩ	院士
Lượng mưa	降水量
Gọi nó đi	稱其為
Ghen tuông	遆
Ankylosaurus	甲龍
Nhận vào	錄取
biên giới	邊疆
Băng nhóm	硔
Lính đánh thuê	傭兵
xoáy	瀠
Nồi	瓅
Làng đá	石村
Yan	郞
Sự căng thẳng, quá tải	株
bằng cấp	资格
Pang	庞
Chứng tự kỷ	自閉症
cam kết với	承诺
phân loài	亞種
nhân lực	人手
lãnh thổ	领地
So sánh	比较
Pháp	法器
Lin	蔿
ẩn giấu	囥
Gọi là	稱作
Của việc học	的學
tranh chấp	糾紛
Troyes	特鲁瓦
bên trong và bên ngoài	內外
vấn đề	问题
cung điện	宫
Công việc khó khăn	刻苦
chức vô địch	錦標賽
Phổ biến hơn trong	多见于
Trước hôn nhân	婚前
bùng nổ	轟
Giảm	减小
cột mốc	里程碑
cốc thủy tinh	玻璃
nguyên âm	母音
nhiều lần	屢次
Quân đội mở	軍開
non nớt	雛鳥
Assen	阿森
đũa	箸
Tác phẩm được sưu tầm	文集
Chengde	承德
Chỉ đứng sau	仅次于
Kou	寇
Hậu Thanh	晚清
chính thức	正式
Buồn phiền	挀
Sasa	笹
Theo nó	依其
Trang Chủ	家用
Tất cả các cách	一路
mua, tựa vào, bám vào	购
Tăng đoàn	僧團
Lai	籒
Ningxiang	宁乡
Thắng lợi	勝
Dương châu	扬州市
Giảm xuống	降為
điện	電動
Thăng thiên đúng	赤經
Zhuang Xiang	庄乡
Fu	褔
đường dài	长途
kiêu ngạo	自大
Từ	出於
mu	亩
Ayumi Hamasaki	濱崎步
Cơ sở	房地
Hợp nhất thành	並成
Chong	骕
Đầu dòng	行首
Đã hoàn thành	竣工
Sương mù	霭
Giám đốc	司長
Lhasa	拉萨
Trung tâm	央
xếp hàng	排隊
Sách giáo khoa	教科文
Nông thôn	郊野
Anda	安大
Vừa mở	剛開
Nhà Hán	漢朝
Michelle	米歇尔
Sự sống còn	殘存
Tiêu điểm	聚焦
Đã hết hạn	屆滿
Chipset	晶片組
Ngay sau khi	對後
Cục thống kê	统计局
Ibn	伊本
điện dung	電容
Đời sống ký sinh	寄生生活
Chùa Phật giáo	佛寺
Con nuôi	養子
Tư Mã Ý	司馬懿
lở đất	滑坡
Quan	鎷
tại sao	為什麼
nội trợ	主婦
huy chương vàng	金牌
Có thể gọi là	堪称
Torii	鳥居
Nhà thực vật học	植物学家
tan chảy	熔
dán	糊
bữa ăn sáng	早餐
Jingmei	景美
Máng trượt	魯閣
Gần gũi	親近
Nước Ý	意大利
Hu	蚠
Phê chuẩn	處分
Luther	路德
Khánh thành	就职
Cường điệu	炒作
Michigan	密西根
nhiệt tâm	热心
Ngọc bích	翡翠
vẽ tranh	繪製
Bộ	部委
thư	邮
hình dạng	塑造
mười bốn	十四
Cây	椥
màu xanh lá	绿
Hoàng dương	煬帝
Mở ra thế giới bên ngoài	對外開
của tôi	矿山
câu hỏi	題
Dịch	譯作
Kai	愷
cá	漁
khán giả	听众
ánh lửa	煟
Mức độ thứ hai	二度
hiểu biết	懂
cờ đỏ	红旗
Tỉnh	该省
Montgomery	蒙哥马
vượt qua	克服
Lo lắng	悙
Tin tức	聞節
hợp đồng	合同
Pei	珮
Lịch sử đội	隊史
Hugo	雨果
Được đặt tên	名为
Cao nguyên	塠
nhà trọ	旅馆
Ya	犽
chảo-	汎
Quên	遗忘
tiền công	工資
tận thế	天啟
hơn	更加
cho đến khi	為止
Chi	墀
Ngọc trai	明珠
Tên	名號
Đền hoàng đế	帝庙
Trò chơi phiêu lưu	冒險遊戲
Kéo	抠
hộ tống	护航
quanh co	逦
Zhen	珍
được chia thành	劃分為
nước Đức	德意志
Lính đường sắt	铁道兵
Hoàng phúc	皇甫
Tổng giám đốc	總幹
Vski	夫斯基
Sự chảy máu	出血
dàn nhạc giao hưởng	交响乐团
Grady	格拉底
Anbang	安邦
ngọc bích	瑭
Minsk	明斯克
Ngoài	出局
Trung và	中與
Hỗ trợ	輔佐
Anji	鯷
Xi	岻
khách hàng	顾客
Giám sát	监察
Yitian	倚天
Ban đầu	本為
Phiền muộn	悪
Hein	海因
Giá cả	成本
Hai nhóm	兩組
Khung xe	底盤
Các nhà hoạt động	主義者
Lên kế hoạch cho	定于
hàng đầu	頂端
Di sản	遗留
Có thể để	能讓
Cuốn sách này	一書
đặc biệt	特殊
sự độc quyền	壟斷
Môn học	课题
Bạn	誎
Nạn nhân	受害人
vàng	黄金
bối rối	汩
Sẽ lựa chọn	會採
Đặt	投放
Yun	恘
Kun	焜
Shengbao	生報
Bian	汴
Phần thưởng	酬
Sôi sục	慙
Vội vàng	涔
Rong	荣
đạo Hồi	伊斯蘭教
tin đồn	谣
Bầu cử quốc hội	議會選
Giữ	憻
Khang Hy	康熙
Ling	苓
kéo tay áo lên	揎
diệc	鷥
Trong phim	片中
Đi nước ngoài	出国
Đường County	縣道
hút	吮
Trận đấu quân sự	軍賽
Lớn hơn	年长
quân phục	軍裝
Thánh địa	麦加
Đưa cho	付出
Hiệu sách	書局
quyền lực	強大
ở gần	邇
Thay đổi	剤
kết thúc	端
giải cứu	营救
Shao	杁
xuong xe	下車
phần còn lại	其余
Sự phối hợp	配位
KMB	九巴
Kur	库尔
Tát	臞
Nguyên	原創
Lân lượt tưng ngươi một	相繼
nhà tù	囹
Trường trung học cơ sở	初级中学
Sạc điện	电荷
Maki	蒔
Chứng khoán	證券
đường	途
Nhà Minh	明朝
Đối với	為於
gian hàng	楼阁
Kỹ lưỡng	精心
tuyệt vọng	嗒
cũ	老
Jian	枧
Hoa Kỳ	合國
Giỏi về	善于
Khiêm tốn	磤
Tốc độ gió	風速
Dịp	際
khó khăn	韧
Furfur	呋
Yu	驫
Một PO	阿波
Nhân dân tệ	瑗
Bị hạ bệ	廢黜
Hải lý	海里
Linh mục trưởng	主祭
Quân miền đông	東軍
Giả mạo	假借
may mắn	幸運
Hu	禩
Thờ cúng	祀
Ga cuối	总站
liệu	是否
Thủ tướng	總理
Cuối của phía đông	東端
Dưỡng dục	養育
bộ trưởng, mục sư	臣
Tát	擳
tai	耳
Xen kẽ	插播
Riel	瑞尔
Đặt nằm	居士
Đề cử	提名
thợ mộc	匠
huỳnh quang	熒
tên nick	诨
một phần mười	十分之一
hồi phục	复建
buồng trứng	子房
tham dự	参与
Co giật	癎
Hổ trắng	白虎
tải	負載
Âm nhạc	樂曲
Williams	威廉姆斯
bốn	四
Quân đội Anh	英軍
Gengxu	庚戌
kiểm tra	支票
Rơi vãi	掉落
riêng	私下
Tochi	栃
Ying	滎
ngốc nghếch	傻
Sem	瑟姆
Chạm tới	抵
chủ nhân	業主
vỗ nhẹ	拊
Senegal	塞内加尔
Bản ballad	歌謠
bonito	鰹
phun	噗
cao quý	贵族
Sâu	蚆
Tiền lương	薪金
vượt qua	传
sư tử	獅子
Liberia	利比里亚
Thành phố vô tích	无锡市
Bê tông	混凝土
Tỉnh miền tây	西省
geld	騸
đứa trẻ	仔
Câu hỏi	質詢
Tàu	艘
Nhượng lại	割让
Người già	老年人
nhà văn	文学家
Đài phát thanh	电台
cây củ cải	葑
Thống trị	覇
sự đối xử	治疗
háng	裆
lý do	理由
Ca hát	唱腔
ăn cướp	搶劫
Nào	來對
Chính quyền	政体
độ tin cậy	可靠性
Zhu	菚
Huy hiệu	紋章
Nhón	撮
Nhóm C	丙組
Bashful	臩
Phương tiện truyền thông	傳媒
duyên dáng	迷人
Phù hợp	菲特
Ba ngày	三日
Goguryeo	高句丽
Trước mặt	車頭
Chính thống giáo	正教
Số bốn	四号
Stoke	沲
sự phản đối	异议
Nhân nhượng	绥靖
Đông Trung Quốc	華東
Gửi quân đội	发兵
Bầu cử bổ sung	補選
shad	鰣
Đặt hàng	勒令
đảo Marshall	馬紹爾群島
bán đảo	半島
bão hòa	饱和
Deng	邓
tuabin	涡轮
Chất lượng nước	水質
san hô	珊瑚
nhà thờ Công giáo	天主教会
Lian	濂
cách phát âm	读音
Versailles	凡尔赛
Aisha	爱沙
Niang	尼昂
Tiểu bang Mexico	墨西哥州
Thẻ	孒
đưa cho	给予
Gọi chung	總稱
Nipa	尼派
Đào rãnh	绖
Và tham khảo	並指
Cắt	剳
Li	鴎
ghi bàn	評分
Phía Nam California	南加州
Gangomorpha	綱鮋形目
đường kính	直徑
Nước hiệp ước	约国
Cánh cổng	之門
Độ nóng chảy	熔点
Mỗi năm	每年
trớ trêu	讽刺
Dơi	蝠屬
Các nhà hoạt động	主义者
Cỏ	草属
Riêng tư	民办
đi lại	徉
Đông Trung Quốc	华东
Nhận định	定論
thành phố	都市
Che đậy	揜
Hoặc là	或是
Hạt Luo	羅縣
Wan	脁
Thay thế	另類
Hạt	各縣
Vẽ tranh	汲
Bộ Trưởng Tư Pháp	检察长
Hamilton	哈密顿
sản xuất	产生
Lãnh sự	領事
Bang	昐
Quản lý trường học	校董
tăng	增长
chuyến du lịch	游览
Giả vờ là	裝為
Sững sờ	懀
hoàn thành	完备
khó khăn	难
Tin đồn	據傳
Rakka	拉卡
học hỏi	学会
cây lau	苇
chiến thắng	勝利
Trong cung điện	宮內
Như thể	儼
Hành tinh lùn	矮行星
Gọi là	被召
Tên	人名
Có hiệu lực	得力
Khoa tiếng trung	中文系
Tanaka	田中
Quá khứ	過往
hòa hợp	和睦
Khen ngợi	褆
Mand	曼德
Màu sắc	花色
Quân đội trong	軍在
Tianfu	天福
tuyệt quá	伟大
nước Đức	德國國
đau đầu	頭痛
đỏ	赤
Diễn xuất	署理
người môi giới	经纪人
Nhân Viên	參謀
cấp quốc gia	国家级
lịch trình	進度
lập kế hoạch	规划
khổ sở	悒
mồm	觜
Nhượng bộ	租界
Lá thư	致信
khu vực	扇形
tiếng ồn của sóng biển	漰
Đồ dùng	器物
Bị giết	被害
kích thích	激勵
ngã	摔
Yau Tong	油塘
bến tàu	坞
kịch	戏剧
Rỗng	中空
mờ mịt	曀
Bao gồm	劃入
Dịch vụ	务
Bộ	寘
Nhặt lên	攟
Mại dâm	產主義
缡	縭
Chống qing	抗清
Caesar	凯撒
Vết trầy	揔
Người chơi giá trị	價值球員
Xi	昔
Nheo mắt	睟
Ren như	任為
byte	字节
Tin tức	訊
Kỹ thuật	工學
Phiền muộn	洼
Chu	楮
Bởi vì	因於
côn trùng	昆蟲
Consortium	財團
Ba mươi sáu	三十六
Ming	鸣
chảy máu	流血
hội,, tổ hợp	组装
Liệt sĩ	烈士陵园
Cặp đôi	耦
Trả	払
cáo	蓪
giỏ làm bằng cói	籚
Cấp	順位
bất động sản	財產
An	垵
Câu lạc bộ bóng đá	足球會
Nasi	纳西
Đánh bại	擊潰
Điên	谆
Tucker	塔克
Hoắc	藿
Hạ xuống	裔
Hiển nhiên	自明
Sau khi đầu hàng	投降後
Lang băm	佊
đạn	子彈
Âm	眞
Cổng	盖茨
Yu	昱
nghĩa trang	陵园
Máy tính bảng	牍
giấy phép	准許
Sau khi trở về	歸後
Vội vàng	溓
Các biến thể	變體
giá bán	价格
Xem lại	改判
Tỉnh Tottori	鳥取縣
Thành phần chức năng	功能界別
Enshi	恩施
Bù lại	偏移
Chủ tịch	董事長
Thành phố Hara	原市
Vacker	伐克
Nedi	涅狄
Trong dòng	線內
đồng	铜
Ga tàu	驛
Hạt Mei	梅县
Băng nhóm	蟸
Hoài Hà	淮河
khiển trách	诃
Hàng chục	数十
nhìn chằm chằm	睽
thế chấp	抵押
tiết lộ	透露
Máy bay chiến đấu	战机
lơi noi va hanh động	言行
trơn tru	畅
Lucy	露西
Kang	畂
Thăm dò ý kiến	民調
Claude	克劳德
Đặc trưng	特點
Newcastle	紐卡
thợ làm bánh	貝克
tôn kính	荣誉
Sự thù ghét	仇恨
chim cun cút	鹑
Đột ngột	橁
nghĩa là	意味著
để trần	龇
Âm	稥
Li	蠎
niobium	铌
Quebec	魁北
bướng bỉnh	顽
kho chứa	场站
Độc thân	單曲
Đào tạo	受訓
Quan sát	視察
Đại khái	大致上
Bộ	所設
Nước cạn	淺水
Suy luận	推算
Đặt hàng	吩咐
Dây chuyền sản xuất	產線
Hệ thống tinh thể	晶系
Ủy ban kiểm tra kỷ luật	纪委
nguyên nhân lớn	大業
Ghen tuông	揷
Quen biết	熟知
Bắc Âu	北歐
Đài truyền hình	電視臺
Hum	吽
nến	燭
Cao hơn	高于
Cảnh sát trưởng	警長
thư viện	文库
Tưởng	蒋
Phúc châu	福州市
Xiuquan	秀全
chiếm lấy	攻陷
Tuyệt quá	餜
Chang Zhang	長張
ủng hộ	支
cá nhân	單人
ngành công nghiệp	业界
răng không đều	齬
Dan	儋
bàn luận	商量
Không hỏi được	索不
cầu	橋
Mới	紐
nhà máy	工廠
cung điện	宮廷
Và mở ra	並開
nhân bản	克隆
Tương lai	将来
Nước	沃特
Hà	嗧
Nietzsche	尼采
Cho thuê	租借
Trên thế giới	世上
xà lan	驳
Học tập	學藝
bánh ngọt	蛋糕
Dừng lại	塞音
Tan	坦
Hausen	豪森
Jiongming	炯明
thông qua	途经
kẻ trộm	賊
giữa	之间
Atlantic	大西洋
bỏ cuộc	放弃
Xu	胥
ký tên	招牌
đấu thầu	溫柔
kỷ luật	纪律
Zhu	濶
Âm	莾
Đầm	大坝
Tong Jian	通鉴
cầu vồng	蝀
Tên	姓
nhóm	群
Tấn	勋
Bunbe	文部
Làm cong	經發
Có ở đó không	在沒
Cá	鱼类
Sirius	天狼星
cộng đồng	共同體
Xiao	潇
Đào mương	堑
Tát	濓
Lên ngôi	即位
Uỷ ban	佣
Đà điểu	鸹
Dâng trào	涌
Nanliang	南梁
Sự gắn kết	凝聚
Cắt	剕
Các hãng hàng không của Mỹ	美國航空
Nhân dân tệ	媛
Dài	竩
phỏng đoán	揣
lụa	紬
Bảo trợ	客量
Quốc gia	囯
Tinh Kanagawa	神奈川縣
Ghế phụ	子座
hải quỳ	海葵
Tên trường	校名
Albert	艾伯
Nghẹt thở	扼
Chạy xuyên qua	纵贯
Hom	埳
Houston	休斯敦
Tiếp tục	矣
ngay	立即
Tên trang web	站名
Liang Zhenying	梁振英
Sabah	沙伯
Yan	剻
tính cách	字符
Trang thiết bị	设备
Anh giáo	聖公
Cờ vua quốc tế	國際象棋
Phố Wall	华尔街
Thành thị và nông thôn	城乡
Và mang lại	並帶
Axit amin	氨酸
Tình cờ gặp	躚
khuyết điểm	瑕
Baodiao	保钓
Không có bữa tiệc	無黨
sau đây	下面
gỗ đàn hương	檀
Cáp treo	纜車
Xoay	匝
vật chất	素材
Tang	旽
chế độ	模式
Đếm theo	数以
Xuống	宕
Xuân	瑃
Yan	妍
Trừng phạt	制裁
màu xanh da trời	青色
Thùng rác	賓
đặt hàng	訂購
Uy tín	美譽
chỉ huy	命令
địa điểm cắm trại	營區
cô đơn	寂寞
ổn định	稳
gốc	淵源
Đại học Luân Đôn	倫敦大學
Amster	阿姆斯特
chậm	缓慢
Kitt	基特
Hoảng loạn	讃
Hoa loa kèn	芠
iốt	碘
Không thích	嫌
Tello	特洛
lượng tử	量子
Ẩm	湿润
lực lượng	部队
rối loạn	動盪
Sửa đổi	修正案
hệ thống	系統
treo	挂
Philippines	菲律宾
Nobel	诺贝尔
thiết lập	设定
Taiyuan	太原
Chết	歿
quá khứ	過去
Quận Tsuen Wan	荃灣區
chuồn chuồn	虻
Oman	阿曼
Dập tăt	熄
làm rõ	澄清
chiếc phà	渡口
Mary	瑪莉
Đây	兹
Yong	镙
Tin lành	新教徒
Bài đăng	發後
phía đông	東面
Dong	侗
Nuthatch	鳾
Mạnh	為強
Dấu hiệu cuộc gọi	呼号
Sumu	苏木
Trung Hoa cổ đại	古汉语
Là khi	是當
Tội lỗi	疚
Đi ngược lại	違背
Điều lệ	宪章
Amino	氨基
Zhen	梡
Ả Rập Saudi	沙特
rút lui	撤回
Quận Nam	南县
cắt cổ họng	刭
con rắn	蛇
Bầu cử tích cực	正選
châm lửa	放火
một mình	單獨
Đường sắt phía Tây	西鐵
Loại	有點
Bóng chày	蛜
Than van	廔
Thời gian	时分
đám mây	雲
tránh	避免
sự phong tỏa	封锁
Tham khảo	參閱
Chỉ định	注明
Suo	碹
Sơn	绘
vận chuyển nhẹ	軺
chẩn đoán	診斷
Wan	沨
Thịt	荤
Ngũ triều	五代
Xa Xăm	远处
huy chương đồng	銅牌
Mas	马斯
Ribose	核糖
đi chỗ khác	離開
Hỏa lực	火力
năm mới	新年
Franz	弗朗茨
y tá	媬
Ký gửi	托运
Gozen	御前
Ốc sên	蝸
Yun	惲
Cũng được dịch	又譯
Jinshan	金山
nguyên nhân tử vong	死因
Hệ mặt trời	太陽系
Lâu năm	常年
Xấu hổ	煞
sự bảo vệ	保護
ngân hàng Trung Quốc	中行
Liền kề	邻近
Đá hoa cương	花崗
Panama	巴拿馬
Cẩm Châu	锦州
gặp	會見
nhà tắm công cộng	湢
Sáng	煇
Tiếng Bengal	孟加拉
tốt lành	吉祥
Đớp ruồi	鹟
Hoa anh đào	桜
để mà	為了讓
chia tay	告別
Đạt được	獲取
Fengyun	風雲
Hy sinh	讉
khoảng cách	距
Sảnh lớn	大會堂
mí mắt	睑
Kinh phí	资助
mẹ	妈妈
Vi phạm	侵害
làm hỏng	失修
Qian	銞
sinh học	生物学
Bingchen	丙辰
niêm phong	封
đốt cháy	燎
Đã chạy	苒
Được Quan sát	觀察
Arthur	阿瑟
tìm	谋
đạo Phật	佛教
Hải cảng	口岸
Họ ngôn ngữ	語族
Ngốc nghếch	躂
Đa thức	多項式
Là hai	是兩
Độc quyền	专有
bỏ rơi	拋棄
4 xi lanh thẳng hàng	直列四缸
thờ cúng	礼拜
bọng đái	脬
thông minh	优良
Trong lễ hội	在節
trong mờ	半透明
Hàn Quốc	高丽
Po	鱄
cướp biển	海盜
Tham dự	參賽
Boli	玻里
Xizhen	溪镇
atresia	閉鎖
Normandy	诺曼底
Đã chọn	中選
Konoha	木葉
Yu	俞
Pan	平移
Điều khoản	条文
Với	带有
chuyến thăm	拜访
Thị trường	巿
Khen ngợi	好评
Yong	雍
sưởi	加热
bỏ trốn	遯
Choáng váng	愅
ngày kỷ niệm	周年
Vương miện hoàng tử	皇太子
Shishi	世時
Mười nghìn	萬餘
Giải thưởng	獎項
Minnan	闽南
Sinh con	生子
quán tính	慣性
khả năng lãnh đạo	领导
Jie	磢
sỏi	石
Quận	县境
sự tương thích	相容性
Pong	鄮
kết hôn	婚事
tiếp tục	繼續
Giải thưởng	頒獎
Tìm kiếm	尋找
Đổ	斅
cây búa	罕默
Nam Phi	南非
Dòng nước	水流
Có thể giống nhau	可同
Phong trào thứ tư	五四运动
Se	瀨
Tổng cộng	累计
nông thôn	鄉村
Chang	昶
tiết lộ	吐露
Đêm	朙
Quan thoại	鸅
Colorado	科罗拉多州
Cộng hòa	共和制
Cảm thấy tốt hơn	好转
Si	硩
Wei	闈
Trùng Khánh	重庆
dán	餬
hố	洞
Sâu sắc	深受
Nguồn cung cấp	物資
buổi triển lãm	展览会
Sima	司马
cây mây	菖
Jia	蒭
vết nứt	裂
xà bông	皁
Xúc phạm	甆
Claw Dragon	爪龍
Bướng bỉnh	倐
Hăm dọa	脅
chiến tranh	戰
tình cờ gặp	踬
Con lai	杂交种
mắng mỏ	叱
Tâm sự	姮
Lân lượt tưng ngươi một	陆续
thế tục	世俗
Yong	甬
thời sự buổi tối	晚間新聞
Lu	泸
Sẽ được tổ chức	會舉辦
Cấp làng	村级
Hội tụ	汇合
Nổi dậy	叛变
Gián đoạn	間斷
Ju	翏
Kinh doanh mỹ	美商
Endanger	危及
Quê nhà	故里
trước mặt	阵线
Tanzan	坦桑
độc tính	毒性
Ngăn	厢
mộc mạc	猥
Lai	崃
Muối	鹺
hướng dẫn	導
Lần tới	下次
gì	哈
Ủy ban Thường trực	常委會
giáo phái	宗派
điện từ	电磁
Mã	代碼
Quà tặng	稟
Ling	啇
tìm	寻求
Saxophone	薩克斯
tăng	增加
kỳ hạn	用语
Huỳnh quang	螢光
thèm muốn	觊
Weber	韦伯
Tong	桐
sự độc quyền	專賣
bát	缽
Lớp cá	魚綱
Kết nối	接驳
hành động như	充当
chi tiết	详
Người vợ	之妻
Loại bỏ	消
người chơi	演奏者
Cây cầu đá	石桥
chia sẻ	股
46	四十六
Sẽ thiết lập	會設
He Wen	何文
chủ nghĩa hiện đại	现代主义
vô hạn	无限
lạnh	凛
Gương Quasi	準鏡
Súng ngắn	霰彈
Ave	阿韦
đứng đầu	的頭
ý tưởng	理念
Ăn cắp	贓
chứa đựng	內有
Một lần	旦
Nia	尼亚州
về cơ bản	基本上
tàn lụi	粃
Yên tĩnh	靜
Xây dựng lại	整建
Li	籾
Smash	漍
Balkans	巴尔干
tự kỷ	自閉
Di chuyển thực địa	場舉
Augustus	奥古斯都
gián điệp	特務
Xuân	轩
Thích hợp	徛
Nhạc phim	配乐
Sau Tần	後秦
Christie	克里斯蒂
Và làm theo	並隨
Vòng lặp phía Tây	西環
nếm thử	滋味
Yamate	山手
xấu xí	醜
vải	佈
Ngày 4 tháng 5	五四
xe	馬車
Đánh bại	击溃
San Francisco	三藩
Tát	捿
khoáng sản	礦物
Zhengding	正定
ngực	胸
mỏ lết	鷦
Chuẩn bị	備
Elvia	爾維亞
phi lý	荒謬
quyền lực	騤
Cô đơn	澂
sinh đôi	雙胞胎
Nhiệt độ thấp	低溫
Báo đàn organ	机关报
Chân xanh	蘭足
honeydew	甘露
Giải độc	戒毒
Dòng	台词
cây sơn chi	栀
Đánh nhau	转战
Năm	年限
nửa đêm	半夜
Đôi khi	時有
Nassau	拿骚
Người phiên dịch	翻译家
Rong Zhen	荣臻
đá ngầm	礁
Xe buýt đưa đón	班車
Xúi giục	诱导
thứ hai	次要
Yu	狇
Lesotho	莱索
Giải Người đẹp	美奖
Bắt cóc	拐
Hiện tại	在场
tiêu diệt	殪
Uy Hải	威海
cờ hiệu	旆
Ya	舎
Tạm biệt	再見
hào phóng	大方
Cơ quan nhà nước	国家机关
Li	奝
Bắt đầu phát sóng	啟播
Xe sắt	鐵車
Aleppo	阿勒颇
nguyên chất	純
thụ động	被动
Dài	长期
Lin	麟
cabin	艙
men	酵母
Thủ đô cổ đại	古都
bao lâu	多久
Mở rộng	扩
Quả ô liu	橄欖
Nibble	镃
giết chết	殺害
tháp pháo	炮塔
Triển lãm xe	車展
Hai mươi năm	二十年
nhảy	趯
người Trung Quốc	中方
Cái nào là	者為
cả hai mặt	双方
Bao vây	围攻
âm tiết	音節
Tong	輬
Nhiệm vụ quan trọng	重任
Cúi đầu	頫
Coi như	视作
đồng hóa vào	融入
Zhen	蓁
khiếm khuyết	瑕疵
ni cô	修女
di chuyển	動
Ôn	汶
Tìm kiếm	检索
Ngái ngủ	沉睡
Ngay sau đó	不久後
cáp	电缆
Hạt Lin	林縣
Chạy trốn	出逃
Công thức	制訂
Giải phóng	放生
tờ khai	宣言
Greenland	格陵兰
Ngoại thành	外城
Những năm đầu	早年
Sôi lên	畖
tiếp tục	延续
Số phận	並命
thắng lợi	取胜
Gửi đi	递交
Chú ý đến	注重
dâm bụt	槿
Medaka	鱂
Tỉ lệ	量表
Colombia	哥伦比亚
Đồ dùng	用具
Công nhân	工作者
Nghĩa trang	墓园
Bán	贩卖
cộng đồng	社区
Trở thành	變為
Bay	灣
Nhấp chuột	咔
Wei	洳
Nước Lào	老撾
lữ khách	羇
tham dự	参加
đặt hàng	顺序
gò đất	冢
Chứng thư	事跡
kính thưa	黗
trượt	溜
chòm sao	星座
bán	出卖
Kun	錕
loài	种类
Vince	文斯
Toàn bộ	整部
điều cấm kỵ	讳
Ngư dân	漁民
Yan	焭
Nam Tư	南斯拉夫
Chống lại	迎戰
Gọi là	稱為
Phim và truyền hình	影视
Yongle	永乐
Tỉnh miền nam	南省
Tích cực	陽質
Hoa loa kèn	百合
Và	且
Shan	硁
phần bổ sung	補充
đôi khi	有时
Nhìn thấy	眼看
sự chậm trễ	延迟
Anhydride	酸酐
Tất cả với	皆以
Lớp học	纲
Astral	星体
Đền bù	赔偿
bướng bỉnh	頑
thối rữa	衰變
Giáo lý	主义
Si	繷
nhân	乗
bàn là	熅
Yi	怿
Sẽ cho	會給
Lan tràn	波及
kiểu	活字
Chu	滱
nhào bột	袚
Xi	僖
Hội Sinh viên	學生會
Chiếm lấy	掳
con đường	通路
Xếp hạng giữa	跻
chuyến bay	飛行
biển Đỏ	红海
tất nhiên	當然
canh	翅
Công chiếu	首演
huấn luyện viên	教练
Thắng lợi	勝出
Yong	邧
cung cấp	供給
Tia	蒂亚
bị làm phiền	不安
giàu có	丰富
gián điệp	间谍
Độ chính xác	精密
cà vạt	繯
Hợp tác	合作用
Slovenia	斯洛文尼亞
Giống như	宛如
tất cả	俱
Chống Nhật	抗日
Đoàn xe	車組
Đường giữa	中路
Rap	饒舌
Saint Denis	圣但尼
Tổng chỉ huy	总指挥
đầu máy xe lửa	機車
Dhara	陀罗
Guji	古吉
Bùng binh	迴旋處
Đang chờ đợi	候
Geng	赓
Mới	新興
Quốc gia	國當
chai	樽
Glock	格洛克
gánh nặng	负担
Số dư	盈
bề mặt	面
tối	晚間
chăn cừu	牧羊
bắp chân	犊
chuyến đi	趟
Làm nhục	诿
vấn đề	议题
Granada	格拉纳达
tự lập	自制
Seva	塞瓦
Lưỡng cực	兩極
Gro	格羅
Hành lý	行李
trước mặt	前線
khúc xạ	折射
Rio	里约
Trở thành	轉為
Yili	伊丽
dốc đứng	陡
bất hợp pháp	不法
Khúm núm	匴
Langor	兰莪
thay đổi	變動
Vịnh Bang	州湾
Thành phố bị cấm	故宫
Chủ nghĩa phát xít	法西斯
Tham gia	從事
Trường tiểu học và trung học cơ sở	中小学
Baseman	壘手
Mori	莫里
vô cùng	极其
cáp quang	光纤
Tham gia	接合
Tấn	浟
Phương sách	勝地
Tạp chí truyện tranh	漫畫雜誌
bóng đá	橄榄球
Chôn vùi trong	葬於
Chìa khóa	钥
Sớm muộn	早晚
Chia sẻ	共用
Sự cần thiết	关键
Qian Yuan	乾元
phần	仳
xây dựng	施工
Biết rôi	悉
Francois	弗朗索瓦
Arizona	亞利桑那州
quai bị	痄
Giáo viên	师范
Cạnh bên nhau	并列
Đen	黒
Thang máy	昇機
Lu	渳
huấn luyện viên	教練
Su Yu	粟裕
geld	骟
Axit formic	甲酸
Địa điểm	址
nhóm máu	血型
phương pháp	办法
Sau cú đánh	擊後
Soo	炱
Crack	破解
từ trên trời rơi xuống	隕
vịnh	海湾
Chồi	苞
Rực rỡ	絢
Không thể nào	不可或
dự án	項目
Huyền Trang	玄奘
đúng	右边
học kỳ	学期
Bối rối	惑
xích mích	擦音
Shao	劭
Tuva	图瓦
quyền lãnh đạo	霸权
lúa mạch	麰
Châu Âu	個歐
Sự bảo vệ	防护
thường xuyên	時常
vòng	環線
ngôi sao	恒星
đồng phục	制服
ngày qua ngày	天天
Tàu	艦隻
Tang	軮
người vợ	妻子
thông qua	經由
Fuchu	府中
buồn cười	滑稽
镆	鏌
Phình to	脹
Huh	寔
Bảo vệ	卫队
Sai	诬
Li	衠
Một nhóm	一組
Weibo	微博
Nước đi này	此舉
Shia	什叶派
Giá trị	取值
Adze	锛
Hawaii	夏威夷
Andre	安德烈
Cao hơn	較高
Nhà hàng	食肆
Trường hợp này	本案
Wa	佤
Zhu	楙
Amidine	脒
mặt trời	太陽
An Sơn	鞍山
Manu	曼努
Đặt	置于
đốt cháy	燒
Tập trung vào	侧重
Giáo viên	师长
Lên	上行
Độc hại	恶意
kỳ nhông	鯢
Chỉ huy	司令员
Hanlin	翰林
Dân chủ hóa	民主化
Nhưng không	但沒
Theo tỷ lệ	正比
tổng thể	总体
Rattus	鼠屬
Cá nóc	魨
theo dõi	軌道
Kín đáo	预留
Tương lai	將來
Song ngữ	双语
Mặt tiền	立面
Tia	提亚
Âm lượng	巻
liên quan	憂慮
Thành phố	轄市
Tập hợp	重奏
Liao	廖
Ula	烏拉
màn	罳
Grantham	葛量洪
Mét	計
Với hai	與兩
sủa	吠
Anh trai	阿哥
Nhiều phe phái	各派
Sơn	漆
Thiết lập	兴办
dữ liệu lịch sử	史料
Alan Tam	譚詠麟
sự chỉ rõ	規格
Tian	恬
lỗ hổng	间隙
Giữ	保住
cây nho	蔓
halogen	滷
Đàn áp	镇压
ngân hàng	銀行
Khu vực hành chính	行政区域
đi cùng	随同
Trang thiết bị	設備
Maroc	摩洛哥
khởi đầu	啓
Thất vọng	浈
Wei	玮
chất đạm	朊
bao	橐
thác nước	瀑
thân nhiệt	體溫
Mẹ của nó	其母
Sơn	凃
Vậy thì nói đi	則說
hình cầu	球形
con hàu	蠔
Đi ngang qua	路过
Gordon	戈登
Đội	队伍
Sejo	世祖
Wu	蕪
Nhanh	叀
lưu lượng	流动
Min	旻
bão	飓风
sự đối xử	待遇
con cóc	黽
rừng cây	林地
rất dài	很長
Sở thích	偏好
Gạo nếp	榤
Con quỷ	妖
Cyprinidae	鯉科
sân chơi	操場
Con rắn	蜒
Rica	黎加
cởi	起飛
riêng	具體
Tang	蔸
Nankai	南开
Thất vọng	挫
Wyo	怀俄
Yang Ming	阳明
Thị trấn	镇上
Tính hai mặt	对偶
Người đồng tổ chức	協辦
Montana	蒙大拿州
Âm	墛
Xuyên tâm	桡
lệnh cấm	取締
Stan	茨坦
cái hộp	盒子
Khu công nghiệp	工業區
đối diện	對稱
Đại học Lĩnh Nam	嶺南大學
kiểm tra	查
Lutetium	镥
ga tàu	檯
táo	苹果
Một	一個
Hay không	與否
Đại học Phúc Đán	复旦大学
thị trấn	鄉
ZTE	中興
Phong	冯
trên công trường	現場
Móng ngựa	鸎
Rio	里約
Xung quanh thành phố	环城
Dương	埞
囵	囵
Spartan	斯巴达
Yan	僄
Tinh tế	精緻
Castellation	栞
Brazil	巴西
sàn nhà	樓層
Sau khi kết hôn	婚后
Hộ tống	保送
Maddie	麥迪
Mét vuông	平米
hợp pháp	法律
Cái cổ	内克
thù lao	报酬
Phát xít	納粹
Tham gia vào	參演
Địa điểm	置入
Sẽ hiển thị	會顯
Bãi bỏ	廃
Soo	洙
trở về	退回
Oss	奧斯
Truyền hình vệ tinh	衛視
Khướu	鹛
Kai	恺
tái phát	復發
Trong bàn	表中
tiêu	花費
Đã đánh giá	评为
Bất lợi	缺點
điện trường	电场
Wuhu	芜湖
vùng đất thấp	低地
Zhongyuan	中元
Lời nhắc nhở	鰏
Số người	人數
Tal	塔爾
cây kê	蘼
Hướng bắc	北上
Khu kinh doanh	商业区
Araneus	蛛属
Không liên quan	無關
Zhu	篰
chỉ	演出
Dòng điện xoay chiều	交流電
chi phí	开支
lợi nhuận	利潤
Nhận được	収
Neutrino	中微子
rửa tay	洗手
giao tiếp với	交流
Bài hát mạnh mẽ	勁歌
buổi hòa nhạc	演唱會
Tát	肧
Trong hình	图中
Chính xác	矫
thỏi	锭
Sữa	牛奶
vai	肩膀
tước đoạt	剝奪
Shengzhi	生智
đếm	伯爵
ít nhất	最少
người Trung Quốc	中文
Không sợ	不怕
sự tôn trọng	尊敬
A	岀
Valerian	缬
Di	棳
Đặc biệt	特種
xây dựng	修筑
Sheji	社稷
tiêu đề	錦標
Hakka	客家
bắc Carolina	北卡
Tôn trọng như	尊為
Shao	晀
Mồm	茅斯
Lỗ rò	瘻
Hoang vu	荒廢
Tâm sự	赬
Tổ chức lại	重组
Clo	克洛
Tráng	包覆
nói	講
vốn có	固有
Một đám đông	一眾
đánh lửa	点火
Li Guo	李國
Giáo sư	囧
Tongmenghui	同盟会
an ninh công cộng	公安
Hệ thống đơn vị	单位制
Phổ biến	流行性
Hoàng thượng	陛下
Giết chết	打死
alkyl	烷基
Được nhúng	嵌入式
trùng hợp	重合
radian	弧度
Cao răng	鞑
Phần	节
xa hoa	奓
Đồng thời	並舉
Phân chia và chinh phục	分治
Trên cây	树上
Con gà trống	胉
Cây rơm	疊
Theo này	據這
Đông Hưng	东兴
chất xúc tác	催化剂
Ardèche	阿尔代什省
Anh ta	訸
Bún	昤
đổi	兑换
cùng với	随着
Xizhou	西州
cả hai	二者
đây là	這是
Trăm	第一百
lời hứa	诺
Nick	昵
Vải trong	佈於
Quận tự trị	自治县
Nhỏ bé	蒂尼
đàn piano	鋼琴
năng động	動態
Chăn nuôi gia súc	畜牧
tỉnh Tứ Xuyên	四川省
tang lễ	殯
Tẩy	去除
Nghiên cứu	研究会
Luân xa	查克拉
Davis	戴維斯
Xe buýt thành phố	城巴
Ngọn lửa đang hoành hành	烈火
vẽ tranh	吸取
Quái thú	野獸
Qiang	锵
Quinoa	藜
Tiết tấu	搏
Đồng hành	偕
thuổng	鏵
Giám sát	监视
Mười nghìn	一万
Lấy lại	重拾
Lực lượng thân thiện	友軍
Giỏi về	善於
Nhà thiết kế	設計師
Yu	嶼
Dòng đông	東線
thứ tám	第八
tử thi	尸
mặc dù	儘管
Kansas	堪薩斯州
Trong tương lai	日後
Bảng đen	籃板
Mingdao	明道
Li	鱏
Đôi nam nữ	混双
Sẽ	维尔
miễn cưỡng	勉强
gặpZhenchang	见面貞昌
Hoặc hơn	或多
bảo vệ	守卫
Xuân	煹
Jordan	約旦
Moza	莫扎
gian hàng	亭
con trai cả	长子
Im lặng	沉默
Chúa phù hộ	天佑
chim ưng	鹰
con ong	蜜蜂
Kết án	刑期
Tiết lộ	披露
Y	湌
Hợp đồng đầy đủ	約滿
đấu tranh	斗争
kiểm tra	試驗
Khung	诬陷
xem xét	慮
khẩn cấp	迫切
khấu trừ	扣除
bản đồ	地圖
ban cho	貺
Nhân bản	人化
Ena	埃纳
Michigan	密西根州
Trò chơi ngôi sao	明星賽
Biên giới	国境
đồi núi	丘陵
Mani	摩尼
tế bào máu	血球
Oslo	奥斯陆
Đường sắt Đài Loan	台鐵
bản mẫu	模板
Xiêm	暹罗
Bướng bỉnh	諩
Thứ mười lăm	十五日
Diacid	二酸
Mô hình	機種
Bướng bỉnh	倜
xin chào	啰
sự phá hủy	毁坏
Dự kiến ​​lúc	預計於
vàng	金
Pháo kích	炮击
Bản in đẹp	小字
hàng	线路
Phòng thể dục	健身房
con lăn đá	碡
một nhóm	一隊
Nhà máy điện	電廠
viễn thông	電信
Sihanoukville	西哈努克
Cơm	莱斯
Shan	騞
Đài Bắc MRT	台北捷運
Hoa loa kèn	蘺
dãy núi cao	屴
người lạ	陌生人
Tàn phá	仚
bong bóng	泡
hình ảnh	圖片
Atlanta	亚特兰大
cửa	大门
Toei	東映
Macro	宏观
Sau khi mở	開後
Zhi	枿
nhạc cụ	篌
sự tôn trọng	尊重
kết thúc	末日
Xuanyuan	軒轅
Sulfhydryl	巰
Từ chức	辭
Thứ hai	次級
Gou	覯
bột trắng	白粉
đầu đạn	弹头
Thong	铻
Người sáng lập	方正
Di tích lịch sử	古蹟
xấu hổ	尬
judo	柔道
Lianba	連霸
Omar	奧馬
Joe	乔
Một	一隻
Băng	颠
Nghi can	嫌疑犯
hư hại	损伤
Đớp ruồi	鹻
Thong	鋙
Cáo phó	箣
Yun	筼
Đôn Hoàng	敦煌
Du lịch	出行
nhà tài trợ	贊助
vào ngày Chủ nhật	星期日
Sự sống còn	残存
Bạn Xikun	游錫堃
đau khổ	挨
Mọi người sẽ	人會
Lễ hội đặc biệt	特別節
Tạo nên	創
Tski	茨基
Sinh viên đại học	大學生
tên nick	昵称
Qua một bên	一旁
thanh lọc	禊
Nâng lên	升空
Diêm Thành	盐城
dốc đứng	沤
tây nam	西南方
Nút bầu cử	選舉結
Pyrene	比利牛
Shan Yu	单于
Công	硙
chế độ độc tài	独裁
Qi	朒
Sau khi chết	亡後
Viper	蝰
xin vui lòng	請
Vắt kiệt	揟
Hàng tồn kho	藏量
En	恩省
Chết	逝世
Phía sau	后面
Điều này	这
Độ ẩm	墒
Dừng lại	闌
Loại trên	上型
Núi	山脉
giá vé	票价
Tiếp tục	不断
Quy tắc nhóm	隊則
Wu Yue	吴越
Taizhou	台州
độ cao	高空
Bảo vệ môi trương	环保
Zhi	栁
người cầu nguyện	祈禱
quang phổ	光譜
đảo	岛屿
Bungalow	洋房
Cần phải	須為
Tre vàng	黃竹
chiến tranh	战
Internet	網際網
bè tre	簰
samarium	钐
lượt xem	看法
nhân vật	身材
Chúng tôi và	們與
Dijon	第戎
Cộng hòa	共和
Mudanjiang	牡丹江
Sữa mẹ	母乳
Peng	彭
Liss	利斯
Hoa và cây	花木
mùa hè	夏
Giá cả	造价
Sản xuất	產
Gửi đến	送至
nhà vua	大王
cũng	偶数
Kiện tụng	訟
Miền Tây mới	新西
sắc đẹp, vẻ đẹp	美女
buồng	橱
Deng Hui	登輝
Dahan	大韩
Nepal	尼泊
Dấu	暗示
Thành phố Gia Nghĩa	嘉義市
chính thức	官
Hương vị	味料
Khó xử	阂
Urum	乌鲁木
Ngắt lời	闖入
Dennis	丹尼士
Fergie	弗吉
Hơn	較
Loại trừ	剔除
tiền vay	貸款
Chung	軍將
đan lông mày	嚬
Âm	慇
Tháng sáu	駿
Liu	鲬
Kashgar	喀什
củng cố	加强
Yên tâm	安心
Tp.	市內
Nói dối	譾
Mở cửa cho giao thông	通车
Phá vỡ	擊破
Người theo chủ nghĩa riêng biệt	割據
ở lại	住宿
bươc	步骤
Bằng gỗ	木质
Thân xe	車體
Tai Wei	太尉
Pingtung County	屏東縣
Thiên nga	艨
mục tiêu	客觀
bằng sáng chế	專利
Đại học Tứ Xuyên	四川大学
Kinh kịch	京剧
Luân	鵾
hậu tố	词尾
con linh dương	羚羊
Bạch tuộc	八達通
chủ tịch	社長
Hà nội	河内
Đứng trên	立足
A	個
Jiang Lu	江路
Chủ nhà	地主
ý kiến	見解
Cố vấn	怂
nói dối	謊
hữu nghị	友谊
Tỉnh Miyagi	宮城縣
Kỳ quặc	奥德
Thừa kế	承襲
Thông lượng	吞吐量
Lan tràn	傳播
khủng long	恐龙
nhiệm vụ	責
nứt	皴
Thương gia	招商
Goa	果阿
Dọa nạt	倿
làng	邨
thường xuyên	常
Bị	遭到
Tổng hợp từ	編自
Xi	奲
nâng cao	募
Mo	酩
Bo	勃
Cá tráp biển	鯛
thanh kiếm	劍
Bao vây	鎶
Turku	土库
dấu	馬克
sau đó	而后
Tim	蒂姆
tập trung vào	專注於
Vũ Hán	武漢
Cảnh giác	惕
Cho ăn	馈
Con dao cạo	蛏
khiển trách	怨
Yếu	不力
Phương sách cuối cùng	不得已
Đẹp	蒩
Si	埒
Aya	滫
Đây	這裏
Chuyên gia	专科
cướp	剽
La mắng	譸
thẩm phán	評判
Kinh dị trắng	白色恐怖
Trong một thời gian	一时
Biểu mô	上皮
Miền nam	偏南
ngăn kéo	屉
Làm	制作
liên hiệp	工會
Giải Mỹ mở rộng	美網
Cảnh báo bão	颱風警報
hộp trục	轴箱
Một phiên	一屆
Treo	鴻
Lu	呂
Lap	拉普
nhân dân tệ	元
góc	角落
chơi	戲
Ming Yingzong	明英宗
Vasily	瓦西里
Thủy lực	液压
tự phát	自发
Jiro	次郎
ma thuật	魔
đóng cửa	關門
Không gian	空格
Điều hành một đất nước	辦國
Manca	曼卡
Shilin	士林
Giáo dục đạo đức	德育
Porto	波尔图
giữ	持
Bảo vệ thành phố	守城
Dego	戴高
Ô	胞
Yang Qian	楊千
Tiếng Mã Lai	马来语
Tara	塔拉
Tháng hai	二月
Ngành điện ảnh	影业
Mua	買下
thị trường	市场
Tường	墙
Rất	甚為
quá trình	過程
Tùy tùng	隨從
Hum	唚
Zhu	譶
Thứ bảy	七世
Khói	烟
Ghi chú	注
quả quyết	断言
hơi nước	瀣
Yi	佴
Quận Hồ	湖區
Chân	腿
Nhậm chức	上任
Bộ nhà ở	房屋署
bà ngoại	奶奶
Thông đồng	勾结
ghi lại	錄
Thân hình	车身
chèn	插入
Nhà có thể	家可
Thời gian của đội	隊時
Đặt dưới	划归
phát sinh	衍生
Yan	鄢
Kết nối	連線
trò chuyện	交談
Lòng tin	讬
Cả hai	两者
men	琺
Hàng ngàn ngôi sao	萬千星輝
bố	爸爸
thời tiết	天氣
Hoàn thành	實現
nếu	的話
dần dần	渐渐
hết giờ	暂停
bố già	教父
Cote d'Ivoire	科特迪瓦
hiệu sách	書店
thay đổi	变动
Giám đốc	署長
nhung	羢
Ngắt lời	打入
Thành phố Tây	城西
Cá hồi	鱒
Sự bắt buộc	征军
Yi	轀
Râu	蠂
ngay	隨即
Praha	布拉格
Vị trí chính thức	官職
Quân miền bắc	北軍
Pseudo	贋
Hông	髖
Hoa Kỳ	美國
Điều cấm kỵ	禁忌
Mian	渑
Tiên phong	前卫
Li	靂
Khuyến khích	推展
nhà vật lý	物理学家
Sáng	燦
sơ bộ	初步
Mỹ La-tinh	拉美
Trung Hoa Dân Quốc	民国
Nano	纳米
Hồ nước ngọt	淡水湖
Kế tiếp	下位
vị trí	地点
Tây An	隞
Tham khảo ý kiến	諮
Tây tạng	西藏
trong thực tế	其实
Cao đẳng nông nghiệp	农学院
Xô	寶可
Ren	覚
Bắn	拍摄
Pov	波夫
Kim Môn	金门
Quito	基多
Phòng thủ biên giới	边防
trận chung kết	决赛
Nhân dân tệ	沅
Loài đặc hữu	特有種
Nur	努爾
Lý do	理
Người phương tây	西方人
Willer	维勒
nói chuyện	議論
Chảy xệ	下垂
giật gân	濺
Tiện lợi	便捷
người Trung Quốc	华文
củng cố	强化
Zhi	贄
Shao	枏
Ya	鐆
Mười triệu	千万
Đài kỷ niệm	紀念館
hydro	氫
lái xe	驾驶
Sự tăng tốc	加速度
động mạch	動脈
Công thức hóa học	化学式
Ruột	胆
Khác	别的
vỏ sò	壳
du ngoạn	遨
tươi	新鮮
Yu Guo	於國
cây	廠
Khóa	鋂
Được	擬
Vịnh Trường Sa	長沙灣
nuốt	吞
Yi	沂
Mái vòm	穹
đất liền	大陸
tấm màn	帏
vùng biển	海区
trái	左边
Phượng Hoàng	凰
người tổ chức	组织者
Dài	蘢
Chiến tranh trên bộ	陆战
Xếp hạng	评级
Gus	古斯
Thêm	有加
Nhân dân tệ	袁
Nguy cơ tuyệt chủng	濒危
nhạc sĩ	音樂家
Ningshi	宁市
nhưng	但是
Lennon	列侬
Song Huizong	宋徽宗
Sasuke	佐助
Nhân tế bào	原子核
Xin	炘
Tuyến phòng thủ	防线
Là đúng	為真
Penghu	澎湖
Cá mèo	鯰
Tang	赅
Tên	名稱
Tập hợp con	子集
Mino	美濃
Terry	特里
Tàn tích	遗址
tham	贪
Chịu đựng đồng thời	並擔
hình chiếu	投影
Shi	湉
Sẽ y	维利
xeri	铈
trận đấu	匹
Chỗ	插槽
axit sunfuric	鏹
Nhà máy điện	电厂
Calvado	卡尔瓦多
Nhân cách	人格
Chứng thực	代言
Alami	阿拉米
Đầu tiên	一來
Kinh hãi	悚
Quy tắc quân sự	軍則
Robin	羅賓
giám mục	主教
Nâng cao	增强
Shogakukan	小學館
Boca	博卡
Tái sinh	更生
Stani	斯坦尼
Winge	溫哥
giun đường ruột	螅
Khitan	契丹
hỏi	询问
Thế giới mới	新世界
Yamanashi	山梨
dịch bệnh	癥
Khuyến mại	晋级
rẻ	廉价
câu đối	對聯
tránh	迴避
Petz	匹兹
được thành lập ở	成立於
Âm	牗
Norman	诺曼
cây cung	躬
Lươn rắn	蛇鰻
Sớm	初期
sự thật	真情
cá chép	鯉魚
tê liệt	瘫痪
người bán rong	行商
Matthew	马修
hạt	郡
Hạt Nantou	南投縣
Bún	麺
Tìm kiếm	搜查
tiền tệ	币
Tàu	舰艇
Hơn	較多
Thay đổi để	改作
Bữa tiệc xanh	綠黨
Georgia	格鲁吉亚
vây	鳍
Giải một	甲联赛
Zhi	欥
màu xanh lá	綠
Hảo	灁
đa dạng	诸
kiềm chế	覊
Đôi chân	腳類
Darius	大流士
giàu có	盛产
Hệ thống	的製
cây rơm	岭
Tỉnh	省部级
cây rơm	垄
Sulfone	砜
Bang đang chiến tranh	战国
Trương Gia	张家
chỉ có	纔
Thiết bị tốc độ	速器
Đi ra ngoài	外出
Sáu trăm	六百
Đến	迿
Baja	巴哈
bãi đậu xe	停车场
Rong	穾
chủ quyền	主權
nhân chứng	見證
điều khiển	管制
Phòng ban	署
thành nội	禦
vồ lấy	攫
tỉnh Phúc Kiến	福建省
người Anh	英屬
Netizen	网民
Dòng chảy ngược	回流
mồm	嘴
Bắn	射
Tang	朖
Bai Juyi	白居易
Sứ mệnh	宣教
hiện hành	現時
Lịch chính thức	歷官
Wagtail	鹡
Thích Ca	释迦
Chengbei	城北
Sâu răng	齲
Bó	外滩
Ngoại thất	外观
Ming Chengzu	明成祖
Hai	們兩
lộ trình	路线
Màu thật	本色
Trang Chủ	居
màu vàng	黃色
Cho thế giới	為界
aka	或称
Nguyên tử oxy	氧原子
mạch đập	脉
Người giàu	富人
Manchester	曼彻斯特
Vẫn	仍舊
Thiệu Hưng	紹興
Yi	黟
huy chương bạc	银牌
Quán ba	槓
cao chót vót	聳
mũi tàu	艫
Bura	伯拉
thần tượng	偶像
Vương miện	冕
Lãnh đạo quân đội	率軍
Tù nhân	虜
Phân tích cú pháp	解析
thần thoại Hy Lạp	希臘神話
Tất cả các loại	各式
trạm biến áp	分站
Lamy	拉米
Jianlian	建聯
Liechtenstein	列支敦士登
đắt	昂贵
Jing	璟
Enshrine	奉祀
bạch cầu	白血球
chùa nhỏ	萻
Thất vọng	湞
hành lang	走廊
Admonish	箴
Hải quân	金鐘
Hong Xiuquan	洪秀全
Phần Lan	芬蘭
Năm	年间
Xiangdao	翔道
Âm	甀
trang điểm	補償
Tăng lên	崛起
sự thù ghét	仇
lợi ích	好处
sức chứa	容量
khi nào	當
Toàn quân	全军
Rủi ro	冒
Syria	叙利亚
nhiệt tâm	熱心
Lan	瀾
xác nhận	確認
vua nước Anh	英王
Giun đũa	蚘
Sống lâu	万岁
Chữ ký	签名
Dongguan	東莞
Đất sét	黏土
Hòn đảo xa xôi	離島
Mọi điều	万物
骍	騂
Cũng thế	亦為
Đông tới	东至
Sanda	山達
Đã không	並沒
Câu lạc bộ	球會
Đế chế Áo-Hung	奥匈帝国
Khu vực thành phố	市域
nhà ở	府
kế hoạch	计划
khó khăn	难以
Công lý của hòa bình	太平紳士
Lịch sử nhà Thanh	清史
nhũ hoa	脯
Yan	慱
Rokko	六甲
nghèo	贫困
Khu vực	區
Sơ hở	漏洞
Trường công	公学
Tụ họp	聚集
Truyên thông	傳統
Cứu trợ	救濟
Đánh bắt cá	捕鱼
kết tinh	结晶
siêu hình học	形而上学
Liên hoan truyền hình	電視節
Liege	列日
quả mơ	杏
nhiệt	热
Pei	沛
Nó là	它於
Outreach	外传
Sass	薩斯
Hai năm	兩年
biện hộ	崇尚
hổ thẹn	慚
dịp tốt	機會
Pha lê	晶體
Đúng	是
Ví dụ	比如说
Anna	亚那
khá	相当
Vui lên	啋
Hoa loa kèn	蓠
phiên bản tiếng Anh	英文版
luân phiên	交替
Ăn cướp	刦
Thời kỳ quản trị	治時期
trộm cắp	俠盜獵
Công việc	婚外情
阌	閿
viết	書寫
Bhutan	不丹
Chương châu	漳州
Đúng	有權
bản làng	山村
ghi chép lịch sử	史籍
thường xuyên	頻繁
nấm	蕈
Người lớn	成蟲
bếp trưởng	廚師
Tham gia	加入
Gây quỹ	籌款
vấn đề	发出
tiêu cực	负
Bắt đầu xây dựng	始建
con công	孔雀
có thai	怀
Cùng năm cuối	同年底
Lộn nhào	檦
Góp phần	出力
Được khen là	誉为
do dự	躇
hàng không dân dụng	民航
Thời gian bận rộn	繁忙時間
trò chơi Olympic	奥运会
Mainz	美因茨
Thân cây	象鼻
Túi vải	布袋
người cầu nguyện	祷告
đều đặn	正規
hút	嘬
giải phẫu học	解剖學
Chúa tể	洛德
Bustard	鴇
Mỏ than	煤礦
Thuộc về lý thuyết	学术
Qiaotou	桥头
Món ăn	餔
Shao	奼
vui mừng	幸福
tiếp tục	延續
Bọn trẻ	儿女
Thị trấn	乡县
Trẻ	颺
tiêu dùng	消费
Linghu	令狐
Lou	蔞
Trang Chủ	本家
Ký ức	存储器
Tri giác	感性
Thơm	香
Xương sống	中堅
màu vàng	黄
Những bông hoa	花草
Turku	土庫
Nhiều hơn	餘
Đại số học	代數
hỗ trợ	協助
Kaji	化二
Thượng hải	滬
Xung quanh	绕
trại	营
thuộc kinh tế	經濟
Hydrat	水合物
nỗi sợ	懼
chụp	射击
Hướng đạo sinh	童軍
bảo vệ	卫
Tiểu bang	州立
Rawai	拉威
Sân bay Kai Tak	啟德機場
Khuôn mặt	面临
Phổ biến	熱門
Musashi	武藏
Toàn thời gian	专任
Đầu vào	摄入
thorium	钍
Đảo xanh	青洲
Truyền lại	傳世
Nam giới	陽系
Trả	繳納
Không được	不得
Gucheng	故城
tháp pháo	砲塔
Quảng Lăng	广陵
trôi dạt	漂
Lần thứ hai	二次
quần áo	衣
Hoàng đế	帝
Chiều cao	高度
Jing	婧
Tấn	訹
Ge	圪
Anjo	安条
phi hành đoàn	船員
bình yên	安宁
Hội đồng chính phủ	政务院
Chỉ huy	司令官
Liên tỉnh	城际
Người chơi	玩家
Thép	鋼鐵
thứ năm	第五
Ngừng	停办
Robert	罗贝尔
liên Xô	苏俄
Hảo	皓
hồ muối	盐湖
uy tín	声誉
quen với	狃
Lớp học đặc biệt	特等
Lin Dan	林丹
Toyama	富山
Tên đường	路名
Mét	計程
sức ép	压力
mòng biển	鸥
lái xe	驾车
Zhao Gong	昭公
chức năng	機能
Ah	阿赫
tháng Ba	行軍
kè	隄
Bremen	不来梅
Thái cực	台基
dễ thương	睆
Tài giỏi	巧
dụng cụ	器械
Cải tiến	改進
Buồn phiền	娈
Bộ phận quốc gia	國師
miền Nam	南方
tim	心
cây lau	簧
Đi sâu	深入
dễ dàng	便于
Giàu có	豊
Chuẩn bị	整備
Punjab	旁遮普
Đường nhánh	支线
nước bóng	光泽
Địa chỉ trường học	校址
Yo	妑
cẩn thận	嫈
Ra mắt	处女作
thúc giục	趱
Tamura	田村
Dương vật	阴茎
phát triển	發育
ngoài trời	户外
Làm hết sức mình đi	竭力
Ni	妮
Dược phẩm	製藥
Sông Nile	尼罗河
Pseudo	僞
Xuất khẩu	外銷
Xu	溆
đấu vật	摔角
Đọc	念
John	約翰
Jing	旌
Mellon	梅隆
Gặp	會師
nước miếng	涎
Bạn	祢
chó	狗
Tát	瞉
Âm	瀀
Krakow	克州
Được áp dụng	适用
có thể	能
Bắt nạt	欺凌
Phòng ngừa	預防
Ẩm	墈
Bida	撞球
Chắc chắn	确定性
Trong khuôn viên trường	校內
tuổi	岁
Không	編號為
bom	弹
Máy bay trực thăng	直升机
lo	憂
Không nhìn thấy	未見
Nghèo	穷人
tiền tệ	通货
ô	细胞
Khối	阻擋
leo	爬
Sao Paulo	圣保罗
Khu nam	南区
Rừng mưa	雨林
Châu Á	細亞
cảm xúc	情感
miền tây nước Úc	西澳
Kết quả là	果是
khách hàng	客
cảnh giác	戒備
Hu	坬
Ye	棬
sự can thiệp	干扰
trường hợp	案情
Thái hậu	皇太后
Huwei	虎尾
Lễ	仪式
Lai	徠
Qi	灂
gốc	由來
Mọi người	人則
rạp hát	剧场
tốt	水井
Renwing	蛉
Tây An	騑
cái cổ	頸
Nguyên nhân và	因與
Tellurium	碲
Giải thưởng văn học	文学奖
Anh Long	贺龙
Wiener	維納
Làm đi	做到
vấn đề	議題
loạng choạng	交错
Sinh vật phù du	浮游生物
Sui	莙
Mong	霍普
Xe buýt máy lạnh	空調巴士
cán bộ	幹部
Nho giáo	儒学
Nắm lấy	抓住
con ma	幽靈
Đoàn thanh niên cộng sản	共青团
Đài Loan quốc gia	國立臺
Lai	徕
Cánh cổng	柵
Sở hữu	自家
襕	襕
Vấn đề	簽發
Sauropods	蜥腳
Kobe	科比
cây sồi	槲
Xi	滍
họp báo	記者會
mắt	陼
Đỏ	黕
Châu Kiệt Luân	周杰倫
World Series	世界大賽
Âm	礇
Nét chữ	字型
Đặc biệt này	這張專
Cao răng	鞑靼
Lỗi thời	過時
trọng tài	裁判员
Thay đổi	改任
Máy bay vận tải	運輸機
Hai	两
trận đấu	球賽
Mang	邙
dư thừa	冗
xì hơi	癟
nắm tay	拳
Khóa	绺
khẩn cấp	紧急
Chú	舅父
Người Baodian	宝殿
Đến	遹
Sử dụng	動用
bảo vệ	衞
Hạt Chiayi	嘉義縣
bàn đạp	踏板
bóng chày	蟋
Shu	扽
Pháp luật	法學
Việt Nam	越國
không được phép	擅自
tầm quan trọng	重要性
Khối u	肿瘤
Đến	迼
Cái thước	治帝
Wang Dun	王敦
tăng lên	上升
Linjiang	临江
con quạ	鸦
dân quân	民兵
Làm lại	重製
giống	同类
bị thương	負傷
Đóng quân	駐守
lấy mẫu	取樣
Yu	訄
Thành phố biển	海市
Đã từng	曾於
Tianyuan	天元
cơ quan	组织
nhím	蝟
Mờ nhạt	毖
Hươu nai	狍
tám	捌
Nắm quyền	掌權
Dadaocheng	大稻埕
chỉnh hình	骨科
Đảng chính trị	政党
Giả mạo	偽造
MiG	米格
Mang	挎
Pennsylvania	賓夕法尼亞州
Mùa	季
Theo	循
Đánh mạnh	重創
cao	頎
Wei	闱
cây	栽
thời gian ngắn	短期
Ham mê	热衷
trông nom	覷
Giáo dục văn hóa	文化教育
Naan	馕
tà ác	邪惡
Antioch	安条克
đội tuyển quốc gia	国家队
Gạo nếp	糍
Nhóm	所組
phong cảnh	山水
Mazda	馬自達
Cổng thông tin	門戶
Lũ lụt	汏
Phía trong	内
Giới thiệu	簡介
Dong	峒
Thành phố Ningbo	宁波市
Và	而該
cách phát âm	讀音
Tuy nhiên	然而
bị bỏ rơi	棄
Li	椝
cắt cỏ	芟
thai kỳ	懷孕
Thực tập sinh	見習
khu	地带
Mở rộng	延
rồng	虬
Jie	筴
Ya	椏
Hoàng tử	公卿
Quét	橫掃
Thổi	擤
ngay tức khắc	即时
Asano	朝野
cho	爲
Vô vi	賢
Xây dựng	楼房
Qian	倩
biên giới	陲
Monaco	摩纳哥
Trực tuyến	線上
Như chủ đề	為題
Guodong	國東
Lời thú tội	告白
giới hạn	極限
Ít	小小的
Vẽ lên	拟定
có	有着
Cá hồi	鲑
sưởi	加熱
sư tử	趞
Đường dây chuyên dụng	專線
Đang chạy	运转
Ali	阿里
nhà trọ	旅館
đũa	筷
em gái	嬃
chơi	玩
Zuo Zongtang	左宗棠
Sức ép	圧
điều đáng nói là	值得一提的是
Yu	迏
Đặt hàng	訂
Dễ dàng	輕鬆
Tin	鋝
Hanno	汉诺
thực thể	实体
Zan	瓚
Cổ hủ	老式
chèo thuyền	桨
Bằng tiếng mẹ đẻ	母語
Lên đến	多達
Nhà thờ địa phương	地方教会
Anh ấy có thể	他會
Hoàng hôn	曛
Gần với	紧邻
Tỉnh Okinawa	沖繩縣
đi văng	榻
Không chiến	空戰
Cầu xin	碑亭
Hợp lưu	匯流
Phi	投擲
Nhón	洎
Từ ngữ	之言
cái nĩa	岔
kinh doanh	業務
Hàng xóm	為鄰
vật được giữ bởi vũ công	帗
đi học	上學
Nàng tiên	仙子
lợi ích	效益
Tỷ	億元
món thịt hầm	燉
Phụ nữ có thai	孕婦
sự cuồng tín	狂熱
Tàn tật	瘵
Trạm Giang	湛江
Hayes	海斯
Dung dịch nước	水溶液
tủ lạnh	冰箱
Kỹ thuật	技法
chủ đề	主題
đưa cho	給予
Hu Shi	胡適
Ngôn ngữ Minnan	閩南語
Đang chuyển động	运动中
hòa hợp	和声
Đầy	十足
Nhiêu bác sĩ	医生
Ủy ban	務委
tiền boa	梢
Pháp	正法
Yufu	由布
Thắng lợi	奪冠
Thân hình	机体
Nhiệm vụ	奎斯特
Tang lễ	殯儀
Lái xe	驶
Liuli	琉璃
Fen	葝
con quạ	克羅
Lượng lớn	巨额
Mora	摩拉
Lang	蒗
Đi qua	横贯
đi tham quan	觀光
Trung tính	中立
cỏ	荛
đột ngột	蓦
Bình thường	尋常
Bạn	宥
Hát	螬
Nea	內亞
Binh thương	休閒
Căng ra	抇
sầu muộn	懣
phía sau	背后
Tiền thân	先河
hải quân Hoa Kỳ	美國海軍
Mảnh thiên thạch	隕石
Phụ trợ	輔政
mắng mỏ	詰
Yên tĩnh	砉
mẫu vật	标本
nhà giam	入獄
Răng nanh	坊
phân phối	分布式
Cũng sẽ	還將
Đánh nhau	抗爭
Răng nanh	邡
Rút tiền	撤军
Guozijian	国子监
năm mươi bốn	五十四
cháu trai	甥
Ân xá	特赦
cảm thấy	毡
Bắt buộc	強制
Đáp ứng	應商
Nhàm chán	鏜
ủ	醖
Năm ngoái	末年
Đến	降臨
nhà chế tạo	制造商
Không gian vũ trụ	宇航
Scandinavian	斯堪的
nghề nghiệp	專業
Sáu nghìn	六千
Quản gia	巴特勒
tấn	色调
Chắc chắn	确性
Có thể biết	可知
toàn bộ	囫
Nhập cảnh và xuất cảnh	出入境
hứa hẹn	有為
với họ	與他們
Xuyên qua	貫通
Nghiệp	噶
Hỗ trợ	辅助
Iran	伊朗
Ba màu đỏ	红三
Hồ bơi	游泳池
Đứng	站立
Hà Bắc	河北
Làng	村镇
Một phần của	一部分
snack	小吃
đánh giá quá thấp	低估
sự phức tạp	复杂度
Thành phố phía Bắc	市北
kích thước	维数
ủng hộ	贍
Toàn cầu hóa	全球化
kéo	扳
chỗ trống	空缺
Ưu tú	精英
Phân đôi	分叉
nghìn	韆
tránh xa	远离
Có ý nghĩa	显著
Bảo hành	保證
Loài	物种
Hojo	北條
giăm bông	汉姆
Biện hộ	力主
Cắt	截止
Renchen	壬辰
Cây thuốc phiện	罂
Âm	諲
Cứu hộ	援救
cơ sở dữ liệu	資料庫
Min	閔
phong cảnh	地标
Hạt Ning	宁县
Vol	伏尔
Ông chủ	老板
bán sỉ	躉
Nhạc sĩ	樂手
sôi lên	瀹
Quân đội mới	新军
Ford	福特
tiêu hóa	消化
Nhánh rồng	龍科
Đến	俢
hoạt động	作业
cảm biến	传感器
Jie	齗
phòng ký túc xá	宿舍
Christo	克里斯多
nhìn	瞅
Tổng giám đốc	總經理
tình hình	局面
sở hữu trí tuệ	知识产权
Hạng Vũ	項羽
TVB Emerald	無綫電視翡翠
bạo chúa	暴君
Trung đoàn	團總
Tình hình	情况下
Thomas	湯瑪
Osaka	大阪
Cùng một chủng tộc	同族
Yêu và quý	拉夫
Người phục vụ	侍从
Bit	位
Nho	萄
Lan	斓
Nes	内斯
giống	类似
Lượng nước	水量
cuộn treo	幛
Người chơi gôn	球手
Rong	穇
trái cam	橙
Treo	懸
Giải vàng	金像獎
Gail	盖尔
Hợp lý	逻
Sinh thái học	生态学
Gặp	遇
Truyền thống Trung Quốc	繁體
dấu	標示
hiên nhà	庑
Yongning	永宁
sự phối hợp	組合
Trang mới	新址
đúng	右
Dịu đi	纾
Chính trị luật	法政
Xã hội	社團
Sheng	嵊
Juxtapose	並設
Tấn	浛
Pyrene	芘
Mini	米尼
du lịch	旅行
Yi	丬
Bình luận	評議
hiđrocacbon	烴
Bắn	射中
Bọn trẻ	子弟
Vất vả	奮
Quan âm	观音
Hoàn cảnh gia đình	家境
Trang Chủ	家子
Dezhi	得志
đi cà kheo	趫
Án Lệnh	奉旨
Nổi danh	著稱
tròn	圆
Tấn	塤
Panchen	班禅
vậy nên	以便
Đêm đó	当晚
Vòng tròn cuộc sống	生活圈
cắt	切
gali	镓
mái hiên	桭
mở ra	開闢
kho chứa	车务段
Aji	亞及
Toàn thời gian	专职
Mahathir	马哈迪
khao khát	慾望
dơ bẩn	穢
ghét	懟
Trích dẫn	引用
Mona	摩纳
hiểu biết	理解
Xiong	芎
Baylor	贝勒
Yu	鋬
Hoàng hôn	日落
Vật rất nhỏ	顆粒
đại sảnh	礼堂
Chăm sóc sau	善后
Thẻ bóng	球證
Trực giao	正交
Ming	搚
Không	否
xa hoa	靡
TV phát sóng	電視廣
Biên tập	编
dấu	痕
tạp chí	雜誌
Thông dịch	诂
Sự khác biệt	差異
Và	巹
Cloister	回廊
Cục hàng không	航空局
thương	缱
Zhenying	振英
lỗi	误
Zheng	鄭
Con nai	鹿兒
Động sản	屋邨
Pháp luật	屆立法
bằng lòng	慊
phần trăm	百分之
thời tiền sử	史前
Nhảy	蹈
gosh	晕
Binhai	滨海
Mesa	台地
cá mập	鲨
Tụ họp	結集
người Trung Quốc	國人
Moruo	沫若
Ga xe lửa phía Đông	东站
Anna	亞那
Lớp	成绩
Chan	鯘
Ba vương quốc	三國演義
Sinh quyển	生物圈
滪	澦
cảm thấy	氈
Đến	以
Nước và đất	水土
Lụa	绢
Trung hạn	中期
Lok Ma Chau	落馬洲
Thánh địa	聖地
Đúng đắn	在義
Plover	鴴
Xuống biển	入海口
Chu	譲
Sergey	谢尔盖
tranh luận	論點
Mặc du	雖
địa điểm	場所
Yao	曜
Hai bên	兩方
Wang Mang	王莽
Hội Sinh viên	學聯
Tên pháp lý	法名
thuận lợi	有利
Huhehao	呼和浩
đá	喦
Cơ quan không gian	航天局
tuần	星期
chu cho giận dư	獳
Tỉnh Chiba	千葉縣
tất cả	一切
Cao đẳng	专科学校
ông nội	祖父
Lòng tin của công chúng	公信
Atty	阿提
Qi	戱
Cou	薆
thay thế	替换
màu xanh lá	綠色
Trở về	回报
Xa xôi	遙
Đội trong	隊在
Băng nhóm	罡
Nga	俄罗斯
Trả	詎
cấp	秩
Kogi	科給
Ba điểm	三分
Xin	昕
tìm	尋求
dỗ dành	鬨
kỵ sĩ	騎兵
Phượng Hoàng	鳳凰
nếm thử	味道
Quân đội Tứ Xuyên	川军
Cành liễu	杨柳科
Churchill	丘吉尔
sự nối tiếp	數列
loạng choạng	蹌
Ottoman	奧斯曼帝
Niagara	尼加拉
Serialization	連載
Bắc	北
Công nghệ	術學
Cụm	集群
Làm	朶
Tỷ lệ bệnh tật	病率
Giành được Hồng Kông	獲香港
Nấm	真菌
Đồng tổ chức	合辦
Ấn bản đầu tiên	初版
phần mộ	墓穴
Indica	籼
đàn organ	機關
Răng rồng	齒龍
nạn đói	饥荒
Thành phố Thiều Quan	韶关市
giới thiệu	荐
Ens	恩斯
Lá cây	葉子
hình minh họa	插圖
ngớ ngẩn	惛
Đã ký	签订
Tỉnh Tân Cương	新疆省
lên	向上
Hitler	希特勒
đẻ trứng	產卵
trường tiểu học	小学
sàn cứng	硬地
Sự quản lý	管理部
Sản phẩm hoàn thiện	成品
Băng	磁带
Trò chơi đánh	擊遊戲
Tolu	吐鲁
Bướng bỉnh	辀
tri ân	感激
Yi	羠
bày tỏ	抒
Học viện	学府
hiệu ứng	功效
hiệu sách	书店
lưới	格
Sau đồng hồ	鐘後
Giải thưởng chuông	鐘獎
Khai mạc	开口
dơ bẩn	肮
Chết tiệt	貛
nhọn	尖銳
bẩn thỉu	龌
Thuốc thử	试剂
sầu thảm	憯
Máy tính bảng	牘
Sự đối lập	反对派
Bờ trái	左岸
Yellowtail	鰤
Hàng năm	年生
Trang chủ chung	家將
phốt phát	膦
Ý nghĩa	意
xem	看见
suốt cả năm	终年
Số Pi	沷
Thứ hai	其次
Một số	幾種
Số tiền	金額
Nóng bức	大熱
cây củ cải	菔
Để lộ ra	裸露
sai	虚假
đi ra	出来
A	一場
Tổng cộng	總共
Wang Xing	王星
khập khiễng	蹩
X	犡
phía Nam Trung Quốc	華南
mũi	鼻音
Gongmiao	公廟
tìm	謀
Biết rõ	谙
móng vuốt	蹯
quyền lực	強權
động vật có xương sống	脊椎动物
ngớ ngẩn	眴
mảnh dẻ	輕微
Cứu giúp	有助于
Sau đó	繼而
Hợp nhất	中並
xe buýt	客車
Nghệ thuật	阿特
Gọi	召
Missouri	密蘇里州
dẫn đường	航海
Chồi	巴德
Tina	蒂娜
phát triển	进步
nền tảng	基金会
khi nào	儅
Bọ cánh cứng	螠
Đường Kwun Tong	觀塘道
Vui vẻ	獝
Celtic	凯尔特人
người ghi chép	隷
Nghẹt thở	掁
Đã đổi tên	改稱
Hồ lớn	大湖
Suy nghĩ	思考
Đô la Đài Loan	臺幣
số tài khoản	账号
Ghi bàn	得分
điểm khởi đầu	起点
Ở Trung Mỹ	於中美洲
Ram	夯
Được xây dựng trong	建於
Đánh giá	评估
Síp	賽普勒斯
Flori	佛罗里
Xi	憙
loài tre	筇
Tìm thấy	找來
dạ hội	舞會
Bún	褣
cố đô	皇城
tàu	舶
rừng	樹林
nhu la	比如
ngoại ngữ	外语
tung Chung	東涌
hằng ngày	日常
Bảo vệ màu đỏ	红卫兵
Xếp chồng lên nhau	堆疊
Âm	輨
Tongcheng	桐城
hành	獵戶
liên quan	有关
Gou	駏
Yan	扚
Az	阿茲
mái chèo	楫
Cứu giúp	助人
câu trả lời	荅
Chú ý	注目
mờ mịt	僾
Oe	大江
Viết	写道
Hảo	豪族
Đường thẳng này	此行
Ghana	加那
Si	阫
tấn công	進攻
Xue	珸
Lên	仰
cao đẳng Nghệ thuật	文学院
lúa mì	稞
Tôi	亍
Thuộc sở hữu nhà nước	国有
Chết	殉
trộn nước với đất sét	埏
nhiên liệu	燃料
Chan	婵
Jiangdu	江都
hợp thời	及時
Vây đuôi	尾鰭
chỉ huy	司令
Hu	腠
Dân số	种群
Thomas	湯瑪斯
Theo thứ tự	依序
bao gồm	括
Tong	鋖
Blues	藍調
Thiên tân	津
Yamei	亞美
Houston	休士頓
Đối xử như	当作
Rạp chiếu phim	影城
Con người và	人並
ngã	秋天
Âm	垿
ban đầu	本來
hiện có	現有
Ba Cup	霸盃
Jie	劼
Ye	曄
Nước nhỏ	小国
Anu	阿努
Pháo đài	士堡
Phòng hành chính nhân sự	行政部
Phong chức	出家
thực ra	竟然
Hướng dẫn cuối cùng	終導
Dễ dàng	轻松
Ngọn lửa	开火
Xiu	琇
nghĩa vụ	義務
Kagoshima	鹿兒島
đói bụng	馁
Jardine	怡和
Nai	鐼
Ga phía bắc	北站
lụa	丝绸
Gạo nếp	醮
osmium	锇
Anh ta	他卻
Bộ nông nghiệp	农业部
Sự bảo vệ	防護
Bọn trẻ	兒女
Mumbai	孟买
Trung úy	校尉
Li	髝
Gió mùa	季風
Proton	質子
bởi	由
Tòa án	法院
Với	具
lấp đầy	牣
bất di bất dịch	侐
Trung thành	忠烈
Nước	水体
thở dài	喟
Giải thưởng Lamy	萊美獎
Memphis	孟菲斯
Nói	讲话
Bion	比昂
Tây An	弆
Wendy	文迪
Đơn nam	男單
Biện pháp đối phó	對策
Như thường lệ	如故
Mười bảy	十七
trò chơi Olympic	奧運會
Strangle	拲
thực ra	其时
Lớp đơn	單層
Quận Tian	田县
Làng Kashiwa	柏村
tóc	發
Tiểu thuyết Hạ	俠小說
cây liễu	柳
Đảng chính trị	政黨
Nam An Huy	皖南
Xấu hổ	臤
cửa hàng bách hóa	百貨公司
con kiến	蚁
Cựu chiến binh	元老
Quan thoại	鱖
cầu	橋梁
kinh ngạc	惊人
chuông	鐘
Kéo dài	跨越
Phân phối	集散
Jian	戩
Với cái này	與此
con cò	鸛
Nhón	摎
chảo-	泛
Rời rạc	離散
Những sản phẩm nông nghiệp	农产品
Thái Y Lâm	蔡依林
đầu gối	膝
Zidong	自东
Quan thoại	國語
Bầy đàn	衆
sau đó	之后
ngẫu nhiên	随机
Loire	卢瓦尔省
Tucheng	土城
mục lục	指标
sự bảo tồn	保全
điện từ	電磁
Huân luyện viên trưởng	總教練
Mở rộng	拓宽
thai kỳ	怀孕
đỉnh cao	峰
Rui	瑞
đình chiến	停戰
Chỉ huy quân đội	軍軍長
Trong văn bản	文中
Tất cả	都
Inge	英格
Thua	丧失
Khu trung tâm	中区
Miễn phí	无偿
San Mari	圣马力
Đưa cho	賜
Tỉnh	兹省
nếu	倘若
mỹ phẩm	化妝品
Col	峝
danh từ	名词
Bộ lạc	族人
Lixi	利西
Cuộc hẹn đặc biệt	特聘
Qiao	譙
Cắt ra	剀
gậy	粘
bức vẽ	画
Carolina	卡罗来纳
Guojin	國進
Li	銕
Kế tiếp	接下来
Nara	楢
trên tàu	機上
nức nở	欷
đời sống	人生
Li	蠾
Hố đen	黑洞
Dòng sông tình yêu	愛河
kết thúc	告终
con quạ	克勞
Phan sinh	方济
Zhonglang	中郎
cỏ dại	麃
chỉ	表明
Kou	蔻
lạm phát	通货膨胀
Trang phục	衣冠
thịt	瓤
Trung bình cộng	平均
Người Đài Loan	臺語
khủng long	恐龍
Chung	地將
Siêu sao	巨星
trước	事先
Lật ngửa	翻越
phấn	堊
Kan	闞
học viện	院所
Đại học hoàng gia	帝國大學
Honda	本田
ở gần	瀕
tốt	良
Làm tốt	做好
nhưng	惟
ngươi	尒
Ngày sabát	安息日
Giải thích	闡
Ủng hộ	拥立
mù tạc	芥
Nên	宜
sông băng	冰川
mục đích	抉
S	斯
Ủy ban quân sự	軍委
Haute-Loire	上卢瓦尔省
cắt	开凿
Craig	克雷格
Tuck	裥
Không có sẵn	未有
kế bên	旁邊
Cặp đôi	夫婦
Ocher	鵭
Quân đội Liên Xô	蘇軍
Nhượng quyền thương mại	專營
bổ sung	额外
tần số	頻率
Des	德斯
Sáu triều đại	六朝
Đinh ốc	螺
Con số	個數
Thời kỳ là	期為
chị em gái	姊妹
Oda Shin	織田信
Gai	霢
phía Nam Trung Quốc	南華
Những người khác	別人
đau	瘡
Nhạc cụ	樂器
Quán tính	氣勢
gọi	稱呼
tuyệt quá	偉大
vườn	圃
Incheon	仁川
Hành động bu lông	槍機
Đau khổ	患
Xen kẽ	穿插
Mayer	马耶
Hàm sóng	波函数
Dòng hoang dã	野線
Nguyên tử	核
Huệ Châu	惠州
Tương tác	交互
Được Quan sát	观察
động cơ	馬達
Xem	参看
Đối với Đài Loan	為臺灣
Thành viên thay thế	候补委员
lấy	取
Bit	比特
Đến	致
Làng quân sự	眷村
Pennsylvania	宾夕法尼亚
Ứng dụng	套用
gớm ghiếc	狰
Rowan	羅文
chỉ có	仅仅
Khùng	瘋
Yun	鋆
Thành viên ủy ban	委员
Người nào	有人
tiền bồi thường	赔款
mục đích	宗旨
Xi	熹
Youzhou	幽州
đổi	滙
Mọi người	人們
Được	求得
Cá chép bạc	鲢
KFC	肯德基
nếm thử	品味
Lưới thép	线网
Thay thế nó	取而代之
thời vua Louis thứ XIV	路易十四
Nấu chín	熟
Hàng xóm phía bắc	北鄰
Hôm nay	当今
Khám nghiệm hoàng gia	科举
Sai Ying Pun	西營盤
bông	緜
Li Chengwan	李承晚
phân tán	分散
xuất sắc	辉煌
Chia đôi	分兩
Mongo	蒙哥
Kanban	看板
Moo	哞
Âm	韴
Được đặt tên	名列
Dương	顸
đơn độc	煢
Trung tá	中校
Sự giải trí	娛
uống	饮用
điền kinh	田徑
Istanbul	伊斯坦布尔
hội thoại	对话
bất hợp pháp	非法
lưu huỳnh	硫
Thuyền buồm	航行
mụn cơm	疣
bán đấu giá	拍卖
tìm kiếm	搜索
Ngoại kiều	疏遠
quy ước	公约
Chú	伯父
Hư hỏng	受损
một loại	一類
Tìm kiếm	搜
Vượt qua	帕斯
Bộ tổng hợp	合成器
hiện hành	本屆
Ba chiều	立體
Hang	山洞
Sẽ tốt hơn	會比
Gia súc	牛
Samuel	塞缪
giòn	脆
Chiến tranh	戰亂
Gạo nếp	餲
Ở gần	傍
Hương vị	风味
Cá tráp biển	鲷
bay hơi	蒸發
mưa	下雨
Nghi thức	礼部
Cuộc thi	大賽
Bao gồm	收录
sôi lên	瘩
tiếng hổ gầm	虓
Năng lực	才华
chính	主修
Trên đường	上路
Cột	栏目
Dung hợp	融合
Marseille	马赛
thuyền chở hàng bằng gỗ	艚
lá thư	字母
Trên bàn	表上
háu ăn	餮
Đào mương	塹
thuế suất	税率
Liệt kê	列舉
yêu tinh	眄
Dịch vụ ưu tú	立功
Thành phần	组件
Duyệt quaSau đó	瀏覽其後
Xây dựng	修建
rùa	龜
cụm từ này	這個詞
Naruto	鳴人
Hát	懎
Rơi vào	归入
Dali	大里
ngọn lửa	火
tuyển dụng	招募
Zhi	志
gây tử vong	致命
Tăng lên	兴起
Phát hiện	檢測
Sức cản	阻力
Rẻ	便宜
thực tế	真實
Shau ​​Kei Wan	筲箕灣
Ở trên	上面
Chòm sao	星群
Yi	僉
dồi dào	充沛
Stowe	斯托
môn học	科目
Xa xôi	偏远
Kofa	弘法
cách phát âm	發音
Hiện tại	现
Tôi	俺
Linh miêu	瞌
điều này	今
cây búa	锤
Ying	穎
Peptone	胨
trực tiếp	現場直播
tràn ra	瀁
House of Lords	上議院
đất đai	陸地
Tsim Sha Tsui	尖沙咀
Zhenhai	镇海
cáp	電纜
Xấu hổ	枃
Chiến trường	戰區
Tùy chọn	選項
dư thừa	过量
Thủy thủ	水兵
Tận tâm	為專
Thêm	外加
Thần linh	神祇
Mochi	鳚
ẩn giấu	匿
nấu chảy	烊
Liu Xiao	刘晓
Dài	漫長
Điểm	点数
Bỏ	裁撤
Yala	亚拉
Tỉnh miền đông	东省
bình luận viên	评论员
Loa	言人
khác	另
móng vuốt	爪
Admonish	谖
Thịnh vượng	兴隆
thành viên	成员
Chánh văn phòng	总参谋长
Shao	曷
Hạ cấp	降级
đồng hồ	时钟
Bang	沘
Gao	皋
bầy cừu	羼
Bang	捊
ngứa	癢
sự ra đời	来临
Bóng chày	蛁
Ni	伲
Qiqihar	齐齐哈尔
chất làm se	涩
Nhân viên tổng hợp	总参谋部
Argon	氬
Bắc TP.	北市
Wushuang	無雙
Thờ cúng	拜堂
chỉ	示出
Huy chương	獎牌
Phụ	亜
Bệ phóng	发射台
cá nhân	个体
Reductase	还原酶
lời nói	諺
Cựu chiến binh	老牌
lớp học	课堂
庵	庵
Huaian	淮安
sáu mươi	六十
con kiến	蚂
Giải trình	解釋
Anna	安納
sách	著作
vẫn là	还是
Nước Anh	大不列颠
Yanghu	阳湖
Như là	此種
Nỗi buồn	悲痛
Standard Chartered	渣打
ngốc nghếch	戇
Tiền lương	俸祿
Điều chỉnh	校正
Yaobang	耀邦
đàn organ	风琴
Quyền công dân	民權
Xi	浠
Giữ lấy	执
dừng lại	制止
Chết sớm	夭折
Khổng lồ	钜
đất	泥土
kết thúc	終
Ryukyu	琉球國
mổ	啄
Kích thước	维度
Yu	鋠
Vương quốc	王国
lũ lụt	泛滥
thỏi	錠
Âm	廾
Lào	寪
khảo sát	調查
cầu hôn	求婚
Nét chữ	体字
Nhầm lẫn	淆
cửa tiệm	店鋪
Bada	八達
quên	忘记
Hóa học	化学
cát	沙子
Nhiều nước	水域
Đảo Hồng Kông	港島
dây mũ	緌
phản cảm	攻勢
với	衕
bắt đầu	開端
Xu	栩
màu xanh lá	菉
Lân lượt tưng ngươi một	陸續
Vì sự tiến bộ	為進
phạm vi	范围
chiều rộng	宽度
Quy mô lớn	大規模
chết	殞
móc câu	勾
Hèn nhát	臦
Buộc tội	控告
liệu	不論
Không để	不讓
Huashi	化市
Trong công viên	園內
Lễ	頒獎禮
Đàm phán	议和
Tát	磇
King Wu	武王
Phản đối	反对
Lu	吕
bối cảnh	場面
Báo cáo	報
không phải	丌
Bộ	各部
Nhọt độc	爗
Hòa nhã	寬約
Các bước	台阶
điều đáng tiếc	憐
Kovic	科维奇
Ize	伊泽
lực từ	磁力
Đại học Yenching	燕京大学
Đội trong	隊進
Nhà máy đầu máy	机车厂
Quận Mountain	山縣
Dàn dựng	分期
tỷ giá	匯率
Apex	先端
mô hình	模范
bao vây	围城
Số Pi	貒
Ru	孺
Thích hợp	澛
Lúa mạch	稘
giàu có	豐富
Foss	夫斯
bài bạc	赌博
Đêm	黑夜
Hiệu ứng hiện tại	現效力
nói nhảm	嚕
Nắm bắt	夺取
Nhà nghiên cứu	研究者
Phá vỡ các quy tắc	破格
khuynh hướng	傾向
kho báu	寶
Du học Nhật Bản	留学日本
Chao	晁
Tỷ lệ sử dụng	使用率
tê giác	犀牛
Sông và	河與
Mái vòm	穹顶
Quyển sách	该书
Theo dõi bởi	紧接着
Yong	镮
Âm	殷
Nhiều	多元
mua, tựa vào, bám vào	購
chất đạm	蛋白
Giải thưởng vàng	金獎
Hoàn thành	完場
Xấu hổ	尴
hệ số	係數
Nhà ga	國駐
Bà ấy	她於
quần áo	衣著
Can đảm	勇猛
Công nghệ cao	高新
hoàn toàn	合共
Lớn	在逃
Ming Shizong	明世宗
phạm vi	音域
Anton	安東
Ra trận	出战
tiếng Ả Rập	阿拉伯语
âm mưu	情节
bạch dương	樺
Đo lường	措
chủ tịch	社长
Trang Chủ	家裡
Độ dẻo	塑性
Đôi tay	雙手
nhiếp chính	攝政
gấp rút	偬
Sự hy sinh	祭品
Vượt qua	递
Han	邗
Tỉnh	拉省
sự bảo vệ	保护
Mọi người sẽ	人將
chuyến du lịch	游
Que	闕
Đại hội đồng	大會
Cấp trung	中層
Đối với thành phố	為市
Sớm hơn	更早
Pomera	波美拉
tâm trạng	心情
Niêm phong như	封为
Ảo giác	迷幻
Quay lại	回
Phía bắc	北边
Thẩm phán quận	县令
Chuyển đổi	轉換
cổ tay	腕
phòng thủ	防御
Tang Shu	唐书
Ghi lại	战绩
Đầu tiên với	先以
lãnh đạo	领袖
Bị tô cáo	被控
Trong nước	国产
sâu sắc	深深
Hitomi	瞳
Lenin	列寧
bộ phận	段
Lớn hơn	較大
thua	输
thăng trầm	起伏
Hải phòng	海防
Đúng luận điểm	权主义
Chống cộng	反共
Vịnh Tây	西灣
Sửa	修葺
con cóc	蜍
đấu với	与
có lợi cho	有利于
Bay	鼯
hẹp	狭窄
Hàn Quốc	朝鲜族
Bristol	布里斯托
Louis XVI	路易十六
mộng	榫
Hát	燽
Mặt và	面與
Mầm bệnh	病原体
thích hợp	龛
Albert	阿尔贝
Sản xuất	製播
đào tạo	训练
A-xít a-xê-tíc	乙酸
như	如同
Vươn xa	深远
Tương tự với	類於
xương chân bò	牼
Sidi	史迪
trẻ sơ sinh	嬰
xấu xí	丑
Cá mèo	鲶
tự hào	得意
Đã phỏng vấn	受訪
Ngày kỷ niệm	纪念日
Mickey	米奇
Sôi lên	汆
Một tâm trí	一心
trung tâm	中心
hành khách	乘客
Chuẩn bị cho chiến tranh	备战
Than van	嗋
chiều sâu	进深
tráng miệng	點心
Động cơ	擎
Treo	弔
đi dạo	漫步
Ruhr	魯爾
Tự tử	自尽
Lĩnh vực là	場為
Công bằng	股本
nướng	烤
con bọ ngựa	螳
Mianyang	绵阳
Sức khỏe	厴
Danh tướng	名将
Phần trước	前部
Hutuktu	呼图克图
thanh John	圣约翰
Chuyến thăm	參觀
dấu vết	跡
Giá vé	車資
sự bành trướng	擴充
Xem	參見
bỏ phiếu	投票
rất ít	寥
quyền sở hữu	所有权
đóng băng	冷凍
bóng nhờn	腻
Guofeng	国锋
Một lát sau	後又
con gián	蠊
sự ưu tiên	優先
tần số	次數
Nâng cao	挺进
S	犋
Phong phú	多生
Thờ cúng	祭拜
Quấn quanh	纏
Flora	植物志
tốc độ	步伐
Hỗ trợ mặt đất	地勤
bàn	桌子
na ná	类似的
Bogie	转向架
dấu	馬可
Lencia	倫西亞
chuỗi	串
Xi Zong	僖宗
Dehua	德华
mầm bệnh	病原
Tái hôn	改嫁
Victor	维多
Phụ trách	执掌
tấn công	攻击
tiếng Nhật	日裔
Điểm ủy quyền	授权点
Cao về	高約
chim cốc	鸬
khổng lồ	巨人
Lingshan	灵山
Châu Âu	歐國
chung	大將
thức dậy	醒
đặc biệt	尤其
biên giới	接壤
Tát	梄
Giang Tây	江西
lạnh nhất	最冷
Tàu chiến	战列舰
Zhu	梚
nhón	揑
hổ phách	琥珀
Thực hiện	作成
Bóng đá	足坛
Thư giãn	放松
ghim	銷
thực tế	真正
Rộng	袤
Xếp hạng	收视率
Hu	轞
Thua cuộc	洛斯
Mô phỏng	実
suốt đời	终身
Nên	应该
Fez	菲斯
tranh chấp	纠纷
He Xiang	河乡
cuối cùng	終於
Bolo	博洛
sự sụp đổ	倒閉
Đại hội thể thao Đông Á	東亞運動會
Đóng khung	陷害
Zac	扎克
được	給定
Qi	祁
Chủ nghĩa nhân văn	人制
Vinh quang	光辉
Ji	嶹
Dài	隴
Nuốt	吞噬
giám sát	监测
cây lau	芦
đã đính hôn	订婚
Yi	羕
chất lượng cao	优质
vô số	无数
Bực bội	戦
Khoa học và Công nghệ	理工
bóng	影
Đại liên	大连
Chạm tới	達成
Pháp	法國國
Koch	科赫
gọi	召唤
chính xác	纠正
Vợ lẽ	庶吉士
Cronqvist	克朗奎斯特
Hóa dầu	石化
Nhịp tim	心率
Thần sấm	托爾
địa ốc	不動產
Liang Guoxiong	梁國雄
ám ảnh cũ	故地
lễ rửa tội	洗禮
Giáng sinh	圣诞节
cây lau	葦
Giới thiệu	舉薦
Quan	蒄
Thành phố	该市
Terra	特拉
không xác định	不明
Bor	博爾
Schleswig	石勒苏益格
vật nuôi	宠爱
Một số loại	某种
Người chơi	隊員
Tỉnh	各省
quy ước	慣例
Rỗng	空心
rau	荁
Chai wan	柴灣
Qi	秊
sương mù	霧
Khai mạc	開場
duy trì	维护
Đài Loan Đài Loan	臺灣臺
Tsuki	槻
người Trung Quốc	華語
sự giàu có	財富
Trong quân ngũ	軍中
Nhập viện	住院
hái	诹
mệt mỏi	斁
Núi	山区
Nói	谓
Kết cấu	纹理
Chu	辧
Thị giác	視線
lồng	篝
Cố gắng	心力
Jing và	經與
đi tham quan	观光
Trình duyệt	覽器
tiết kiệm	节约
theo dõi	轨道
Qin Jun	秦军
chỉ huy	指揮
Tôn kính	殊榮
Khu vực khai thác mỏ	矿区
Trường hợp	病例
Điều khiển	行駛
vi sinh vật	微生物
óc	大脑
Vui mừng	愉
thị trường	集市
Từ chối	婉拒
trái thạch lựu	石榴
sự hy sinh	牺
Buồng lái	檥
Món ăn	皿
ban nhạc The Beatles	披头士
Phòng	客房
Nanguan	南管
Đội trưởng	上尉
Sở thích	爱好
Fontanelle	囟
Dongfanghong	东方红
Xuất hiện	樣貌
Có ý nghĩa	顯著
Trước nhà ga	站前
bệnh sốt rét	瘧疾
lãi suất	利率
không khí	空
Với Pháp	與法國
Lòng trung thành	全忠
Wren	鷯
mô phỏng	模擬
Du lịch	旅游业
Nhận biết	鉴定
Mệt mỏi vì	厌
Phù thủy	魔女
Đi đến	後藤
Tre	特雷
Cáp Nhĩ Tân	哈尔滨
phòng ngự	防衛
Thứ hai	星期一
nguồn	來源
mục đích	恉
Đức phật	菩薩
quên	忘記
Cá	鯕
xung quanh	四处
columbium	鈳
Pith	蜙
Nói	發言
gót chân	踵
Còn thiếu	下落不明
Vòng tuần hoàn	发行量
bệnh cúm	流感
tên đầu tiên	名字
Reid	里德
Zi Zhi Tong Jian	资治通鉴
Hu	禬
Định giá	定价
nam châm	磁鐵
trộm cắp	盗窃
trận đánh	战事
Kẻ trộm	賊團
Queensland	昆士蘭
Tiềm năng	电位
Loạt	叢書
Ngành quân sự	军工
Yu	鮗
xúi giục	煽動
mối quan hệ	关系
lập kế hoạch	規劃
Sau đó	继而
chèo xuồng	舠
từ chối	沒落
chứng minh	证明
Yan	灠
Chắc chắn	厄尔省
vị trí	地點
đần độn	驽
Nguy hiểm	危險
Đánh giá	評鑑
Con gián	蠤
nôn mửa	呕
Sự hoàn hảo	至善
Ga tàu	的車站
tươi	鲜
xuất hiện	相貌
Dài	朗
Lựa chọn	选取
Longqing	隆慶
Bị giết	所殺
Qian	鏘
Đài loan	全臺
gia đình	世家
như sau	如下
bắt chước	模仿
Gai cứng	鰭硬棘
cho đến khi	一直到
Hai lần	兩度
nghiêm ngặt	嚴謹
Sớm hơn	早於
bay	蠅
hàng rào	篱
chuyển đổi giới tính	變性
Tuck	斎
đồng hồ	時鐘
Xinh đẹp	绮
không phải	并非
không dây	無線
Xu hướng	干流
Yi	猗
Hạt Yilan	宜蘭縣
Yong	雝
phải	不得不
Sự trừng phạt	处罚
Arachnidae	蛛科
con quạ	鴉
Hướng ngoaị	出線
Khinh bỉ	谑
Chi	碏
buồn	悲傷
Hồi sinh	振興
Gaoju	高居
Tabu	塔布
Tổng	格罗斯
đại từ	代词
Vô cùng	極具
dụng cụ	仪器
người Trung Quốc	汉文
xuyên qua	經
Và	了與
Cổng thông tin	门户
Tàn tật	傷殘
bệnh còi xương	疳
đồng cỏ	草原
Độ chính xác	精度
Pro	普羅
Kan	蒪
Giữ	举办
phái đoàn	代表团
Không có gì	一無
Neem	楝
Tori	托里
Sago	西米
Khớp nối	铰
Người vợ	老婆
Suy sụp	沮
Yuan Lin	員林
Đẩy	推
Tổ chức lại	重組
Cái cằm	颔
Người chồng	夫座
Xie Chang	謝長
xác ướp	木乃伊
Thất bại để	敗給
không vui	葸
Thành phố sông	河市
Mở ghi chú	開記
Nó được gọi là	被稱
Xấu hổ	嶨
Kara	喀拉
Clan	宗族
Cuộc tranh cãi	讧
Có liên quan	關聯
bờ biển	海滩
ôxy	氧气
Nâng lên	秉承
Cheng	騁
Tên trung quốc	中文名
người hầu	仆人
Quá tải	重载
Katai	迦太
Ẩn giấu	藏身
Luân hồi	轉世
xã	公社
Kinh thánh	圣经
Tan	谭
Nam Xương	南昌
kho chứa	车厂
Tỉnh đài loan	臺灣省
Trò chơi toàn sao	全明星賽
Orne	奥恩省
Hai liên tiếp	連續兩
quyền giám hộ	監護
Liên Xô	苏联
Chúa Trời	天主
rhodium	铑
Bị phá hủy	被毀
chỉ có	只
Phim hành động	動作片
Là để	是讓
Sâu	蚒
Một	一體
trở nên	成为
sợi	纱
Chết	滰
Hiệu ứng âm thanh	音效
Ngạc nhiên	怚
Wiki	维基
lấy	採取
Màu cơ thể	體色
toàn bộ	整個
phân tử nước	水分子
Nhân chứng	目擊
Phù hợp với	適合
Bảo vệ	卫冕
Nong	荝
khác nhau	异
xuyên qua	经
người Ý	意大利人
Yên tĩnh	砗
Không chỉ là	不仅仅
Witte	維特
Phỏng vấn	采访
Chong	驌
Dài	長久
Tính xác thực	真实性
áo choàng ngoài	外套
Phụ thuộc vào	視與
Calais	加莱
Cứu giúp	幫
Khánh thành	首屆
Cạn kiệt	耗尽
bởi	通過
Cánh tay	手臂
Yali	亞利
Pera	培拉
Được chỉ định	獲委
Người nổi tiếng	名士
Ling	蔆
vượt qua	過了
con đường	径
Vùng biên giới	边区
Người giúp việc	墦
lạc đà	骆驼
Xing	荭
Tấn	饨
Đơn vị	分隊
Âm	魤
động mạch	动脉
silicon	硅
Di cư	遷徙
Tham gia	与会
Quốc gia	國的
Gân	藨
Ít hơn	小於
Kích hoạt	啟用
Độ lệch	偏离
Sẵn sàng	准备
Thắng lợi	获胜
Tiều phu	騵
Khám phá	揭開
U ám	杒
Giáo viên và học sinh	師生
Thống đốc	港督
pha lê	水晶
Sẽ kết thúc	會結
cắt	截
con chó lông xù	尨
điểm	点
Thẩm Dương	沈阳
Anh ấy làm	他並
âm mưu	阴谋
Sẽ vẫn	仍會
Awang	阿旺
Khai sáng	啟發
chộp lấy	搶奪
Trụ sở chính	总部
bức vẽ	繪畫
Bụi bặm	撣
Độc thân	單身
đối diện	对称
khoảng thời gian	間隔
bữa tối	飧
Tosa	土佐
Mùa trước	上季
ánh sáng	輕
kiểm tra	考試
Du	杜
Chỉnh sửa	整頓
Sớm	不久
Đồ tạo tác	神器
nơi ở cũ	故居
Sự vô hiệu	失效
Kinh doanh	营业
Literati	士大夫
Tiền truyện	前傳
nhà khoa học	科学家
Songshan	嵩山
Sunda	巽
Người chơi	队员
Galifo	加利福
bán	售卖
Qua	佺
Wei	瑋
Te	忒
Bài hát mới	新曲
Hoạt động	举措
Tội ác	罪案
Yên tĩnh	蚶
kẹp	箝
Hạ viện	众议院
Phượng Hoàng	鳳
tiếp xúc	接触
Khoa Lịch sử	史部
Tiếng chim	伯明
Tang	柢
Chấp nhận	接納
thủy phân	水解
bỏ phiếu	表決
Cổng phía đông	東門
IV	四世
Mua trong	购入
Tôi	偶
Bữa ăn	粕
Chợ phía Tây	西市
bộ định tuyến	路由器
Đặng Tiểu Bình	鄧小平
Và được	並被
Sáng	燿
Baa	咩
Công bằng	同等
hệ điều hành	操作系统
Sẽ đầu tiên	會先
Cuộc chiến thuốc phiện	鸦片战争
Dege	德格
Bến du thuyền	匡
đỏ mặt	赧
Rollei	羅萊
Xuân	暅
phương châm	口号
Đã đến	卡梅
Suvi	蘇維
Nhanh	快捷
phong cảnh	地標
Croe	克羅埃
mềm mại	柔軟
Lạm dụng	滥
Tây An	褭
ca hát	歌唱
Được lai tạo	育成
Loại một	一型
Lảm nhảm	呓
nghìn tỷ	秭
Gaochang	高昌
chính thức	宦
Ren	侇
Silesia	西里西亚
Loạt	连串
Zheng Jing	鄭經
Albania	阿爾巴尼亞
Cốt lõi	蕊
phòng bếp	廚房
Mesopot	美索不
Chỉ định	指定
kết nối	连接
Cạnh tranh	竞
Ghim	蛲
Tiêu đề	冠以
Irving	欧文
Corinth	科林斯
Dinh thự	宅邸
Weller	韦勒
Tuyết rơi	降雪量
Mọi gia đình	家家
băm nhuyễn	醢
Dinh thự của Thống đốc	總督府
nhắm mắt lại	瞑
Khó xử	獮
Trong khoảng	約有
Shizhou	什州
Giữ	舉行
ngôi đền	聖殿
Litao	立陶
Trưng cầu dân ý	公投
Saint	聖
Philip	腓
Roh Moo-hyun	卢武铉
biên tập viên	编辑器
mặt trời	艪
Hy vọng	意料
Ye	鄴
đồng tiền	硬幣
Nghĩa trang	墳場
công bằng	等於
dính máu	血腥
Tạp chí	学报
phân	屎
Vội vàng	沶
Quốc tịch	國籍
Đến	鮀
máu	血
gần đây	附近
Thuộc về	属
cánh hoa	花瓣
Xi	兮
xe tăng	鑵
quần vợt	網球
hàng	線條
vật nuôi	寵愛
Yan	羉
tụ lại	辏
Xây dựng	组建
máy chủ	主人
Người cao cả	志士
đại học Harvard	哈佛大学
cung điện	王府
cứng	艰苦
Thêm vào	上加
thung lũng	峪
sự bất công	冤
Kish	基什
Vòng tuần hoàn	流通
Faro	法罗
Bị cấm	紫禁
Wiener	维纳
Wuzhou	梧州
Quy định	条例
chuỗi	絃
nhà tài trợ	赞助
Quân sự và dân sự	军民
món nợ	債
Thường với	常與
Phong Đài	丰台
Hấp dẫn	吸引力
manh mối	线索
Virginia	弗吉尼亚
Có người lái	载人
Giết chết	击毙
Mang trở lại	帶回
Gerson	格森
Khai thác	剝削
Liu Jia	劉家
Ngày lễ	假期
tháng Ba	进军
lộ trình	路線
Thuộc về	同屬
Thuyết tương đối rộng	廣義相對論
Yan	彦
Quốc vương	君主
Phái hữu	右派
hòa thuận	相處
Thiếu tướng	少將
Sự tôn trọng	敬意
rộng lớn	寬廣
Phân phát	派發
Kinh tế và Thương mại	經貿
khi nào	何时
Sao phụ	子星
Matsue	松江
Ngưu	苅
Russell	羅素
Hu	坖
Legon	勒岡
Xi	郙
Zhaicun	寨村
xe buýt	公共汽車
Đồ khốn	庶子
liệu	不论
Lươngsân vận động	俸大球場
huyền thoại	传奇
sự phân cực	極化
Tây An	聹
buồng	內閣
Đi một	以個
tưa miệng	鸫
Trường học	建校
Chuyên môn	專長
Khu vực	界別
hơi thở	氣息
Đô la Đài Loan	台幣
mùi	氣味
sự tôn trọng	崇敬
Con thằn lằn	蜥
Nong	侬
Cove	科夫
Lun	崙
mạch lạc	相干
xây dựng	築
Kiềm chế	制约
Arashi	嵐
Ying	潁
phi cơ	飞机
Lý thuyết trường	場論
Đã đặt hàng	受命
độ sáng	亮度
Qi	锜
Cuối cùng	為時
Đội bóng đá	足球队
nhà thờ	教會
kỷ	世纪
Cống vật	进贡
Dân tộc	族裔
Xe máy	摩托
Khó khăn	难度
Wiscon	威斯康
Nissa	尼撒
Robinson	罗宾逊
Chơi	飾演
cào	耙
kết thúc	过度
Băng nhóm	幫派
Cân	称
Thái Bình Thiên quốc	太平天国
Xinhai	辛亥
Ánh sáng	光线
Tro	阿什
Bún	麎
Murong Chui	慕容垂
Nhận vào	入場
niềm tin	信仰
Chết	亾
lúa mì	麦
Xe buýt	大巴
Bốn mươi hai	四十二
Vợ lẽ	妃
Jing	紒
Thành phố	市政
Đất nước lớn	大国
Bố	帕
Tôn kính	勳銜
Đối với Nhật Bản	為日本
Alba	阿爾巴
Chỉ năm	年僅
Hai loại	兩類
Yutai	於臺
Thái độ	姿態
Tren mat nuoc	水上
với	和
Hsinchu	新竹
Yan Guo	燕國
锷	鍔
Bắn	出手
Hắc Long Giang	黑龍江
Erdo	尔多
Giá trị	价值观
Đường sắt Đài Loan	臺灣鐵路
Một trăm triệu đô la Mỹ	億美元
má	腮
Xác nhận	證實
Cuộc họp	该会
Động cơ diesel	柴油引擎
Tổng	總和
lịch sử	歷史
Đến	耮
Tần	験
Gạo nếp	醅
Sự đối xử	療
hình bán nguyệt	朏
than phiền	诼
Thành phố và Quận	城县
Che Gong	車公
diễn đàn	討論區
Điều này	這座
Thẻ mọi người	卡人
Như một loại	為一種
nhạc jazz	爵士乐
Labiatae	唇形科
Thủy lực	水力
xà phòng	肥皂
nhiệt đới	热带
đổ đầy	馅
biến cố	事件
Và phải	與對
Chỉnh sửa	修饰
nhọn	銳
Smash	枍
hẻm núi	峡谷
dấu	標記
Bạn cùng lớp	同學
Thời gian mặt	面時
ba lô	背包
Phác thảo	小品
Khai hoang	填海
chia tay	掊
su hào	苤
Xúc phạm	侮
Eigenvalues	特征值
đỏ	紅色
Aman	鼦
Đài loan	台灣
khô	眢
ngược lại	反之
Việc làm	就業
cầu thang	樓梯
Kè	垸
Bướng bỉnh	烍
Thứ hai	諓
Hợp đồng đất đai	地約
chiến thắng	優勝
Trục xuất	驅逐
tóc giả	假髮
Bộ trưởng nổi tiếng	名臣
Đúng	是沒
Vết trầy	攰
nội dung khiêu dâm	色情
Lần cuối cùng	上次
Cao nguyên	塬
Vị trí	部位
Ichiro	一郎
ngắn gọn	簡潔
mơ hồ	渺
Liên kết	邦德
Bữa tối	晚宴
Hóa đơn	比爾
Không gian sâu	深空
Dậm chân	跺
Chengjun	成軍
tàu	船隻
Alice	翹
Lịch sử	有史
Sự mở rộng	拓
tiết kiệm	拯救
Tiếp cận	逼近
Nhà cung cấp	廠商
cuối cùng	最终
nếp nhăn	皺
đội trưởng	艦長
Vera	维拉
các tập tin	檔
ấu trùng	蚴
ngã	失守
che	蓋
Toà nhà cổ xưa	古建筑
Liền kề	相鄰
Địa chỉ	地址
truyện cổ tích	童话
mùa gặt	收成
Tai	凼
Cục an ninh	安全局
sự miêu tả	描写
Lantian	藍田
Cúp thế giới	世界盃
bụng dưới	脥
tiếng Nga	俄
hiện nay	现今
Và chọn	並採
Yang Ming	陽明
Mãn tính	慢性
kết cấu	构型
Ji Luyu	冀鲁豫
Cởi	脱
Dân dụng	民用
Mạnh nhất	最強
thực thể	實體
Màu vàng	為黃
Đỏ thẫm	绛
nhóm	集團
cải cách	改革
chuyển khoản	转任
Đưa vào	戴上
tiền boa	尖
Quay lại	再來
bàn luận	商讨
củ sen	藕
Ye	赒
thu hút	吸引
tham dự	參加
Jiading	嘉定
Biển núi	山海
Sử dụng nhiều	大量使用
Văn phòng chi nhánh	支廳
Khám phá	揭
Sa thải	解僱
Trong văn phòng	任內
Hiệp sĩ	騎士團
Rêu	藓
Ứng cử viên	人選
Ngây thơ	稚
Vợ lẽ	妃嫔
Torr	乇
Thuộc về	分屬
Thành lập	创立
Đội và	隊及
Xông khói	咝
đưa đón	梭
mái hiên	檐
Chi	錅
đủ	夠
Viết như	寫成
Lượt xem	觀
Lạm dụng	虐待
Ba	灞
Sau	過後
Người Phoenicia	腓尼基
Lên đến	達數
Tàu	艦
Ottoman	奧斯曼
Yingkou	营口
Yan	嚟
Thế giới đầu tiên	天下第一
Hát	黚
Elson	爾森
Quần đảo	群島
mông	觝
đo lường	衡量
Chúa Trời	神
Zheng	崢
quan trọng	重要
giá đỡ đầu giường	桯
Zuo	祚
Thêm vào	增設
Làm tan biến	溶解
Nhịp	節奏
Xiang	湘
Concord	協和
đất sét khô	塥
Khí ga	加斯
Tàu đánh cá	漁船
Olympic	奥林匹克
Chiết giang	淛
tham số	參數
Lá giữa	中叶
Cây	植株
Đối với Áo	為奧
Bộ này	這套
thay thế	後補
băng qua	橫過
Dân dụng	民事
La mắng	诎
nhà khách	招待所
Li	浬
bố	爹
Sẽ làm	會的
Liên kết	領展
Chống lũ lụt	防洪
Trước	歷屆
buồn	怆
Nói	說文
Ying	鎣
vẫn	静止
Đáng kể	大幅
Kho chứa nước	蓄水量
tính hợp pháp	合法性
xúc phạm	贬
Lượn lờ	蠕
Tay đen	黑手
Quá khổ	超大
tương đối	相对
Xia	霞
đi bộ	走路
tiền đồn	前哨
Gaozu	高祖
Khối lập phương	方塊
nói nhảm	嘮
các môn thể thao	竞技
mưa rơi nặng hạt	雱
liên doanh	合资
Giả mạo	氓
Roi da	掄
nông thôn	乡村
Yuyao	余姚
bức tượng	雕像
năm này qua năm khác	逐年
Bảo vệ	親衛
Sorties	架次
Mờ dần	衰落
A	甲
锽	锽
Tập thể dục	练习
gừng	薑
nghẹt thở	噰
Có hạn	限量
Yang Guo	楊過
Ba lớp	三層
Kéo dài	跨
Tính đặc hiệu	特异性
Phòng bắt giữ	捕房
Công	硂
Pha trộn	摻
đất ngập nước	濕地
Anh ấy vào	他進
phương sách	度假区
Lý thuyết số	数论
Giải nhất	一等奖
sự đổi mới	革新
Tế Nam	濟南
bí mật	機密
Đời sống	人壽
phần mộ	塋
lũ lụt	水灾
Dọc đường	沿途
Tình huynh đệ	博愛
Nói	說道
lữ đoàn	旅长
Được áp dụng	適用
Vội vàng	殱
Zhan	詹
Răng nanh	昉
Khoa	学部
quý giá	宝贵
Quy định	规定
sự bành trướng	擴張
Trước cửa	门前
lo	愁
Mùa	季节
xí nghiệp	企业
chất xơ	纤维
Thứ hai	次之
Khiêm tốn	蹒
xem	看出
Trình duyệt	瀏覽器
Zhu	踼
Chiếm lấy	俘获
Annie	安妮
Trước mặt	戰線
Miriam Yang	楊千嬅
Nhón chân	跕
Feda	費達
Reaper nghiệt ngã	死神
quả thận	腎臟
Suy thoái	低迷
Washington	华盛顿
Vương miện hoàng tử	王储
bánh ngọt	糕
đổ	挹
Tonghua	通化
Con trai	個兒子
Cồn thuốc	酊
Hàng đầu	榜首
Bất động sản cơ sở	基地產
Ziyang	紫阳
Về quê	歸鄉
Cặp mạnh mẽ	強對
Được soạn bởi	编制
Shixie	石硤
Sau khi nó xảy ra	發生後
Jiao	蟛
tuyến tiền liệt	前列腺
Luật phổ biến	普法
Hiệu suất	业绩
hẹp	狹窄
Điều này	這
từ nguyên	词源
Nội dung	內容
Hoàng đế	元帝
khác giới	异性
thoát khỏi	摆脱
Trừng phạt	誅殺
giữa các vì sao	星際
Austin	奧斯汀
lý do	道理
Giấy bạc	箔
hai	貳
Hai phòng	兩間
ảnh hưởng	影響
đi dạo	遛
Nước Lào	寮
nhà ở	住房
Hai đầu tiên	首兩
Zhang	張
Sâu	蠽
câu đố	谜
trương hợp đặc biệt	特例
Maw	鮍
Và sau	與後
Bước vào	步入
Thoát nước	沥
Zhaoqing	肇庆
bỏ tù	圄
Đặc vụ	代理商
Pang	龐
Liangguang	两广
Xu	盱
Bragança	布拉干萨
Tín hiệu	示意
Stie	史提
Ấn-Âu	印歐語
Cuối thời nhà Minh	明末
Mặt tốt	好手
Chăn nuôi gia súc	畜牧业
đơn độc	孤
Netizen	網民
ngưỡng cửa	柣
Masamune	政宗
phân loại các cuống bói toán	揲
cây rơm	壟
Người bắn súng	射器
Đầu tiên	首
Lucas	卢卡斯
đế chế La Mã	羅馬帝國
Xiang	薌
Pháo đài	堡
Đến	来
Thuyền	舫
Thúi	腐
Rực rỡ	豔
Morgan	摩根
là đúng	是對
mùa thu	秋季
tính cách	氣質
Thuộc về	分属
Times	次
Kẻ huỷ diệt	驅逐艦
người Trung gian	中介
Tujia	土家族
chín mươi	九十
Tổ chức	宪
Hồng	閎
Bảo vệ chống lại	防
Hu Zongnan	胡宗南
Con Ốc Sên	蜗牛
Lề đường	路旁
rùa	鱉
xếp hàng	陣容
Phong cách	風格
Zhao	赵
Hà nội	河內
phản đối	抗議
Ontario	安大略
kỳ dị	古怪
Ông chủ	博斯
Tây An	悞
Vùng cơ sở	根据地
Điều dưỡng	护理
Akita	秋田
phanh	閘
Hoàn thành	实现
Cảnh sát	警務
Xuống biển	入海
Hoa trà	山茶科
bánh ngọt	粑
Hinder	阻礙
Và cùng một lúc	並同時
vào buổi chiều	下午
phản chiếu	反映
mật ong	蜂蜜
Cục giao thông vận tải	交通局
chân	英尺
Số Pi	伕
Ying	湥
kim cương	鑽石
Gạo nếp	麷
sắp xếp	安排
Shidan	時擔
cái khiên	屏蔽
Điều tốt	好事
hung dữ	兇
đặt thành	定為
bánh xe	車輪
đứng lên	起来
Ahma	艾哈迈
Khổng lồ	绝大
ranh giới	垓
hoàn thành	蒇
Thiên kiến	偏见
niêm phong	封印
ký tên	簽
Ôliu	橄
Chỉ ra	指出
Xiangjiang	湘江
quạt	搧
Sau đó	則在
Hỏi	搵
gấp đôi	雙
quân đội	陸軍
Tus	图斯
khu vực	沃德
EUR	欧元
Hotan	和田
bác bỏ	反駁
Cá	魚類
Hiệp sĩ	爵位
Vận tải hành khách	客运
Cánh đồng	該場
Ra tù	出狱
Nagao	長尾
chủ nhân	所有者
Venezuela	委内瑞拉
Shan	驘
đội	队
anh hùng	英雄
Chọn	摘
Diễn viên lồng tiếng	聲優
Biển báo dừng	站牌
Một đất nước	一國
đạo Hồi	伊斯兰教
Vượt qua	過關
Xi	岥
Người Thanh	清人
Hui	翚
Síp	塞浦路斯
Ya	伢
Thêm vào	相加
Yonan	與南
ánh sáng	灯
Tòa nhà	该楼
cảng thương mại	商埠
vật chất	材
Giám đốc bộ phận	司司長
Giải thưởng nhân vật chính	主角獎
bảo đảm	確保
Đầu máy hơi nước	蒸汽机车
Lai	崍
Jingtai	景泰
Yun	芸
Ghé thăm Trung Quốc	访华
Diễn viên phụ	未成年
còn lại	遺骸
đúng tiến độ	如期
Kinh doanh	營業
Ji	霽
Gạo nếp	糓
luật sư	律師
Thị trấn mới	新城
và cái này	而這
Jian	梘
Neil	尼尔
âm thanh	聲
Mạch máu	血管
Nia	尼亚
nâng cao	餤
Người Hồng Kông	港人
Hu	祜
một triệu	一百万
sẽ ảnh hưởng	會影響
Rừng nhiệt đới	热带雨林
Khoa hóa học	化学系
Yilan	宜蘭
gì	什麼
Rein	輰
mang mối hận thù	柸
Bộ trưởng ngoại giao	外长
Chagatai	察合台
lỏng lẻo	松
hội đồng	事會
Xe cộ	辆
đất sét	粘土
vịt đực	德雷克
viện trợ nước ngoài	外援
phòng khám bệnh	诊所
David	戴维
Chất kiềm	鹼
Đường sắt điện	電鐵
Cắn	啮
Chưa quyết định	未定
ngưỡng cửa	檻
Tiêu đề	片頭
hợp nhất	合併
Hafnium	擪
Đối với quốc tế	為國際
phục kích	伏兵
Nói	來說
Phải	须
Dinh thự	公館
Khởi phát	发病
La Liga	西甲
Kiệt sức	殆盡
Wang's	王氏
Mặt hàng	個項
mang đến	帶來
Phiên hiện tại	當屆
Trung thành	忠
nơi	斑点
Tích trữ	夛
Cách mạng Văn hóa	文革
giá trị	价值
Và máy móc	與機
bền vững	持久
hữu nghị	誼
United Star	聯星
tham nhũng	貪污
Dongsen	東森
hướng dẫn	指導
Lời nói hòa bình	和谈
nước biển	海水
se se lạnh	凊
hai trăm	兩百
Công tắc điện	掣
Thẻ vàng	黃牌
vĩ độ	緯
nghị sĩ quốc hội	众议员
Xây dựng đô thị	城建
Đẩy lên	撖
thể dục	體操
Kun	琨
Đấu thầu	招标
không gỉ	不锈
Ya	涯
Khu vực	片区
Niger	尼日
Yan	湨
lạ lùng	陌生
Đài Loan độc lập	台獨
tiếp nhận như một vị khách	迓
Tiêu biểu	代表性
Tấn	恂
đồ thị	圖表
Thị trấn phía bắc	北镇
từ chối	衰
Hưng thịnh	興盛
thuốc kháng sinh	抗生素
Airport Express Line	機場快綫
Thay đổi	之變
Ji	姞
Ôm	橂
Thiên nhiên	本质
Trận chiến	戰役
Gorgon	芡
Thanh Hải-Tây Tạng	青藏
Một lát sau	後成
Vượt qua	渡過
Metropolis	都會
họ	牠們
Sun Liren	孫立人
Trong Xu	在許
Sao đôi	双星
Trang bị thêm	改造
án tử hình	死刑
Dệt	织
Torreya	榧
Âm	甏
Lồng tiếng	配音
Hui Di	惠帝
phần phía sau	后方
Làm	製作
quan hệ ngoại giao	邦交
toàn bộ	整个
Khóc	嘥
Nam Sa	南沙
thử nghiệm	審訊
dưới nước	水底
sự ion hóa	電離
Trang điểm	補
Cái này	這個
tài giỏi	高明
Y khoa	医科
Được thuê với tư cách	聘為
Phát sóng trực tiếp	直播
Silesia	西里西亞
Shao	紹
nướng	烘
Changhe	長和
Di chuyển thủ đô	迁都
Mở	开来
đấu với	與
Nghịch ngợm	匦
tế nhị	微妙
Bình minh	曙光
Lạch nhỏ	小溪
Lực lượng	原力
Mở ra	開業
Lực lượng	作用力
cá ngừ	鲔
Quay	自旋
cá kiếm	剑鱼
Đảo	特島
Xiu	柭
Danube	多瑙河
bão táp	风暴
Trên bầu trời	上空
Tình nguyện viên	義工
lốc xoáy	氣旋
Thani	塔尼
Sel	塞勒
Mạng truyền hình	电视网
Chi nhánh	支系
Bản địa	土著
chương trình	节目
Nhà sư	和尚
Malta	马耳他
Ren	壬
Hồ bơi	泳池
hiếp dâm	强奸
Ueno	上野
Họ trúc đào	夹竹桃科
phần mộ	茔
Nhà truyền giáo	传教
Chấp nhận	納為
vận chuyển nước	水运
Phòng thiết kế	设计局
Bừa bãi	大肆
chuyến đi	蹚
phun ra từ miệng	噀
Sách chính chủ	主簿
Sway	聨
Lang thang	徘徊
Albania	阿尔巴尼亚
ủng hộ	支撑
Than phiền	訴
lựa chọn thay thế	替代品
Kiêu ngạo	觮
sơ cứu	急救
Cơm	水稻
Mặt nạ	口罩
Vùng biên giới	邊疆區
Tuyến Tseung Kwan O	將軍澳綫
Lizana	利桑那州
Ou	瓯
không hài lòng	觖
New York Yankees	紐約洋基
cao bồi	牛仔
Chắc chắn rồi	绝
Altai	阿尔泰
chủ tịch	總統
Gỗ	伍德
Tổ chức	主机
Thánh địa Etienne	圣艾蒂安
xử lý	手柄
Ve áo	襟
Lu	祿
Máy quốc tế	國際機
Fubon	富邦
Diễn viên phụ	小调
chim bồ câu bằng gỗ	鵓
cây rơm	埂
Bậc thầy	有主
báo thức	警報
con bò cạp	賧
uranium	铀
Phần còn lại	残留
Để đặt tên	來命名
Âm	琀
Liên minh Châu Âu	歐聯
ánh sáng vàng	金光
Ding	燢
Cha mẹ	家長
Bị phá hủy bởi	毁于
Taibai	太白
Là	是個
sự ngộp thở	窒息
Cô đơn	鬩
hơi nước	蒸气
Nanyu	南語
Gian lận	詐騙
Busan	釜山
Goth	戈特
Thời gian	時任
Hàng rào	圍牆
sau đó	然後
vợ lẽ	妾
rung chuyển	搢
giai thoại	轶事
trung thành	荩
kết tủa	澱
Nghề nghiệp	入伙
Hoặc	要么
Thành lập	創立
Yi	翧
Tai	氹
Nói	謂
bất kì	任何
Quyết định	決
món thịt hầm	煂
Ghi chú	箋
Mạnh mẽ hơn	更強
sự chuẩn bị	预备
Deming	德明
Tên	取名
phục kích	埋伏
nhảy	舞蹈
Chân thành	挚
bán	售賣
Đẹp mắt	壮观
Khiêm tốn	忝
thực tế	实际
Công ty xe buýt	巴士公司
Ký tên	标志
Trang Chủ	住家
Tây An	奤
Gián điệp	斯皮
Lu	逯
bài đăng cho động vật kết nối	杙
thường xuyên	时常
Cấp dưới	下設
Lu	昩
Qi	虘
Nằm trong	在于
Princeton	普林斯頓
Chạm tới	達
Quyết tâm	慴
dấu vết	痕跡
Súng tiểu liên	衝鋒槍
lau	抆
bắn tỉa	洟
Huân	洓
một	壹
Hoa vàng	黄花
Yan	漉
Trực tiếp	實況
Phi đội	中隊
Jia	郟
tin đồn	詗
Kiếm ăn	覓食
ngốc nghếch	戆
Thành phố cổ	古城
xây dựng	建筑
cầu nguyện	祈求
tương ứng	相應
Friedrich	弗里德里希
Tránh	避開
thuật ngữ	術語
Đảng viên	黨籍
Tôn trọng như	尊为
Bộ phận chính thức	吏部
Tỉnh	什省
lạnh	寒
puck	冰球
Thấp	低矮
Hilbert	希尔伯特
Wai	崕
đội bóng rổ	篮球队
Su	蔪
Armstrong	阿姆斯特朗
Khu nam	南區
người ghi chép	隶
Bán	賣
Miao	澪
Wa	俤
Bực bội	愗
Áo	奥地利
Dweller	居者
Biệt thự	山庄
hội nghị thượng đỉnh	首脑
cống rãnh	畎
Greno	格勒诺
thậm chí nếu	即便
đời sống	生命
nếu	假如
Rani	拉尼
Đảng Công nhân	工人党
soái ca	元帥
ngứa	痒
Fu	軂
Phát triển	开发
Della	德拉
vui mừng	快樂
Ở lại văn phòng	留任
Georgia	喬治亞州
Chủ nghĩa hợp hiến	宪政
Nhón	搋
Trụ sở chính	总署
Tang	渃
Nicky	尼基
Bốn cách	四路
Ye	谒
không bật	中午
kết thúc	尾聲
Thành phố Đại Liên	大连市
góa phụ	鰥
Dừng lại	点站
Người giám hộ	護級
đầu lâu	頭骨
Khung	禎
Punk	朋克
độc lập của người Mỹ	美國獨立
Chải	栉
Cơ học	力学
hiện hữu	存在
trao đổi thư tín	對應
đạn dược	彈藥
phá vỡ	決裂
Kết hôn giữa các	通婚
Hai mươi sáu	二十六
hú	嚎
Di	娣
sản phẩm	勣
Về lúc	约在
Ryder	莱德
Số ba	叁
Alexander	亚历山大
Choáng váng	慪
phát sóng	播音
Cao nguyên	高地
Thuringia	图林根
hẹp	褊
Tỉnh hà nam	河南省
Jensen	詹森
Cô ấy là	她為
Ai sẽ	者將
Ada	阿达
người quen	相识
Lưu Đức Hoa	劉德華
đầm lầy	沼澤
quần áo nghiêm trọng	襚
Cuộc phiêu lưu	探险
Được	鑑於
Fei	霱
mối thù hận	讎
đưa cho	給
Cùng kỳ	同时期
thám tử	偵探
Đấu sĩ	鬥士
Zheng	郑
Thứ tư	星期三
bôi nhọ	衊
Liên tiểu bang	州際
phiên bản	版本
Bảy năm	七年
hệ số	系数
đứng lên	起來
Jiawu	甲午
thung lũng	山谷
Âm mưu	劇情
Park Jeong	朴正
Ở lạibình minh	待在黎明
lãnh thổ	版图
Li Yuan	李元
ô	伞
Và tham gia	並加入
Ương ngạnh	叛逆
Bu	蔔
Cuan	爂
Bất đồng ý kiến	分歧
chủ quan	主观
Thành phố Fukuoka	福岡市
số nhiều	複數
Lớp học đầu tiên	上等
Truyền hình cáp	有线电视
Vẽ tranh lên tường	塗鴉
Chú	叔父
ủng hộ	撐
Bắt đầu	萌生
của tôi	鑛
Điều này cho phép	這讓
Hoàng đế	皇帝
đất đá	硗
Subei	苏北
Kính thiên văn	望远
quần lót	衩
Khởi đầu	下手
Như	做为
bộ	集合
Shannan	山南
Nơi gặp gỡ	會場
Liên tiểu bang	州际
thêm nữa	进一步
Tốt bụng	样
Kháng cự	抵禦
Học	攻读
Shaoguan	韶关
Shan Xiang	山乡
cây kế	薊
Nhà kho	蜕
để họ	讓他們
váy	裳
Quận Hoàng Phố	黄浦区
Môi trường sống	棲息地
Cửa hàng	店家
háng	襠
đĩa	盘
Ngôn ngữ	语文
đề tài	题目
mới	新近
cái chày	杵
công nghiệp hóa chất	化学工业
Naples	那不勒斯
vài trăm	几百
Ở đâu	哪里
sự phá thai	流产
Trẻ	孏
đặc biệt	殊
Một hớp	巑
Chèn	插
Cô ấy đúng	她對
Chu	榖
Tongji	同济
Guoguang	國光
Xin	莚
Khu vực phí	費區
Wenshan	文山
Vòng	袢
Jie Quan	屆全
Augustus	奥古斯
Eda	額達
Vương miện của	之冠
uốn cong	弯曲
Li	蓏
Học tập	學中
Vẫn	仍旧
sau đó	之後
Valkyrie	武神
cơn lốc	強風
Lớn	為大
nhạc nền	主题曲
Đất đai	蘭德
Tháng sáu	儁
Cử nhân khoa học	學位
Rui	叡
Ngốc nghếch	蜲
bánh mì hấp	饅
Nhẫn	戒指
Tokyo	东京
Cô	姑
Linhai	临海
đứa trẻ	儿
thể dục	体操
cảm giác	轟動
Gửi đến	發給
Theo dõi	有轨
lau	抹
Xiling	西陵
Liên Chân	連戰
Cooper	古柏
Đáp lại	答复
Bigne	比涅
Gwangju	光州
Sada	萨达
Xia Wei	夏威
Kesi	克西
Ngoài luồng	停播
Tám người	八人
Đại học Jiaotong	交大
Vũ công	舞者
Tát	俇
Âm	耼
Hội chợ triển lãm	世博
phương châm	標語
Bài hát nhịp	刓
Christo	克里斯托
Nội chiến	内战
molypden	鉬
thiếu	匮
Điều lệ	包機
con trai	男孩
Loạt	系列赛
sự thù ghét	讐
Chuẩn bị	备
sự công nhận	承认
Gran	格兰
catalpa	楸
Tham gia	列席
phản động	反动
Hình nón	锥
Quận	縣份
Nagano	長野
hình dạng	形
Qi	麒
Thống nhất	統
Shao	礭
Cán bộ, chiến sĩ	官兵
Hố va chạm	撞击坑
trái	左邊
Thành phố Heyuan	河源市
dã man	野人
con châu chấu	螽
tính thẩm mỹ	美学
Miyako	宮古
Cố gắng hết sức	极力
Cao Pi	曹丕
ghét	怼
Bộ hình sự	刑部
Bắc việt nam	北越
Gao Ping	高平
Evergrande	恒大
Áo choàng ngoài	褛
hiếm hoi	罕
McDonald's	麥當勞
Chi nhánh	隸屬
Kennedy	肯尼迪
Mu	穆
chủ tịch	總裁
rửa	濯
Sojourn	旅居
Đầy hơi	臃
Vắt kiệt	拄
Mir	米爾
Thủ lĩnh	领队
yamen	衙門
Tàn tích	遺址
Người lao động nhập cư	民工
gặp gỡ	遭遇
Liên đoàn bóng đá	足聯
Xa hơn	較遠
mỏ neo	碇
mê tín	迷信
Xe đạp	自行车
Thần học	神論
uống	飲
Nhóm B	乙組
quả mọng	貝瑞
mẫu	格局
Và đông	與東
Vale	瓦勒
Và	並將
Luẩn quẩn	獰
Đảng tự do	自由党
Què	巛
đứa trẻ	儿童
con tằm	蚕
máy in	打印机
Dẫn độ	引渡
Lo âu	安溪
Khó xử	蔲
Đến	赶来
Thành tích	绩
Moo	唞
Định lượng	定量
Chạm khắc	雕
hành pháp	执法
độc	有毒
Clan	戰隊
Fraki	弗拉基
Tỉnh Gyeonggi	京畿道
Đưa vào	置在
Thích ca	释迦牟尼
lý lịch	背景
dép	屣
Tên viết tắt	聲母
Sức cản	抵抗
Ý định ban đầu	初衷
Chuồng	樗
Times	時報
Phật tử	佛教徒
flo	氟
Rác rưởi	垃圾
Smash	弉
đan lông mày	颦
Bóng bán dẫn	晶体管
Choáng váng	愙
giả thuyết	假说
Azerbai	阿塞拜
máy vi tính	电脑
rò rỉ	漏
va chạm	碰撞
Thái độ	態度
Yu	毓
nằm xuống	放下
Sốc	震撼
Thuật bói toán	占卜
Năm đầu	元年
Thường Châu	常州
Lộn nhào	挻
dốc	梯度
Nhớ lại	想起
Thai kỳ	妊
nghiêm khắc	嚴格
Chenghe	城河
Cá	撈
Chongwen	崇文
Kính hiển vi	显微
Buồn phiền	憇
Huh	唦
lưỡi	葉片
Xiu	魫
Rút tiền	撤出
Song ngữ	雙語
pháp luật tố tụng hình sự	刑法
luôn luôn	历来
Biya	比亚
Nhân sâm	蔘
có thể nhìn thấy	可见
Giẻ	褴
tốc độ	速度
Cứu hộ	救援
trêu chọc	撩
Đã chọn	选中
Ni	佲
Với	有與
Sông Kim Sa	金沙江
thực dụng	實用
Giới thiệu	推举
Odo	奧多
Đăng ký	認購
Bang đang chiến tranh	戰國
hạt dẻ	栗
ân sủng	恩典
Dãy núi Taihang	太行山
thoát khỏi	渫
Ngoại ô phía tây	西郊
Bị nghi ngờ	疑似
Xi	遰
Daying	大营
thiếu hụt hoặc khuyết	赤字
Pang	蒱
Ngồi xổm	踁
Lỏng lẻo	松散
Thảm họa	受灾
ủ	酝
Âm nhạc	音樂
Bước lên	踩
Đa dạng	各樣
Ngày thứ chín	初九
phía trong	內的
Lừa gạt	擶
Tong	浼
citron	橼
Chi nhánh	分支
lau	搌
Đặc khu	特區
bờ biển	灘
dẫn đầu	主導
xúi giục	唆
hội đồng	理事會
Háu ăn	餣
Sai lầm	錯
Chim	悫
hamadryad	狒
Tập Cận Bình	习近平
Trạm kiểm soát	编组站
zhu	柷
Song Zhe	宋哲
Ngồi xổm	儎
vài năm	幾年
Học hỏi từ	師從
gọn nhẹ	緊湊
Quay	纺
nấu bia	酿造
Nhạc khiêu vũ	舞曲
Afu	阿富
Không dễ	不易
Trục	軸心
Phương pháp này	此法
truy cập	存取
nồi nấu kim loại	埚
xử lý	柄
hẻm núi	峽谷
huyết tương	等离子体
Eisenhower	艾森豪
Ếch	鳬
sản xuất tại	產於
Nói cách khác	换句
Stan	史丹
ngu Google dịch dở	镭
thuốc tiên	酏
động kinh	癇
Máy bay ném bom	炸機
Shu	舒
Bảo mẫu	褓
Shaq	沙克
Chì	牵
bộ sưu tập	徵收
hồi phục	光复
Tháng sáu	濬
Thủy phi cơ	水上飛機
bình minh	旴
rùa	鳖
Nhắc lại	重申
nấu ăn	爨
Trang	佩奇
Hiện tại	呈
sân bay	机场
Hesse	黑森
Hương	香火
tê liệt	痹
kích thích	刺激
Shao	绍
Cà vạt	逰
vào ban đêm	夜間
Marshalling	编组
Bama	巴马
Thiết bị	器件
Ye	榙
Shizuku	雫
Xương ảo	虛骨
nghìn tỷ	兆
Lệ Giang	丽江
Lịch sử văn học	文学史
Ivan	伊凡
琎	璡
tuổi già	衰老
caldron	甑
Còng	髢
Sống lâu	萬歲
Văn phòng tổng hợp	总办
Hộp số	齿轮
Shipai	石牌
Một tháng	一個月
Viola	堇菜
Có lông	褎
Biển vàng	黃海
phi lý	谬
Ngỗng hoang dã	鴈
Quốc tịch	国籍
Barbara	芭芭拉
khối	挡
Bộ tứ	四重奏
Sáng	耀
thổi	吹
Hai	兩
Nơi cư trú	寓所
Chuồng lợn	猪笼
Fuzhi	府志
Luân phiên	候補
Indiana	印第安纳州
mở rộng	延伸
mẹ	母亲
Điện thoại di động	手机
kê chung	粢
kết quả của	的結果
Chủ nghĩa nhiệt đới	向性
Oscar	奥斯卡
gặp gỡ	會
Kem phủ lên bánh	釉
Eisen	艾森
Văn phòng	務所
Tịch thu	缴获
Đề tài	專題
Quận De	德縣
Tranh giành quyền bá chủ	争霸
người môi giới	侩
Đôrêmon	哆啦夢
Arp	阿普
Chim vàng anh	鹂
Âm	荺
Castro	卡斯特罗
Khung	祯
nốt ruồi	鼹
giật gân	溅
Loạt	连续剧
điên	狂
hướng dẫn	指导
Móng tay	指甲
Vắt kiệt	搲
Điện khí hóa	電氣化
Bộ trưởng trung thành	忠臣
Ngoại hối	外匯
Gentry	士族
Thống đốc	省长
Người israel	以色
lấp lánh	爍
đúng giờ	時間內
Trung tâm về phía trước	中锋
giống như	同於
Tóm lại là	结论
Được liệt kê là	列为
nghệ thuật	美术
Yucai	育才
Zhuo	篏
Sự thông minh	情報
tiết lộ	揭示
tiếng ồn	噪
Brittany	布列塔尼
thoát ra	澌
Tây An	蟇
mưa bão	霣
Của tôi	礦場
Sebasti	塞巴斯蒂
mệt mỏi	殢
Gọi nó đi	称之为
cái nhìn	睞
Vượt qua	过
Zhu	篭
cấp lãnh đạo	梯队
Thị trấn	該鎮
Bỏ cuộc	口鼻部
Kết hôn	嫁給
Được hỗ trợ	為輔
lo lắng	急
Giám sát	監管
bánh mỳ	麵包
Nicholas	尼古拉斯
Bột giấy	漿
tiền giấy	钞票
Giàu có	里士
Hừ hừ	哼
chuyên quyền	專制
không gian	空间
Xu	訏
rút ngắn	缩短
lái xe	帶動
số ba	三
Câu lạc bộ thể thao	體育會
Jiong	炅
kích hoạt	激活
Ụt	壆
Chạm khắc	彫
Phép tính	運算
Madu	马杜
Rải rác	散館
tia chớp	閃電
Soochow	东吴
nốt ruồi	痣
Triều đại	皇朝
Shi	輊
quỷ lùn	矮人
Minato	港区
con sông	江河
Hằng ngày	日日
Một cách bất cẩn	不慎
Lan tràn	蔓延
trêu chọc	嬲
Hãy học	讓學
Phiên dịch	译
lẫn nhau	相互
Con nai	荵
sao Mộc	木星
Hollywood	好莱坞
Thiền sư	禅师
Ghen tuông	遢
Cửa xe	车门
nền tảng	础
Bondi	邦迪
đại sảnh	廳舍
Học khu	學區
Barb	鲃
Quãng tám	八度
cá tầm	鳇
Treo	珩
đề tài	題目
Ấn Độ	印地安人
dẫn đường	導航
vô tội	无辜
Rudolph	魯道夫
Tháng sáu	椚
nút bần	科克
Ấn tượng tốt	好感
Ti	媞
hiếm hoi	罕见
Và sẽ	而將
vải lanh mịn	緦
Câm	倝
thông thường	平时
hệ số	因子
từ trường	磁场
Trước kia	前為
giảng viên	講師
Thua	虧損
King Kong	金剛
Pakistan	巴基斯坦
Lối vào hang động	洞口
Hiện có	現存
Săn bắn	捕獵
Thế hệ	生代
bực mình	生气
Thị giác	视线
sức ép	压强
Tin tức	資訊
lửa	熛
Âm	瀷
căn bản	部首
Toyotomi	豐臣
piebald	骓
Đàn anh	长老
Viên	球團
Bún	甶
Lớn lên	生長
điện giật	電擊
chó dại	猘
Nói	讲述
Fontan	埛
Lá cây	葉
chế độ ăn	饮食
khoe khoang	诩
Tóm lại là	結論
Trở thành một vị Phật	成佛
Helen	海伦
Xây dựng	廈
Robert	羅伯特
lực sĩ	运动员
bẻ cong	抝
Ying	瀛
Hy Lạp cổ đại	古希腊
Ngã	下跌
Gà trống vàng	金鸡
Triệu	萬人
tiền lương	薪
Li	嬇
Đông Ấn Độ	东印度
hiện hành	現有的
Nhân nhượng	綏靖
Maine Loire	曼恩卢瓦尔省
đấu tranh	奮鬥
Tường	墻
Lỏng lẻo	寬鬆
Sóc	鹯
khỏe	精
Tim mạch	心血管
Lễ tạ ơn	感恩
Cuộc đua	人種
Tuyên truyền	宣傳
Nhân dân tệ với	元配
An Ren	安人
Như	作为
đến	到来
Số phận	他命
Hệ thống trường học	学制
Nghỉ ngơi	憩
Sâu	顦
Bùng nổ	景氣
làm sao	怎樣
giám đốc	主任
thoát ra	爆发
quả thận	腎
Kinh điển	經學
Phong cảnh	景物
Miao	牕
Hawke	霍克
Chương trình này	此劇
giải cứu	抢救
ca sĩ	歌手
Dianzhen	店镇
chiều dài đầy đủ	全长
Đông người	擁擠
Shao	嵙
bờ Nam	南边
đói bụng	餓
Yi	渉
đơn giản	简
Màn	屏
Dệt	编成
giám sát	監測
Chưng cất	蒸馏
Hiện tượng thiên văn	天象
Taikoo	太古
Ghi chú	注意
Ban Công tác Mặt trận Thống nhất	统战部
May thay	幸得
Đàn áp	勦
Xung quanh	一带
đế chế	帝國
dịch	流体
Sự bắt chước	仿制
Y khoa	醫
Tốt	俾
giống như	同于
Yan	瀼
Lính canh	卫军
Thực hành	力行
Trái cây	波尔
Sôi lên	疒
Trích xuất	抽取
muốn	通缉
Shimen	石门
điều này	這位
Cùng với	也與
Nanxi	南溪
Trung Quốc ở nước ngoài	侨
Máy điều hòa	冷氣
người kế vị	接班人
Đảo ngược	逆向
nghĩa hẹp	狹義
chính ủy	政委
Mel	梅爾
Guadara	瓜达拉
Hội nhập	整合
Bocheng	伯承
Thủ môn	門將
theo chiều dọc	豎
Chi	袀
Sinh lý học	生理學
Grebe	鷉
phân loại như	歸類於
Âm	馑
Yi	丂
hội chợ đền	庙会
Wan	暓
Zhuang	壮族
Galle	加勒
của chúng tôi	們的
Thơ	詩歌
Yu	苰
Đến Trung Quốc	来华
iridium	銥
Đỏ tía	勃艮第
Hệ mặt trời	太阳系
Biện hộ	倡導
cho	替
Bệnh máu	血症
khăn xếp	襆
Bồi thẩm đoàn	審團
kế bên	旁边
Thương vong	死傷
Vận tải hành khách	客運
trứng cá	獐
Toàn bộ hành trình	全程
Li	橞
dẫn đầu bởi	为首
Câu lạc bộ đua ngựa	賽馬會
Thường sử dụng	通常用
lạ lùng	奇怪
Đối với Châu Á	為亞
nhiều màu	缋
dap xe	骑
Dương	鱚
Chủ yếu	為主
đa dạng hóa	多樣化
đồng hóa	同化
Pinghu	平湖
Lịch sử	史学
Sách	成書
dự trữ	後備
Ming	洺
quạt gỗ	翣
Sưng lên	膨脹
Cát	沙地
xuyên qua	通
Chân	足目
Là một giáo viên	為師
Zhan	鄣
đỏ bừng	酡
Ba vương miện	三冠王
Württemberg	符腾堡
quần áo	服
Qi	玘
tỉ lệ	鳞
Thêm vào	墕
Bray	布赖
Merlin	梅林
đầu lâu	髏
Bengbu	蚌埠
bộ xương	骷
theo chiều dọc	垂直
Xi	濙
cây con	秧
tối	晚间
Lu	潸
Hình ảnh	画面
Người nổi tiếng	知名人士
Poly	保利
Con gái	女兒
Li	橥
Grebe	鉷
NATO	北約
Tiêu Sơn	萧山
Anthony	安東尼
Đình công	纷争
Matsumoto	松本
Giá cả	耗費
Cục tình báo	情報局
phía đông	东方
Đuôi	尾端
Aragon	阿拉贡
chuyến thăm	逛
Dây điện	線電
đã nói	輻
Tỉnh	該省
Có lông	軞
Con đường cũ	老街
Tây Nhật Bản	西日本
Truyền về phía	投向
Người Đài Loan	歌仔
Lu	淥
khuôn	黴
cánh quân	犄
Gia hạn	热内
Một	一
Hạ gục	擊出
Ao	水塘
dấu ngoặc	支架
Jin	瑾
Y khoa	医
Trường học	校舍
Chris	克莉絲
Nhà thầu	承建商
Khói	菸
Thiếu lâm	少林
ô lớn cho quầy hàng	簦
Sau giờ làm việc	工後
Bao vây	圍攻
lời bài hát	歌詞
Sự khác biệt	相差
Laplace	拉普拉斯
Dân chủ Congo	剛果民主
mù	盲人
Ira	伊拉
lật đổ	推翻
Thực tập sinh	学员
Yu Mei	於美
Một vài ngày trước	日前
nghiêm trọng	嚴肅
Cá đối	鎻
dầm ở mái hiên	梠
teo	痿
Meri	梅里
dựa vào	依赖
Cục bướu	藞
Trọng lực	重力
TV thu phí	費電視
Đã chụp	被俘
thở ra	虖
Ai	墤
Hural	呼拉尔
McKinley	麦金莱
Rái cá	奥特
đảng phái	党派
hiệu suất cao	高性能
Gao	泑
Siku Quanshu	四库全书
thời gian	時刻
nhà sinh vật học	生物学家
Ít khi	極少
Trên đất liền	陸上
giới thiệu	推薦
Fran	弗朗
Sử dụng phòng	用房
Ji	璣
đàn bà	婦
Osuke	大佐
Nho giáo	儒家思想
phía Nam Carolina	南卡罗来纳州
thể lực	体力
Tình yêu lớn	大愛
ngày	枣
Tiểu sử Han	漢傳
Xóa sạch	全歼
Meishan	眉山
Cộng sản	共产
Dacheng	大成
sốt rét	痁
Đối với đất	為陸
Mười nghìn bảng	萬英鎊
Hợp lý	正當
bãi đậu xe	停車場
giữa các vì sao	星际
Muối axit	酸盐
Hai	兩部
bông mịn	纊
Chặn	堵
Đội bóng đá	足球隊
Dựa trên	為基礎
Làm hai	成兩
sự thiếu	荒
Dẫn đầu	率先
Gang cá chép	綱鯉
Dần dần	日渐
sự phối hợp	協調
sự ưu tiên	优先
Áp phích nhân vật lớn	大字报
Hàm Đan	邯郸市
Buồn phiền	凾
đầu máy diesel	内燃机车
phân phối	分佈
Người hướng dẫn	教官
đường thủy	水路
Vô hướng	标量
Sher	謝爾
Yuri	尤里
Moat	呠
Nóng bức	炎熱
Những bài hát được ưa chuộng	勁歌金曲
văn hóa	文化
Kinh tế học	經濟學
Pai	湃
Xingye	興業
cây	杝
Rong	嵘
Bận với	忙於
Chung	概
Bianjing	汴京
Ma Zi	馬自
Cây kim	针形
như là	这样
Hảo	郝
thí nghiệm	實驗
sốc	惊
cũng như	以及
đất son	赭
lưới lọc	笊
côn trùng	蝏
nghi ngờ	疑
Newyork	纽约
bất tận	無窮
Tự thiêu	自焚
Trẻ	雏
Gillen	吉伦
cây liễu	杨柳
Hu	寽
Toàn diện	综
phần tiếp theo	续集
mưa	雨
Trái	左侧
Sống sót	存活
Đĩa	磁碟
Qingyuan	清源
Rob	罗伯
gửi	发送
Tổng hợp	合輯
Quyền thành viên	員對
cột cửa	枨
Phòng hòa nhạc	音乐厅
Baidu	百度
Hoàng đế	鸘
tên khoa học	學名
Anh ta	祂
Shi	湜
Đánh bắt cá	捕魚
điều này làm cho	這使
Bảo tồn nước	水利
xoay	翻
không hợp lệ	無效
Nâng cao	更進
Xa	法爾
vận chuyển	转运
đệm	缓冲
mã	码
có thể so sánh	可比
từ	自從
Bể nuôi cá	水族
Quân miền nam	南軍
Cơn thịnh nộ	肆虐
Hàn Quốc	丽
nhiều	阄
xuất hiện	显现
Sammy	森美
Sauropods	蜥腳類
tạp chí	杂志
Shi Jingtang	石敬瑭
Phía sau mặt đất	地後
Trạm nước	水站
lò nung	窑
Fu	茯
Trang Chủ	故鄉
Không cần	無須
Mạc phủ Edo	江戶幕府
bóng ném	手球
cái vòng	箍
tấm màn	簾
Tin tức	新聞
Zhou Wuwang	周武王
Los Angeles	洛杉磯
Địa điểm	地盤
phanh	制动
Tai nạn	速成
Chống lại	兌
Tam tự	三自
Anh và Pháp	英法
dễ dàng	輕易
Jingwei	經為
Húng quế	罗勒
Tốc độ thấp	低速
tín dụng	功勞
Sơ cấp	初等
Hydrazine	肼
Kết hợp	编入
Sự hỗn loạn	乱
Yokohama	橫濱
Trần nhà	天花板
lòng bàn tay	掌
Bất cứ lúc nào	時隨
đứng trong sự kinh ngạc	戁
Sự đổi mới	創新
Tiếp thị	营销
Đã chọn lại	蟬聯
Huyền thoại	相传
Sierra Leone	塞拉利昂
Coccus	球菌
Pháo đài	堡垒
Leah	利亚人
Lên trời	升天
nghi ngờ	懷疑
NênNam giới	應當男
bạc	银
Ưu tú	菁英
phần nhỏ	分数
Vườn	庭園
súng lục	手槍
Vận chuyển đến	运往
khuynh hướng	倾向
lò nung	窯
Co lại	萎縮
Canaan	迦南
Sting	螊
Nhón	夾擊
cuộc tổng tuyển cử	普選
học sinh	瞳孔
lời hứa	諾
Bơi	游泳
Uy tín	知名度
bị thương	负伤
Sáng	璩
Rơi vãi	落差
giao banh	服侍
Ngập	充斥
năng lượng	精力
Giới trẻ	年人
Jerusalem	耶路撒冷
Quảng đông	粵
Hinder	阻
kỷ nguyên	时代
Hiện tại	在現
Đồ dùng	器皿
Hợp nhất	整併
Cistanche	蓯
Maha	马哈
Vị trí	外景
Kaka	卡卡
Dừng lại	阑
Xiao	肭
Enke	恩科
phiên bản mới	新版本
chân trời	地平線
berili	鈹
Một lần	一次
Phía dưới	低于
mờ nhạt	昏
Ký tên	標誌
than vãn	啕
Nhiêu bác sĩ	醫生
Lỗi thời	过时
mendelevium	钔
Nitrat	硝
Malaysia	大马
Sên	蛞
Tần	钦
đế chế La Mã	罗马帝国
蒉	蒉
Khó xử	烞
ngày lễ	假日
Ollie	奧利
Lạc Dương	洛陽
Ou	甌
Tội lỗi	匏
Thời gian	时任
con đường	路徑
Phun trào	喷发
Đăng ký	寄存器
phát sóng	轉播
Đẩy lên	撏
Chiến dịch	競選
Li	頬
dạy	教
Sớm hơn	較早
Quân đội Đức	德军
phòng thủ	保衛
củi	柴
đến	到來
Thành phố và Quận	城縣
có thai	懷
Khoe khoang	騷
kéo ra	挈
bán đảo	半岛
Cạn kiệt	出奔
Được ghi là	錄為
Bang Washington	华盛顿州
Ủy ban cải cách	改委
Trận đấu	賽對
Ngoài ra	另外還
sân khấu chương trình	舞台剧
rượu mạnh	醲
Đi về phía trước	出面
phong kiến	封建
Qi	汱
gọi	称呼
Cùng lớp	同班
Áo ngực	卜拉
con bò cạp	貜
Nhiều thứ khác nhau	流形
bộ	集
Răng nanh	犬齒
Tên	名称
Huh	唰
Thẻ căn cước	身份證
óc	脑
Tỳ kheo	比丘
ký sinh	寄生
Chín năm	九年
Thu hút	引來
Quý Châu	贵州
nịnh nọt	諂
Cuộn	罗尔
scrofula	瘰
Điểm	點則
Thực ra	竟是
Liyou	立有
Đá	踢球
hydro	氫氣
phải	必須
ngành công nghiệp	工业
Xúi giục	冔
Myanmar	緬甸
Sâu	蠖
Châu Úc	澳洲
bệnh sốt rét	瘴
Kui	隗
Tại chỗ	原位
dã thú	獸類
Và sau	及後
Lenin	列宁
Chúc mừng	祝贺
tách rời	分开
Bởi hai	由兩
chu vi	周长
Vượt qua	峠
đạn dược	弹药
Sẽ gặp	會會
Bán	售
Mười nghìn	万
Nổ	爆炸性
Wei	鴅
trang viên	莊園
Quân sự	軍務
Rơm rạ	稭
Wehrmacht	国防军
Si	驷
cái kén	繭
Xây dựng	打造
Chechnya	车臣
Nghịch lý	悖
Sau đó	那么
Người giữ	保持者
Trạm Giang	湛江市
Robin	鸲
Dinan	迪南
Báo cáo	報道
Cải cách chính trị	政改
trường tư thục	塾
Barton	巴頓
Tây Sa	西沙
Li	汧
suốt cả năm	終年
lực lượng	强迫
Giảm bớt	缓和
ghê tởm	厭惡
Đảo ngược	反向
chấp thuận	验收
Dựng lên	架設
Qingyu	青嶼
năng động	动态
Cái gối	皮洛
Bị nghi ngờ	涉嫌
đất dưới tường	壖
Mặt trống	空手
than chì	石墨
Nổ	突發
Hu	斛
Đi học	就學
Trên tay	手上
Địa chỉ	位址
Ý nghĩa	內涵
Trường học	學園
thuyết tương đối	相对论
dịu dàng	绅
Bộ chỉ huy quân sự tỉnh	省军区
hợp đồng	合約
Tongzhi	同知
Tôi	亹
hiện tượng	现象
Cực lớn	特大
Walt Disney	華特迪士尼
ống kính	透镜
Chân dung	肖像
Giữ	搣
Trong	的進
Yamazaki	山崎
Covet	觥
Rắc rối	惎
Hạm đội	車隊
Kết án	判刑
cây mây	菶
bán sỉ	趸
Phổ biến	人氣
nhỏ giọt	淌
纴	躴
Nuss	努斯
Đặt vị trí tại	设于
Đạo Do Thái	犹太教
chuộc lỗi	贖
sóng ngắn	短波
thảm thực vật	植被
khe núi	巇
Định mệnh	天命
không xác định	不得而知
Quan thoại	鳜
người phụ trách	館長
thán từ	欹
Oh	喔
Làng	村子
Trùng Khánh	重庆市
kang	炕
Chúa tể	领主
nghiên cứu	科研
Đặt thành	设为
Diaspora	侨民
Xử lý	应付
cửa tiệm	舖
Tiền nhiều	重金
Purine	嘌呤
Ha guc con thu	追捕
Thành phố thẩm dương	沈阳市
Cốt lõi	蘂
Rào	椛
Poser	波塞
tươi	鮮
phim ảnh	胶片
Quy định	法规
Zai	繧
Ly thân	失散
Xiaoxiwan	小西灣
nông nghiệp	農業
Hoài	淮
châm lửa	焌
Bạn	莜
con bò cạp	螐
Francis	弗朗西
Trên đường	道上
Âu-Á	歐亞大陸
Cắt ra	圉
Ủy ban quân sự	軍事委
Erioformes	鮋形目
chúng tôi	我們
Thần Zeus	宙斯
Hóa học hữu cơ	有机化学
bốn mươi ba	四十三
Longi	隆基
Tàu thuyền	舯
Răng nanh	鞡
Kesen	克森
ghế	座位
Lột vỏ	皮尔
Từ vàng	金字
Jiahe	家河
Nhóm	該組
Toàn bộ	的總
Giám đốc nhà máy	厂长
máy tính để bàn	桌面
Đánh giá phim	影评
Lánh nạn ở	投靠
Reel	轆
quyền lực	强大
Mang	搭載
Khuyến khích	推广
Biển trung quốc	中國海
Konishi	小西
hàng đầu	顶端
xe ngựa	輅
Xuyên qua	穿过
Xem	見到
Tường bên ngoài	外墙
nút thắt	紇
Không sợ hãi	无畏
Yuanming	圆明
Khó xử	怩
Được bao quanh	包围
Thành phố mùa xuân	春市
Đã kết nối	相连
Ngâm	醪
amoniac	氨
Năm ánh sáng	光年
Chân	麓
hung hăng	猖獗
tàu sân bay	航空母舰
Raleigh	雷利
Hàng ngàn	數千
Biển phía Nam	南冰洋
Quyền hạn	管轄
Cấp độ	层面
Ong vò vẽ	黃蜂
khai thác mỏ	礦業
Anqing	安庆
sử dụng	使用
Nâng cao	推進
Bolivia	玻利维亚
Florua	氟化
Kwun Tong	觀塘
Báo chí	報章
kilowatt	千瓦
Rộng lớn	百老
Đổ	浇
Hầu tòa	出庭
Ảnh bìa	旐
ngôi đền	神庙
Một mục	一項
đường sắt	铁道
Thuế	稅務
Ni cô	甔
Khai Bình	开平
hiện hành	当前
Thành phố chính	主城区
Jersey	球衣
trớ trêu	諷刺
Hoảng loạn	慌
Pod	波德
Ngày 21	二十一日
Thương tiếc	殟
Cá áp chảo	盤魚
khí thải	發射
Nấu nướng	烹調
thuê	租金
Sẽ là	將以
Y	逤
Tỉnh Cát Lâm	吉林省
Ben	贲
Yasukuni	安国
Cơ quan ống	管风琴
Còng	枷
Tiểu bang là	國為
lờ mờ	暗淡
Moore	摩爾
Chết	滅亡
điều này	此
opera	歌剧
phô mai	酪
trong phòng giam	细胞内
Nhà khoa học	学家
Giang môn	江门
Tổ tiên	祖
thua	失去
Nguyên	原版
Cao đẳng kỹ thuật	工程学院
Dương xỉ tóc	毛蕨
Bí danh	別名
Adam	亚当
hơi già	老年
Minhe	民和
Người Thượng Hải	上海人
Mãn Châu	满族
đứa trẻ	童
Buổi họp thường niên	年会
Đề cương	纲要
Hội Sinh viên	学生会
gấu nâu	羆
Hiếu chiến	侵略
Hiphop	嘻哈
Joji	佐治
hành tinh	行星
Quốc tịch nước ngoài	外籍
ống khói	囱
hình ảnh	图像
ve sầu	螗
Chọn	採
Bao gồm	列入
đầu máy xe lửa	机车
chung	一般性
cỏ dại	菆
Puli	普利
Trước	从前
Yi	乀
kích thích	激发
Thiếu Lâm Tự	少林寺
Bồ tát	菩
Tasch	塔什
Vân Nam	滇
Chết trên	卒于
quân đội	軍用
Shaoqi	少奇
Tốt	嘛
Ngã	福尔
mạng tinh thể	棂
khách hàng	消費者
Nhiệm vụ đặc biệt	特遣
món thịt hầm	炖
Tiêu chuẩn	制式
người quản lý	管理人
Nửa dưới	下半
Học hỏi	有學
Đảng phái	偏重
Sanyuan	三院
nhân cách	個性
nhóm làm việc	工作组
Thời trang	时装
thiểu não	嚚
Một với	一個以
Tổ chức	主持
sử thi	史诗
thiền học	禪宗
bão táp	暴風
Dương giang	阳江
lớp học	階級
Bất chấp	不管
tổng thể	整體
họ	他們
Rafa	拉法
Quảng trường	广场
Đôi	雙打
Axit carbonic	碳酸
cái cổ	頸部
sự tan rã	解體
nịnh nọt	諛
tránh xa	遠離
Tấn	莍
Bầy đàn	众
Zhu	趒
Từ chối	赤緯
Hắc Long Giang	黑龙江
Morris	莫里斯
sâu	深处
liều lượng	劑量
bọng đái	膀胱
Shi	轼
Ngành thủy sản	渔业
Và vốn	與資
Tìm thấy một quốc gia	开国
đèn lồng	燈籠
Khu vực thang máy	舉區
người Ấn Độ	印度人
nguyên	原著
cesium	銫
sự dũng cảm	烩
Hơn	越
Lùn nâu	棕矮星
Phiên bản mới	新版
bỏ phiếu	票選
cây búa	捶
McLee	麥理
Nar	納爾
Xiushan	秀山
tích hợp	集成
Hồng	泓
Cái gọi là	故称
Nên	应当
Bệnh viện	病院
Nghe	聽到
Kịp thời	上時
Asashi	朝時
Chú ý đến	理會
Dài hạn	远期
Địa ngục	地狱
Thánh tích	遺物
Vội vàng	潲
Cháy	燔
lò vi sóng	微波
Sách	本書
Biến đổi	變量
Góc phần tư	象限
Frederic	弗雷德里
Mờ nhạt	澅
Âm	鞕
Từ chối	下滑
Siêu âm thanh	超音速
Ye	諤
Xia	呫
Sau khi đầy đủ	滿後
biên giới	边疆
Chen	宸
Nhưng đúng	卻對
Yan	焉
Caro	卡羅
táo	蘋
Bồ công anh	蒲公
gai	刺
dấu	唛
Shato	沙托
Đánh giá	評價
Máy móc	械
tên nick	綽號
Marley	馬利
Tỉnh lỵ	省府
Yi	泴
terbium	铽
Gunzburg	茨堡
tranh chấp	爭執
Yongding	永定
tóm lại	總結
Nối tiếp	連環
sự áp bức	壓迫
được bảo chứng	奥斯特
Đường Huyền Tông	唐玄宗
đồng ý	同意
thực dụng	实用
Hua County	化县
chất làm se	澀
đá phiến	石板
giáo phái	教派
cái khiên	蔽
Richeng	日成
Từ	从
đường sắt	轨
Qiang	羌
Độc lập	单机
khu vực	面积
Gọi chung	统称
Longjiang	龙江
Sáng	烱
Walla	瓦拉
United Airlines	聯合航空
Đã sẵn sàng	已
Một lát sau	後獲
chuyển khoản	移送
âm thanh của một vụ tai nạn	訇
vải	布
Ăn thịt	肉食性
Thở	呼吸
Anh quốc	乌克
Đặt theo tên	得名
khối lượng	弥撒
dầu	石油
Rand	蘭特
ngu Google dịch dở	鐳
Trò chơi	場比賽
Khởi nghiệp	創業
bộ phương trình	方程组
Cái nút	按钮
Theo thời gian	不时
Sau chiến thắng	勝利後
Thống đốc	州長
sẽ	遗嘱
Giữa và	間與
Ke	岢
chiến binh	戰士
Mờ nhạt	毳
liếm	舐
lái xe	驱动
Academia	學界
đường bang	国道
Xếp hạng lên đến	率達
Xếp hạng	收視率
Người dơi	蝙蝠侠
谳	谳
Bản nháp	選秀
Phong cách Nhật Bản	日式
ân xá	赦
Hutt	赫特
Nhẫn	环形
Hạt Yuan	源县
Wiz	維茲
Thực chiến	實戰
chiến binh	武士
Nhẹ hơn	較輕
kết hôn	媾
Đường Queen	皇后大道
sự can thiệp	介入
cầu	橋樑
Mới đến	传入
khóa học	历程
thịt	肉類
trước đây	前者
Thẻ căn cước	身份证
chờ đợi	期望
bọ chét	虼
chỉ bởi may mắn	儌
con số	数
Chiến công quân sự	戰功
chủ đầu tư	投資者
công thức	式
Xâm phạm	违
Hủy diệt	歼灭
mái hiên	簷
Chắc chắn rồi	絕
Tinh thần	心態
Bài học	讲学
Máy khoan	鉆
Sự tôn trọng	尊崇
Mùa	季候
Aube	奥布省
dị ứng	过敏
sôi lên	烋
đô la Mỹ	美金
Sẽ thử	會試
màu xanh lá	格林
âm thanh của mưa	淅
Hội túc cầu	足协
Thời sự buổi tối	晚報
yêu thích	嬖
Chỉ huy	指挥部
Dương vật	陰莖
Súng trường bắn tỉa	狙擊步槍
Gu	牯
trạng thái	状态
Tất	袜
thợ săn	猎人
Fro	弗罗
Kess	克斯
Kinh nghiệm	体验
Không phù hợp với	不符
Đi	徢
Tensor	张量
Geng	庚
quần áo không viền	袗
New Delhi	新德里
Đảo ĐÀI LOAN	台湾岛
cửa hàng	商店
Tháng sáu	骏
Bộ quốc phòng	防部
căn cứ	硷
trục cửa	戺
Đến	降临
Yan	柆
ngọn nến	灺
Yao	嚞
Giá	差餉
lụa dày không thấm nước	縑
Căn bản	基本
Máu cao	高血
Sự can thiệp	干预
Đối diện	對向
Công việc nhà nước	國務
Sống thử	同居
dọn dẹp	清白
Nhà cũ	旧居
Đưa cho	送给
Khắc nghiệt	苛
Trường Cao học	研究生院
Được	鉴于
Thiên tài	天才
Đội đại diện	代表队
Quyết định	决定
Hôm nay	即日
Minato	港區
Chi	螛
phòng bếp	庖
Na	娜
tỏi tây	韭
Midi-Pyrénées	南部比利牛斯大区
trận hải chiến	海战
mô hình	机型
Bú	吸
Đài	無綫電
Yong	鐶
chế độ	政權
cửa tiệm	舗
Bạn	尔
nhỏ	細小
Động vật có vú	哺乳類
Ling	翎
tháng Ba	行进
Giao lộ	交界處
sự khéo léo	蓺
phản cảm	攻势
Mét	米
Bát nhã	般若
Hongshan	洪山
Thích hợp	妥
Phần còn lại	余下
Đau ốm	患病
Yongxing	永兴
Điều chỉnh	调
Chính thống giáo	东正教
Sắp có	即將
Sau cánh đồng	場後
thích hợp	適宜
Bộ quốc phòng	國防部
Ăn mặc đẹp lên	換裝
Hiệu suất	公演
Công cộng	公办
thong thả	故意
thể loại	门类
Lời hứa	有許
Dongping	东平
tỉ lệ	规模
Mười nghìn đồng	數萬
Hướng dẫn	批示
Goss	戈斯
Viện dưỡng lão	养老院
Hoạt động	活動
đậu xanh	豌
nhô ra	頯
đồ da	靼
Eda	義大
Sinh	誕
Đừng di chuyển	不動
đề nghị	提議
Sa thải	解雇
Hàng không	航空兵
Số hữu tỉ	有理数
Võ thuật	武術
Mai táng	葬
Trạng thái lượng tử	量子態
thuốc súng	火药
Franco	佛朗哥
bật	打开
Sự cố ngày 4 tháng 6	六四事件
Giặt ủi	洗衣
Tấn	蹍
May mắn	运
Tỉnh hồ nam	湖南省
Hòa tan	可溶
Phản ứng tổng hợp hạt nhân	核融合
Các mặt hàng	货物
Trịnh Châu	郑州
nhảy	跳
Joan	琼
Trận đấu nhóm	組賽
Tín đồ	信徒
Ám sát	刺殺
Đàn ông	男士
Fei Di	廢帝
Kinh doanh	商務
Thứ mười tám	十八日
Hua	骅
Betty	贝蒂
Nghìn tỷ	万亿
Sau khi chết	死後
phụ đề	字幕
làn da	膚
Qi	郪
đào	穵
Cao cấp	資深
Rừng rậm	密林
tổng thể	整体
Mina	米那
Buzhong	部眾
Hun	鄜
quần chúng	群众
Lọc	炼
cẩn thận	慎重
BC	西元前
caftan	裋
Bắc Ngụy	北魏
Yak	亚克
Analects	論語
Este axit	酸酯
Mạng truyền hình	電視網
Lendo	倫多
sự tan rã	解体
Livo	利沃
Sulfhydryl	巯
tự hào	自豪
và	並以
Phong lan	蘭教
Quận Bắc	北区
Babu	巴布
người phát ngôn	發言人
Sư Tử	麗奧
ngai vàng	王座
Đầu tiên	一来
Khu dân cư	居民点
Ở đâu	哪裡
Chim cốc	鶿
điếc	聋
Kết thúc	终结
Yue	嶽
疬	癧
Testi	睪
trứng cá	麞
chỉ có	僅
Sealand	西蘭
Cheng	埕
Bảo vệ	護
cây	樹
Neihua	内华
bóng chày	蛐
Được biết đến trước đây như	前稱
lao động	劳
ngọt	甘
Ôn tập	評審
cảnh giác	警戒
Lang thang	阭
Shao	斸
Chủ đề	紉
thỉnh thoảng	偶爾
Phiền muộn	抑郁症
Ngôn ngữ	語的
phong cảnh	景观
tranh luận	辩
Sự miêu tả	說明
sau đó	於是
sự chỉ trích	批判
Shu	坧
Cincinnati	辛辛那提
sách	冊
Bi da	斯诺克
Phải và	權與
Lu	甪
Đã tweet	啾
đại dương	大洋
Trung úy	副將
thứ mười ba	第十三
轹	轹
Tian Sheng	田勝
Trục xuất	逐出
nòng nọc	蝌
Pháp	佛法
đồng xu	便士
Trong	中為
Và Châu Âu	與歐
bài thơ	詩人
Trot	镋
Đơn giản	朴
Họ Cyperaceae	莎草科
bưởi	椵
Sicily	西西里
rừng núi	山林
điều chỉnh	曲调
Như sâu	為深
Tấn công lén lút	偷襲
giỏ đựng đất	篑
嫒	嬡
trung tâm	枢纽
Baoan	宝安
săn bắt	追擊
Tổng thư ký	總書記
Chiến thuật	訣
Đôi khi	时有
ngạc nhiên	詫
Thế Chiến thứ nhất	一戰
Chọn Hoàng đế	选帝
Nổi bật	傑出
thông minh	优
hợp xướng	合唱團
Bầu trời xanh và mặt trời trắng	青天白日
Bão táp	风波
rộng rãi	廣泛
tình hình	情形
kiểm tra	测试
bó	捆
nhảy	跃
Không cho phép	不准
Pao	搗
Dọc theo	沿著
Đặc vụ	劑
Siber	西伯
Ni	尼
Bắc Kinh	京
gần đây	最近
Thánh tích	舍利
Mua cổ phiếu	入股
giống	好像
Trong và ngoài	進出
mùa đông	冬
dầu	油
Hydroxyl	羟基
Laon	拉昂
Công ty phát thanh truyền hình	廣播公司
khuấy động	搅
kết cấu	结构
Su	囌
Nestorian	景教
bộ Nội vụ	内务部
Hàm Đan	邯郸
Sức gió	风力
Văn phòng công cộng	公職
Bang	浜
Harry	哈里
say	醉
Tất cả các chủng tộc	各族
Thanh niên	青壮年
Khi mở ra	時開
Diện rộng	廣域
Ti	悌
Xã hội	社社
Guinea	几内
nữ hoàng	王后
Vào dịp	之際
Huns	匈奴
Chong	翀
Xô	漑
Baoji	宝鸡
lời nói	谚
Long Ya	龍亞
Sản xuất	产
Adi	阿迪
Hố	钂
lãnh thổ	领土
Điều tra dân số	普查
con khỉ	猴
Thông minh	為優
Tin tức	纽斯
Sinh thái học	生態
Đất đai	兰德
ga tàu	車站
lách	脾
Phát hành	获释
Metropolis	大都市
cơ chế	机理
Tòa nhà mới	新造
Thành lập một quốc gia	立國
đệ tử	门徒
đơn độc	惸
một cách tạm thời	暫時
Án Lệnh	諭
Miller	米勒
Ren	雷恩
nói	告訴
Huasheng	華盛
Ian	伊恩
Li	謜
phòng thí nghiệm	實驗室
Bộ văn hoá	文化部
Omai	歐邁
Gui Chou	癸丑
Hiệu suất	表演
kỵ sĩ	骑兵
Giữ	拥
Solini	索里尼
americium	銤
chi tiết	细节
Tế bào thần kinh	神经元
sự kiện lịch sử	史實
Huyện	管區
bộ trưởng, mục sư	公使
công viên	园区
Ando	安多
sách	册
Gower	高尔
chức vô địch	冠軍賽
Mười	十個
Pingpu	平埔族
Mập	法特
Công việc nữ	女作
buồn	愴
Chỉ là không	就沒
Munich	慕尼黑
Sách Phúc Âm	福音
Kiêu ngạo	倨
Hiệp sỹ	奈特