Lụa	絹
Kiêu ngạo	戕
tốt	良好
Ga ga	站站
Tianfu	天府
Quân đội thứ tư mới	新四军
Thiên tân	天津
Thuật sĩ	覡
Yi	奕
súng trường	步枪
Wehrmacht	國防軍
Chánh văn phòng	參謀長
một nửa	半
Nước bùn	濁水
Lừa dối	棃
Gò	砣
Tây An	嫺
Cảnh sát	警察
Ye	謁
Thầy tu	牧師
Chao	菵
sương giá	霜
Bức vẽ	塗裝
Giới thiệu	介紹
bạo loạn	暴乱
người mẹ đã khuất	妣
Sát thủ	殺手
Nam triều	南朝
Siêu hình học	形而
cây sào	極
Trong	處於
Dài	長時間
Dedi	德帝
chim cun cút	鹌
Lễ kỷ niệm trường	校庆
cấp dưới	下屬
đổi	兌換
Thali	塔利
titan	钛
Tổng giám đốc	总经理
JPY	日元
Yi	犿
mồ côi	孤儿
Xoắn	扭转
tuổi tác	年齡
Kawasaki	川崎
không gian	空間
Thượng Thư	尚書
Sản xuất hàng loạt	量產
Thua	喪失
Cũng muốn	亦要
loài	這類
Nền tảng	式月台
Nam và nữ	雌雄
Ứng dụng	申请
Quần đảo	群岛
Tong Jian	通鑑
to quá	過大
Bang	憘
Warren	華倫
Niak	尼亚克
Hurst	赫斯特
vách đá	崿
Hai lớp	兩層
Trung thổ	中土
Sinh tại	出身於
Dioxit	二氧化
Ban cho	赐予
tập trung	浓缩
Thiến	閹
Gongqing	共青
Nai	枖
Thanh Đảo	青岛
Zetian	則天
Riêng tôi	本人
Tứ kết	八強
Thụy Điển	瑞典
tổ	窝
Hệ số	因數
Gula	古拉
người hầu	僕
bass	噌
và ngay cả	乃至
Dongjin	東晉
cổng thiên đường	閶
yên tĩnh và tốt đẹp	姽
Cánh tay	腋
sức mạnh	轴线
hấp	煨
Tán thành	核定
liên kết	縲
kế tiếp	翌
Diene	二烯
Tuỷ	砈
Đáp lại	回信
kháng thể	抗体
Đông đúc	排擠
thất vọng	挫折
Dai	黛
lau	揩
Chia thành	分為
Miễn phí	免
Puja	法會
chuyên gia	研究員
kẻ thù	敌军
Kết xuất	渲染
Arsenal	阿仙奴
cắt ra	剜
Người	事者
Assad	阿萨德
Không cố ý	无意
Âm	颿
Jurchen	女真
ổn định	穩
Đã trở thành	經成為
Xu	仙
Sai	誣
Không con	無子
Chuyển giao	转入
Buzzer	鷟
Vị trí thứ ba	季军
Ngốc nghếch	枲
Erde	爾德
Shao	笭
Yama	亞馬
Dương	邿
Tự nhiên	本土
Bồn tắm	巴斯
Tỉnh Quý Châu	貴州
Thuyết giáo	传道
Kren	克人
Tình yêu mới	爱新
con ong	蜂
Cá hồi	鮭魚
Giá bán	物价
nhận biết	察覺
cabin	舱
Yun	蕴
Phân loại	歸類
gồ ghề	嶇
Adze	錛
chuyển khoản	抽调
Gầu múc	筲
cá	渔
Vết ố	渍
Thua	落敗
Cánh đồng	菲尔德
động vật có vú	哺乳動物
Google	谷歌
Sviato	斯维亚托
Danh lam thắng cảnh	景點
Khói	煙
Hiện tại	現過
tiếng nói	嗓
Chính thức	官员
Hydrat hóa	水合
Anh trai răng	牙哥
kỹ năng	技巧
Jing Gong	景公
tỷ lệ thất nghiệp	失业率
Đảng viên dân chủ	民主派
Dinburgh	丁堡
hình trụ	汽缸
di chuyển	搬家
Sau giờ làm việc	務後
ồn ào	嘈
Wow	倗
sự khác biệt	微分
Trước và sau	前后
Và tôi	安地
Trino	微子
Enthalpy	焓
Cử đi	遣
điện thoại	电话
Mobil	美孚
Mờ nhạt	洨
Zhu	翥
ngôi đền	廟宇
Quân đội	軍力
kiệt tác	杰作
Croatia	克羅埃西亞
Cách mạng	革命性
dinh dưỡng	營養
Roe	獂
Ghi lại	戰績
kỷ nguyên	纪元
đặc vụ	代理人
vệ tinh	衛星
Mômen từ	磁矩
Đền thờ	该寺
dâm đãng	嫪
toàn bộ	总
Thành phố Hạ Môn	厦门市
cấp	年级
chính quyền thị trấn	镇政府
địa điểm	之地
Duo	铎
Bắc Dương	北洋
tuyên bố	聲明
tiên phong	先驅
Rắn	蛇類
Kẻ ngốc	谞
Greentown	绿城
phóng to	放大
công cộng	大众
Tiếng nói	嗓音
Công quốc	公国
áo cà sa	衲
bộ lọc	濾
Đổ	斖
Để tham khảo	以指
bị mắc kẹt tại	卡在
lao động	勞動
Cleveland	克里夫蘭
khóc	泫
ngưng	輟
khu vực lân cận	街坊
thành phố Đài Bắc	臺北市
Walter	瓦尔特
hung dữ	抨
hàng đầu	顶部
cải tiến	提高
vận dụng	操纵
Sau khi tốt nghiệp	畢業後
tự động hóa	自動化
Mỗi người	每人
cảm hứng	靈感
Tìm ra	查明
Ye	阒
Sỏi	砂石
Sờ nắn	捫
Từ	源于
Ủy ban bầu cử	選舉委員會
hạt	县
Tây An	埓
Yi	侎
dốc đứng	漚
phi tiêu	鑣
Giải thưởng	頒
Giáo dục	学历
Tuổi	歲時
than hồng	烬
Trường đại học bình thường	师大
Xâm phạm	違
Âm thanh	音频
Theo	跟着
Braham	伯拉罕
Yan	燕
Giới thiệu	引进
Ti thể	线粒体
Samoa	萨摩亚
ấn Độ Dương	印度洋
Bàn là	鉄
sắc đẹp, vẻ đẹp	美人
Yushan	玉山
Bang Anh	英國國
đẩy	推力
Yangshi	陽市
mùa đông	冬季
thảm họa	災
Quận trưởng	區總
Gấu mèo. - Gấu mèo	狸
Mức độ thấp hơn	下层
Ao	鳌
Vật nuôi	寵
Anh trai	胞弟
được làm bằng	制得
Trang trại rừng	林场
Phát hành	獲釋
Yan	琒
tròn	圓
Đường mòn	步道
lung lay	盪
Môi trường sống	棲性
nội bộ	內部
bàn thờ	坛
Tiết tấu	撍
sự phát triển của	发展
Của bạn	您
Aqui	阿奎
Dongfeng	东风
Quần đảo Điếu Ngư	钓鱼岛
Đội bàn	表隊
An County	安县
suốt đời	终生
kết hôn	婚
An County	安縣
ngành công nghiệp	行業
Ảnh bìa	旗幟
Keyun	克運
lời nhắc	提示
Yu Xian	於現
Nhãn	标注
Báo đốm	美洲豹
toàn thời gian	全職
Chu	辚
Thuộc về	所属
Rob	羅伯
Quốc tế	國際性
Tong	丠
Zhu	竺
Xâm lược	侵
Thánh George	圣乔治
Rado	拉多
Đi dạo phố	上街
cây búa	鎚
Ong vò vẽ	蜉
Móng chân	蔕
Jingkai	經開
cao nhất	癿
làm	办
nguyên nhân	原因
Âm	輜
Hoạt động	运营
Jingshi	京师
Lúa mạch	訞
stronti	锶
Erland	爾蘭
quá trình	遊行
Tên	名曰
Nghệ sĩ vĩ cầm	琴家
nở hoa	开花
hẹp	狹
ngôi đền	殿
Họ cá	鱼科
Dịch chuyển	排水量
Giám đốc	理器
tất cả	全都
Nước carbon	碳水
A	一棟
làm hại	危害
Franche Comte	弗朗什孔泰
Pháp luật và	法與
Người tiên phong	首创
Đến	來達
Khu mục vụ	牧区
mong manh	辮
Than van	卌
Hằng ngày	每天
Vũ khí hạt nhân	核武
ấm áp	热烈
Điện	該電
Phó trưởng phòng	次長
thưởng thức	欣赏
Alkyne	炔
Phấn đấu	力求
âm lượng	捲
đất ngập nước	沼泽地
Zhu	洿
Nội tuyến bốn	直列四
điền trang	地产
Yu Bai	於白
Châu Á	亞州
Độ sâu của nước	水深
Rơi vãi	掉
Phía đông	东侧
sự chỉ rõ	规格
Mặc	穿戴
dẫn đến	导致
Về mặt	而言
Chú ý đến	讲究
Danh sách	名单
Sau đó	再將
thị trưởng	市长
Cục công nghiệp	工部局
Súng lục tự động	自動手槍
Phân biệt	分辨
Sau đó	那麼
Zhengri	正日
Người giữ	持有者
tư thế	姿勢
Tội lỗi	匤
tóm lại	总结
Indonesia	印度尼西亚
Nước sâu	深水
Nhậm chức	赴任
trở về	回歸
Cặp đôi	侪
lòng trung thành	忠心
Shan Xiang	山鄉
các bạn	你們
Suga	須賀
Tiêu chuẩn	本位
kết án	句子
mồi câu	餌
Trung Á	中亚
Tỉnh hà nam	汳
chính xác	改正
Mang	扛
Dịch vụ	務
tranh chấp	争议
Đô đốc	提督
Giao tiếp	通信
tuân thủ	遵守
Ba vương quốc	三國
Wikipedia	维基百科
Mất đi	迷失
Hộ chiếu	威士
trang web	網頁
Jin	縉
Tường bên ngoài	外牆
tài liệu tham khảo	參考
mạ	镀
Một chàng trai tốt	好人
Chương	篇章
Xuân	萱
toàn diện	全面
hầu hết	几乎
Các mặt hàng	貨
con ngựa	馬
thư giãn	懈
crom	铬
Kinh hãi	戙
tổng thể	整數
Gọi là	叫做
Ngoài	開出
thích hợp	适当
Vui mừng	樂及
Dài	垷
chứng chỉ	證
cáp	缆
thời gian	时刻
Ủy ban cách mạng	革委会
Cái	塊
bờ biển	濱
quạt	风扇
Chi nhánh	分局
Dài	垡
Maharash	马哈拉施
người thân	親屬
phòng ngủ	卧室
Ôn tập	審查
Anderson	安德森
Orleans	奥尔良
nấu nướng	烹飪
doanh nhân	商人
Tun	澚
Cho quân đội	為軍
Mang đến	帶到
kinh tế quốc dân	国民经济
Yan	暊
Chengdi	成帝
thành phần	成分
Thiểm	陕
Shi	軾
Qi Qi	齐齐
đã có thể	能够
liền kề	邻
trực tiếp	活
Xô	揅
Thuộc về	所屬
Đảm nhận	承建
Burleigh	伯利
Sư đoàn bộ binh	步兵師
La mắng	瞷
Triều Dương	朝阳
cũng	連
Trình độ cao	高階
Đối với tổng số	為總
gù lưng	踽
Buồn phiền	燊
Nói	来说
khối lập phương	立方體
Nước thải	污
Lo lắng	悮
hóa đơn	罰款
Công tố viên	檢方
đêm	個小時
Carbine	卡賓槍
Mặt đối diện, sự đối nghịch	其反
nấm	菰
kịch bản	剧本
ngã	墜
Gifu	岐阜
nguồn	源頭
Nhìn thấy ánh sáng	見光
Liaodong	遼東
Tôn kính	褰
phi	扔
nhiệm vụ tại ngũ	现役
sự nhiễm trùng	傳染
Tuổi mới	新世
báo chí	報紙
tỷ lệ phần trăm	百分
Đi bộ	行於
lời thỉnh cầu	請願
Cảnh	场景
Cứu giúp	帮
Nặng	厚重
trực tiếp	居住
Đen	黁
cung điện	宮
Thương tiếc	殤
Tom	湯姆
Gian hàng	布斯
dừng lại	停止
Đêm đó	當晚
Tin tức	闻讯
ròng rọc nước	槔
Đã đăng nhập	署於
Maria	玛丽亚
Yu	禺
Zoro	祆
đày ải	流放
Họ Hoàng thảo	报春花科
Phong trào sinh viên	學生運動
hấp dẫn	姱
Công thức là	式為
Tingen	廷根
ý tưởng	想法
Rải rác	散
Nhà văn nữ	女作家
Ngọc trai	珍珠
Giới văn hóa	文化界
lấp đầy	礴
chân thành	悃
Alexandre	亚历山
chính xác	准确
sáng	光亮
Thực ra	实际上
buồng	櫃
con châu chấu	蜢
Msen	姆森
Lang	醘
Chọn	采
Quebec	魁北克省
Lên	了
Hội nghị	秘书处
Áp suất không khí	氣壓
cá nhân	個別
Thành phố hàng châu	杭州市
Mô-men xoắn	扭力
chỉ	出示
Âm	兾
Theo	隨
Hanshin	阪神
Wanchai	灣仔
quanh co	迤
lòng tin chắc, sự kết án, phán quyết	定罪
Mazhou	馬州
Ya	仒
bẩy	陷
Dadong	大东
Zhang	张
Hải cảng	港口
vườn	园林
Tải	载
Ủy ban Trung ương	中央委员会
Gián đoạn	间断
Điều dưỡng	護理
con bò cạp	谡
mở rộng	扩大
đường phố	街道
Cúp hạng	級盃
Li	楳
Loạt	連續劇
Khóa	锁
Dường như	看來
khuôn	模
mái nhà	屋顶
Weiss	威斯
Bậc thầy	主將
Nhẫn	對環
Yu	苃
Bru	布吕
người nổi tiếng	名人
Phân loại	分类学
lễ hội	节日
tần số	次数
tuyệt đối	并未
Trung tâm về phía trước	中鋒
Yêu cầu giúp đỡ	求救
Ami	阿美
đứa bé	娃
học hỏi	學會
Muối axit	酸鹽
Chiếm đóng quân đội	軍佔領
lụa	綢
Số là	号为
nhóm	小組
nếm thử	趣味
đã chọn	選
bonito	鲣
gián điệp	諜
Lớp học đầu tiên	一等
Cùng thành phố	同城
Piedmont	皮埃蒙特
Còi	娗
tự sát	自杀
bóng rổ	籃球
giống nho	葡萄
Bố	之父
Tiao	漖
tấn công	进攻
Seibu	西武
Hulun	呼伦
Gai	霡
Kỉ niệm	回憶
Khúm núm	匃
Jesus	耶稣
coban	秆
cốc	杯
Berlin	柏林
Rad	拉德
Xindu	新都
Thưa thớt	稀疏
trang điểm	化妆
thông minh	嫉
Công việc này	本作
M	犸
Tham gia	搞
Zman	兹曼
Bạc	銀色
hình thức	結成
Gặp gỡ	遇到
TV không dây	無綫電視
sơ yếu lý lịch	简历
Crete	克里特
đất đai	国土
đấu kiếm	劍術
Wan	菀
vỏ sò	贝壳
Âm	聃
Tảo	蓿
đi xe đạp	循环
thời kỳ băng giá	霜期
Tang	苶
Đường dẫn là	徑為
Lòng trung thành	忠義
Chào	嗨
Mizuki	水木
Cá chình	鳝
mệt mỏi	倦
cuốn tiểu thuyết	篇小说
dần dần	漸漸
Martin	马丁
Xà gồ	誩
Luang	鑾
Thứ ba	星期二
Ghế	蓆
Beech	榉
Yu	柀
Mời vào	進來
xấu	糟糕
Lễ hội nghệ thuật	艺术节
thực hiện	製成
thịt cừu	膱
tương ứng	分別
Mỗi năm một lần	一年一度
Đối với Đài Loan	為台灣
thưởng thức	享
Gặp gỡ	議將
Được đặt tên	名字命名
Thông lượng	吞吐
sự vội vàng	迮
sách	册子
Đen	黢
Chi nhánh	隶属
Vợ lẽ	嫾
đế chế	帝国
Văn hóa nhạc pop	流行文化
thích hợp	一贯
Đông Nam	東南
Giá cả	耗费
Một trong những	其中之一
Thu nhập = earnings	所得
Ác mộng	釭
Gọi	打电话
Quốc hội	国民大会
tạo nên	创建
Trong hai	在兩
^	虏
Nok	诺克
Xa lánh	扜
Đang xây dựng	在建
Tát	跏
Leicester	莱斯特
Xiao	烐
Núi	山脈
vàng	黃金
bức vẽ	绘画
dụng cụ đánh bóng	鑢
Sevi	塞维
Tường	廧
kiểm tra	査
trứng	卵
làm giấy	造纸
Vội	飜
Nghiện	嗜
Kochi	高知
Bảng màu	配色
viện bảo tàng	博物館
Đối với Xu	為許
Zhi	朿
mỗi	各个
đêm	宵
Noir	努瓦
lông mày	眉
luôn luôn	總是
Bị giết	喪生
mùi	闻
địa ốc	房地产
một phần năm	五分之一
trường hợp	案件
chuồng cho gia súc	牿
Nói	说
Kuomintang	国民党
Tiền Tần	先秦
Một vùng	個地區
sự chậm trễ	耽
Su	椙
cao nhất	与此
để mà	为了
tham dự	乘坐
Nguyên liệu thô	原材料
một xu	一分
cải cách chính trị	变法
tái thiết	重建
thể loại	类别
giới trẻ	年輕人
Palau	帛琉
Tiêu biểu	代表
Những thói quen không xác định	習性不明
Mạc phủ Muromachi	室町幕府
Quay lại	复出
món thịt hầm	燜
Áp đặt	施加
Tóc dài	長髮
râu	髯
Gọi	叫聲
năm mươi chín	五十九
Đối với cá cảnh	為觀賞魚
cá chép	鲤
Lịch sử	文史
Illinois	伊利诺
Ren	贔
luật quôc tê	国际法
Phần phía nam	南段
Detroit	底特律
Chỉ huy	統帥
cả hai mặt	雙方
hổ thẹn	怍
Seto	瀨戶
Hoãn lại	延後
Roland	羅蘭
xuyên lục địa	洲際
Cái đặc biệt	該專
Vị trí	区位
Ban Tuyên giáo Trung ương	中宣部
Yên tĩnh	腚
Trò chơi điện tử	电子游戏
nô lệ	奴隶
xe lửa	列車
Studio	制片厂
nghĩa trang	公墓
Cá	鲯
chuyển khoản	調任
Đi	觘
Kirstan	克斯坦
Qi	磾
kết hôn	結婚
Newport	新港
Yokohama	横滨
hiện nay	現今
khuynh hướng	趋势
Cuối cùng đã có	終獲
Yongli	永曆
ổn định	穩定
Thành phố	市營
Yala	亞拉
con vẹt	鹦
Chương trình đa dạng	綜藝
thân thiện	潗
tóc	頭髮
Đầm lầy	蝣
đặc biệt	尤
Cạnh là	邊為
Shao	騒
Goo	觫
Grub	蛴
với anh ấy	與他
nhiều	諸多
Yarrow	蓍
Khuyết điểm	投奔
mùa vụ	作物
Connet	康涅狄
	炙
Công cộng	公營
Đã phân đoạn	分段
Thiên Sơn	天山
bị bỏ rơi	弃
phần mười	仂
Kêu meo meo	刕
Xin	莭
Không bao giờ	永不
không bật	晌
Làm	朵
làm sao	怎麼
Dọc và ngang	縱橫
Mất nước	脱水
Đừng	不
Trang Chủ	故乡
Trong vòng	為內
Mecklenburg-Vorpommern	梅克伦堡前波美拉
Danh ca	天后
trong nhà	室内
Bị đánh bại	敗北
spa	溫泉
axit sunfuric	镪
thông thường	惯例
mẹ	妈
Texas	德克薩斯州
Đổ	濅
rung động	振動
Thành lập ủy ban	設委
Đảng và	黨與
Quận dương	陽縣
hướng dẫn	導軌
thay thế	代替
sư tử	簑
Bài đăng	崗
gò đất	坵
Truyện ngắn	短篇
Thế hệ mới	新生代
Qi	琦
Dường như	看似
Nhà ga xe lửa	鐵站
thâm thúy	黝
Độc hại	疟
Yu	鈺
máy lạnh	空调
Senegal	塞內加爾
pháp luật	立法
Con cá này	本魚
Chìa khóa	鍵
cao nhất	总量
hướng dẫn	引導
Diễn dịch	解讀
nói dối	說謊
Trong phần này	本節
Cách cũ	古道
ám sát	行刺
Miles	英哩
người nổi tiếng	名流
con nai sừng tấm	麋
Bảo vệ đất nước	护国
Tàn phá	仮
Chengdu	成都市
gõ cửa	敲
nhà vua	君王
Munde	芒德
ngoại ô	郛
Zhi	栳
pháo đài	炮台
Tình dục	性
Núi	山區
Bộ sưu tập	館藏
Rất thích	真如
buồn	悽
Fu	孚
Cầm đồ	卒
Tov	托夫
Chia sẻ	份额
Đi tắm	洗澡
Công đoàn chung	总工会
cà vạt	繒
Yan	颜
Updo	髻
chúng tôi	們
Cả năm	年滿
tương tự	一樣
tiền bạc	金钱
Khoa	教职工
Thebes	底比斯
Sau cuộc cách mạng	革命後
Từ	出于
Nhẹ nhàng	咯
Bắt đầu lúc	開始於
Hoa mận	梅花
Buller	布勒
Chuyển thẻ	卡轉
Máy Jin	機進
y học cổ truyền Trung Quốc	中藥
Làm	做出
Vật liệu xây dựng	建材
chiến tranh lạnh	冷战
Nhà sử học	史家
Gọi là	稱爲
mái chèo	枻
chung	大将
con ma	鬼魂
kem	冰淇淋
Anh cả	大哥
đưa cho	给
Tiết tấu	毆打
Thầy tu	牧师
Spo	斯波
Napoléon	拿破
Chuyển động	乐章
Nes	內斯
thứ mười hai	第十二
Baijia	百家
Dương dương	洋
sớm	初
chốt	闩
Michigan	密歇根
Dốc cỏ	草坡
Đây	涖
nông phu	農夫
Gặp	梅特
tuyết	雪
Mười tuần	十週
Máy bơm	抽
tim	心脏
từ	既然
Cuộc đua thời gian	時賽
Người da đen	黑人
Chung tay	联手
Treo	沆
Chim vàng anh	鸝
tình trạng	条件
Shao	魣
Nối	追加
Từ Hi	慈禧
vinh quang	榮耀
Crowfoot	莨
Tuo	佗
Harry Potter	哈利波特
Cây	廠房
Vị trí	选址
đừng	勿
Đài Loan triều đại	台灣清治時期
Phòng thờ Phật	佛殿
Miocen	中新世
Hình thái học	形目
Xie	荬
Được viết bởi	所著的
sau khi kết thúc	完成後
ngân sách	預算
Có xu hướng	趨於
Hercules	武仙座
Biểu tượngcon lươn	符號鰻
Hans	漢斯
Medaka	鳉
Ga tàu	站位
Giám đốc	管理器
Tên gọi chung	俗名
cung điện	行宫
Junior Weekly	週刊少年
thuốc súng	火藥
đúng	權利
Trung Quốc	華夏
Tuyết nhiều	大雪
Chất lượng và	質與
Quy tắc lớn	大規
Hàm Đan	邯
sưu tầm	搜集
thoát khỏi	革除
sao chép	拷贝
Yi	幪
Fulan	富兰
Mach lẻo	緋聞
Quốc gia	屬國
Cho như	舉為
A	个
Có thể giới thiệu	可指
Thiên đường	天国
lặn	跳水
Gù	跣
Con gái	媎
Âm	瞤
Dahan	大韓
bán sỉ	批发
Wong Chuk Hang	黃竹坑
quả bóng bay	氣球
HD	高清
mù	瞽
hydroxylamine	胲
Ba người con trai	三子
bôi	泯
Đã chọn	選定
Mía	卡內
Đền Nội	本能寺
Vinci	芬奇
Rong	榮
Guojun	国军
con đẻ	孥
bất chấp	不顧
Bước xuống	下台
Tiết tấu	殴
Swill	泔
hôn mê	昏迷
lời hứa	答应
Zhang	嶂
kiểm tra	考试
cáo	福克斯
Vội vàng	鷜
mùa hè	夏天
Không ít	不下
suốt đời	終身
Bảo mật	保定
nước mắt	撦
vâng lời	乖
Pháp nhân	法人
Đối với	為其
Màng tế bào	细胞膜
sỏi	礫
Taekwondo	跆拳道
Yan	偃
hạm đội	舰队
Hiện đại	近现代
Hu	庶
kế vị	继位
Kiềm	碱性
viết một bức thư	寫信
Lãnh sự	执政官
sự khôn ngoan	智慧
Niêm phong	印
mong manh	裊
Ji	吉
người Trung Quốc	国人
Hội trường tưởng niệm	紀念堂
Nan'an	南安
Tiền công	公款
Thành viên nhập	員進
Một tờ	一張
Cụ thể	即為
Di chuyển bữa tiệc	動黨
Làm lại	重制
64	六十四
europium	铕
hoa mỹ	旺盛
Con thú răng	齒獸
Lùi lại	搬回
rút lui	撤退
bán sỉ	批發
Chang Chen	長陳
Nói	講話
Số ba	叄
Xiang	駪
Bắt đầu ném bóng	先發投手
giám đốc công khai	宣传部长
Bouyei	布依族
Quay	斯宾
bụi bặm	塵埃
Seri	塞里
đĩa bay	飛碟
chòm sao Kim Ngưu	金牛座
vận dụng	操縱
Tuscany	托斯卡纳
dạy	诲
Kiến trúc sư	築師
ngu độn	稠密
Sinki	辛基
xóa bỏ	刪除
nhiệt độ	溫
kính hiển vi	顯微鏡
Vội vàng	湶
Tan	櫨
phòng quận	縣廳
Giới thiệu	引進
Biao	飚
Âm mưu	地块
Cary	卡里
lòng can đảm	勇气
một hớp	抿
Lưới là	格為
Sự khác biệt	差异
Vận chuyển Trung Quốc	中海
Pu	莆
Công khai	宣传
Nenjiang	嫩江
chủ nghĩa cộng sản	共產主義
Li Hongzhang	李鸿章
tháng Giêng	一月
Batting	击球
học hỏi	學
Routh	勞斯
thảm họa	祸
Đúng	則對
im lặng	噤
thần thoại	神話
lừa	特技
Shire	夏尔
Phôi	坯
Xuân	琑
Ji	翕
Taibao	太保
Ngay đâu năm	元旦
Ủy viên	专员
Xa lộ	公路
Dốc	峭
độ dày	厚度
Weiss	衛斯
Chính xác	对
Ngôn ngữ là	語為
Gạo nếp	馉
Sau khi cải cách	維新後
Chip	芯片
Byzantine	拜占
Sâu	蚡
Xấu hổ	糗
Diễn viên	鑄
Chấp hành	处决
đường sắt	鐵道
Li	橺
Linh miêu	猁
chủ nghĩa xã hội	社會主義
năm	年度
Thêm vào	後加
doanh nhân	企业家
Công thức phân tử	分子式
Rắc rối	困扰
Sông nhỏ	小河
Salva	萨尔瓦
Một lần nữa tại	又於
Các thành phần	零件
Tất cả	全體
Hinder	妨碍
Xuất tinh	射精
Jinchaji	晋察冀
đồn trú	守备
Âm	玒
Được	得來
Đóng quân	派駐
Baba	芭芭
hướng dẫn	导向
Tsuen Wan	荃灣
trợ cấp	津贴
Vợ lẽ	妁
Hu	灦
sự nghỉ hưu	退休
Người bảo vệ	護木
Boston	波士顿
Sự định hướng	定向
Thiết bị điện	電器
Nhất	至多
Đăng ký	登记
nút	节点
Huyền Tông	宣宗
Friedrich	弗里德里
Bian	卞
Zhouyi	周易
Viện thiết kế	设计院
thời trang	时尚
Từ chức	辞去
van	瓣
Trung du	美聯
lỗ mũi	鼻孔
Liên doanh	聯營
thảm họa	灾害
Nền tảng	月台
nhân viên	人員
Kích hoạt	起用
Nan	楠
Els	尔斯
Thắng lợi	夺冠
các môn thể thao	競技
Lectra	力克
từ	從中
Vắt kiệt	櫔
Petersburg	圣彼得堡
phẫn nộ	愠
lưu Bị	劉備
Daejeon	大田
Leba	黎巴
Khai báo	宣告
Làm cho lớn	作大
không nhận ra	壈
Vòng xoay	自轉
hân hoan	麾
Điều này	這場
thị trấn	城鎮
Buồn phiền	懮
PR	公關
Hum	嚶
xấu xí	窳
Maki	槙
Hay bông lơn	锲
nền văn minh	文明
Tội phạm chiến tranh	战犯
dền	苖
Chất lượng hình ảnh	畫質
lồng	栊
Dele	德勒
bỏ tù	徒刑
đề cập	提
Dệt may	纺织
Shao	姹
sự an toàn	安全性
Nakamune	中宗
Phòng Tuyên truyền	宣部
Di	氐
bươm bướm	蛱
Trương học nư sinh	女校
Túp lều	廬
Âm	螔
khắc đá quý	琱
đất đai	陸
nhanh chóng	急速
Bale	巴勒
Càn Long	乾隆
tải	负荷
Sự công bình	公義
Và sẽ	會和
Mi	芈
tiếng Đức	德语
Hình ảnh	畫面
Anh và chị	兄妹
Ke	岕
Ổ cứng	硬碟
Hưng thịnh	繁盛
Yana	亞納
Jianghuai	江淮
sẽ là	將在
Chế giễu	旤
Theo nhóm	成群
đấu trường	竞技场
Trạch đông	泽东
Yongchang	永昌
Đồng minh	协约国
Cuốn sách này	此書
Diao	刁
cái cổ	脖
Eck	埃克
Himalaya	喜马拉雅
Được bao quanh	包圍
Chấp nhận	接受
Tấn	噸
con bò cạp	貹
Giám đốc bộ phận	科长
diễn xuất	演戲
hydro hóa	氢化
Nổ	迸
Hình thành	成形
đá quý thấp kém	碔
Hơi cay làm chảy nước mắt	催淚彈
Aran	阿朗
Xanh hóa	绿化
Triều đại Jin	金朝
Tolo	托洛
bên	側
bảo vệ	把守
Chôn	掩埋
độc nhất	獨一無二
Thực nghiệm	实验性
Đại dương băng	冰洋
Hiện có	现存
Hoa hồng	玫
Dội lại	回升
bánh xe	輪
đêm khuya	深夜
mười lăm	十五
Geer	格尔
che	覆盖
Loạt	系列賽
lỗi	错误
Jie	頡
Xi	溍
Kang	亢
Trực tiếp	過著
buồng	櫥
điều khiển	控
Hiệu quả chiến đấu	战斗力
Thông báo	宣布
Đĩa	板塊
yết hầu	咽
Zuo Zhuan	左传
kinh khủng	慘
Tốc độ gió	风速
tròn	回合
Chính thức	吏
gặp	見面
tích cực	正
Đảm nhận	承办
khen ngợi	赞美
Vòng tròn	局局
văn chương	文學
Kiêu ngạo	恾
kết hôn	姻
Rong	镏
Cửa hàng	存放
mọi nơi	到处
đường Nathan	彌敦道
Lywood	萊塢
bùng nổ	砰
tranh luận	爭論
Quart	璮
Helsinki	赫尔辛基
sàn nhà	楼层
Thủ đô	首府
kinh tế chính trị	政治经济学
Đài	收音
Phong trào sinh viên	學運
Nhân viên và	員及
Răng	齒目
phương trình	方程
ăng ten	天线
Chải	櫛
Báo cáo	报导
Thời gian vị trí	位時
Cung cấp	設在
Đi bộ	踯
Sông Ga	加河
Hồ Bắc	鄂
Raptor	盜龍
mở ra	開拓
Đồng nghiệp	同僚
Nhà thờ	圣堂
con sông	河流
liền kề	毘
Hút máu	吸血
Đến	到達
Thư viện	書館
khô	涸
Ulan	乌兰
tiêu đề	锦标
bật	打開
gậy	罗德
Nếm thử	口味
Hạ cấp	降級
di chuyển	搬
gì	何
vải lanh mịn	缌
Jinchuan	金川
Xe buýt nhỏ	小巴
bơm vào	碰到
lười biếng	怠
thương	繾
Nam TP.	南城
Thiên thể	天体
màu sắc	颜色
Bà	姥
Chia sẻ	佃
Top thứ ba	三甲
Độc thân	個單
Bình minh	晨曦
Tại đây	在這
Li	俪
rùa	龟
Petersburg	彼得堡
Nam Bình	南平
Zhu Di	朱棣
Kui	馗
Ether	乙醚
thiểu số	少数民族
Sự phẫn nộ	憤
cắt cỏ	刈
chim cun cút	鵪
Hum	唥
Người sản xuất	製作人
Phát sáng	發光
được đặt tên	命名为
Đông Chiết Giang	浙东
STD	性病
Độc hại	惡意
Jing	靖
ước tính	估计
Mở	曠
mồm	嘴巴
Đảng dân chủ	民党
dây súng	戟
Ronin	浪人
sự hy sinh	犧
người bắt	捕手
bài hát nhịp	呗
Ga phía nam	南站
Tỷ	亿
Bán đảo Mặt trời	鮮半島
Montana	蒙大拿
Đường vào	線於
khán giả	聽眾
Dang	簹
Bắn	槍殺
Tê	耔
Sima Yan	司馬炎
Khác với	別於
Muộn nhất	最晚
Lập trình	編程
Bao vây	圍賽
Wenwei	文為
Hạ gục	淘汰赛
Lừa dối	棐
Vượt qua	遞
thầu dầu	腽
Blanch	焯
Abha	阿布哈
Diễn viên	铸
mỗi	每
phân tích	分析
Lam	欖
giải thưởng	奬
Gạo nếp	醨
Nữ hoàng dài	長後
Quận He	和县
Mỗi kỳ	每期
cây rơm	嶺
huyền diệu	神奇
đói bụng	飢
hiệu ứng	效应
chết	殂
Tài trợ	融资
cộng hưởng	共鳴
Tiếng Anh	英
gạch tráng men	甓
Tổ chức	筹办
Đau khổ	廌
Bộ Tư pháp	司法部
xây dựng	建筑物
Đối với thức ăn	為食
Na	呐
Kịch	話劇
Gặp gỡ	邂逅
Âm	訔
Hoàng đế Meiji	明治天皇
Gru	格魯
Đơn nữ	女單
Các nước láng giềng	鄰國
Mức lương hàng năm	年薪
phủ nhận	否認
cả hai	倆
Khá phổ biến	頗受
nghe	聼
triệu	百万
số liệu thống kê	统计
theo chiều dọc	纵
thanh kiếm	铗
Cái cằm	頷
kinh nghiệm	经验
tiếng Nga	俄文
Trường Xuân	常春
điểm phía Bắc	北角
Osmanthus	桂花
Nie	聶
Đã có	有過
Chanh	柠
đồ dùng bị hỏng	楛
Ở gần	臨
Lá cây	叶
Kính ngắm	取景
bóng râm	蔭
tiếng Đức	德裔
Sui Yu	遂於
đốt cháy	烧毁
William	威廉
siêu	超級
nhát	愐
California	加利福尼亞
Cái nhìn của công chúng	公視
Xi	鍚
Con trai	男童
Bordeaux	波尔多
Dầm sau	后梁
Huỳnh quang	荧光
Chi	錻
nâng cao	預先
Đường chính	幹道
Barcelona	巴塞隆
Wow	譁
Thô	觕
con hổ	猛虎
Dier	迪爾
Nhân tạo	人为
lớn lên	長大
Sau khi sụp đổ	滅亡後
Sinh thái học	生态
Sâu	蚼
Li	黡
Tarim	塔里木
Biên dịch	编撰
Banyan	榕
Rút tiền	撤軍
đúng	右邊
Chỉnh sửa	修飾
củi	樵
Trực giác	直观
Khu vực nước ngoài	洋區
Kinh thánh	聖經
Thân tàu	赫爾
Nhân vật	身影
Bất lợi	弊
Đại học Thanh Hoa	清華大學
Kejinshi	科進士
Cướp biển Nhật Bản	倭寇
Thống đốc	總督
tiện ích	效用
Chủ nghĩa duy vật	唯物
Thức ăn cho cá	食用魚
Giết người	命人
King Xiang	襄王
Bunji	文治
Phòng ngừa	预防
cà ri	咖哩
mong manh	嬝
dịch	流體
Cuộc điều tra	偵查
chiến thắng	胜利
Pháp luật và mệnh lệnh	治安
Ác tính	惡性
cương cứng	勃起
điện báo	電報
tỏi tây	韮
Quốc gia	該國
chap	皸
Tây Sơn	西山
Kết xuất	渲
Trong trạng thái	州內
phụ trợ	輔
Dựng lên	竖立
đuôi tàu	舳
Hai nước	兩國
Tàn bạo	戾
Chỉ đạo	有向
Đánh vần	咒語
phước lành	祝福
góa phụ	鳏
côn trùng	虫
Một đầu	一頭
Mét	计
Heidelberg	海德堡
Tây Kowloon	西九龍
Ngay sau khi	權後
Tỉnh Quý Châu	贵州省
căn bản	激進
tẩy rửa	祓
Kho chứa nước	蓄水
Gia Khánh	嘉庆
Thành phố Trung Sơn	中山市
tuyệt quá	极大
không rõ ràng	缈
Trao giải thưởng	获奖
xe cứu thương	救護車
Nước Ý	義大利
Mười chín	十九
Đúng đắn	義者
McCartney	麦卡特尼
Tiến bộ dân chủ	民主進步
ý tưởng	念頭
con lợn	猪
Zhu	璛
Văn phòng	公室
Ờ	祾
Doron	多伦
còng tay	杻
Triển khai thực hiện	實施
Zhoushan	舟山
Nai	鼐
Xuân	狓
Trợ cấp	補助
dấu	記號
lưu lượng	流量
Tolia	托利亞
Dường như	看来
bộ	定
Đất	地
Ami	阿彌
Kun	崐
Ma Cao đặc biệt	澳門特別
Cho lần đầu tiên	為第
Alexandra	亞歷山卓
Một trong những thành viên	員之一
gián tiếp	间接
Nico	尼科
Trực tiếp	活的
mùa khô	旱季
Căn cứ	基部
con châu chấu	蚱
rẻ	賤
xương bàn đạp	镫
Ngoài khuôn viên trường	校外
Văn phòng quản lý	管理所
Tây Phi	西非
Muội than nhỏ	小煤炱
Trung đoàn	該團
Liu	刘
Sq ft	方呎
nhà ở	議院
Bộ trung tâm	中央集
Hum	彐
Lek	列克
Trận chiến ác liệt	激战
Sway	斯威
Sự tàn bạo	暴行
hòm	方舟
giả vờ	佯
Đến	來愈
thực tế	事实
Huashan	华山
Cây rơm	棧
đêm trước	前夕
Từ	來自
không khí	晾
bờ Nam	南邊
Mùa thu trắng	秋白
Lee An	李安
viêm	炎
Tổ chức	宿主
Faey	霏
ghi lại	錄得
bói toán bằng rơm	扐
Qi	槴
Phi cơ	航空器
Người Bồ Đào Nha	葡萄牙語
CMB	中巴
Con nai	獹
bán	出售
Một tá	十几
nâng cao	高级
Đặc biệt	尤为
Ở lại	停留
Người ngoài hành tinh	外星人
ngủ	寝
Ủy ban	委會
kiệt sức	憊
Thể rắn	固態
Xấu hổ	榁
bố trí	铺设
cừu	羊肉
Quăng	托斯
Nhạc Phi	岳飞
dỗ dành	閧
học thuyết	学说
quỹ	資金
chăn yên	韉
Philip II	腓力二世
Là	乃
Tai nạn trên không	空難
Bonito	鳣
Lawrence	铹
Bùn vàng	黃泥
Nổi dậy	反抗
Heartland	心地
Gầy	薄的
mạng lưới	凈
trên	上
Âm	瀔
bến tàu	塢
Không có gì	無可
Số thực	实数
Và	幷
Và di chuyển	與動
Trầm tích	沉积物
Thành viên gia đình	家属
Nước thành viên	員國
đại sảnh	霍尔
Anh ấy và	他與
Thế giới	世間
Itabashi	板橋
Nhập trường	場進
Xiaolong	小龍
Dữ dội	重度
Giáo dục trung học	中等教育
trứng vô sinh	毈
Đau khổ	惣
ngày	白天
Treo	悬
Bán	販
Người chơi	选手
Frigate	护卫舰
Công	珙
xenon	氥
cháo	穈
đá quý	璨
chỉ	刚
Thận trọng	保守
lỏng lẻo	鬆
Jiro	二郎
Đây	玆
ốc lắp cáp	腺
Kiev	基辅
Zhuan	顓
Văn phòng	办公厅
Yi	侾
Yên tĩnh	蛨
Cổng vào	入口
Bảo trì	機務
Gothic	哥特式
E	戊
Tugua	土瓜
Si	菎
Không khác nhau	無異
Khuazi Mo	花剌子模
Nib	尼布
Chất thải	废
đồng cỏ	牧场
Tên viết tắt	声母
Cleveland	克利夫兰
Newze	紐澤
Làm giả	锻
Nga	俄国
Quyển sách	該書
Abba	阿拔
Algiers	阿尔及
hết giờ	暫停
Xikang	西康
Người hâm mộ	樂迷
lỗi	錯誤
tỉnh Giang Tô	江蘇省
trên	关于
Với	著
Tăng lên	昇
ngủ	睡
cây lau	萑
Huấn luyện viên	主帥
Cửa quay	閘機
Wuling	武陵
Liu Xiaobo	刘晓波
ngân hàng phía đông	東岸
thiền học	禅
Đêm	魮
Takamatsu	高松
học thuyết	學說
dựa vào	羸
xương sống	脊椎骨
cây gai dầu	蔴
Cô	嫡子
Crossfire	交火
mận	梅
Trong hồ	湖中
Võ sĩ quyền Anh	义和团
giải nhì	二等奖
Sẵn sàng	準備
Ở lại	留申
Oxazine	嗪
Edward	愛德華
chịu được	抵擋
Nguyên nhân	病因
Pre	普雷
trên tàu	机上
Lịch sử tự nhiên	博物
món nợ	债
Tên	起名
Ngắn mạch	短路
Người Mỹ gốc Phi	非裔
Có một tiểu sử	有傳
Cụm hình cầu	球狀星團
Vảy	藂
thuốc màu	颜料
đường mía	蔗
Cảm quang	感光
song song, tương đông	平行
Muhammad	穆罕默
Đường sắt Đài Loan	臺鐵
Làng Nam	南村
Dinghai	定海
Giới thiệu	引种
Kể từ thời thơ ấu	从小
sự thích nghi	改编
Căn cứ	本营
đông bắc	東北
Ứng cử viên	人选
Vương miện	皇冠
không nhiều	不多
Kiểm tra	考中
Xây dựng	營造
Cây ngang	祣
Hoàng đế	天皇
Đánh nhau	斗
Nước thải	汚
lỗ hổng	差距
Mọi người	尔人
xuống	毧
Thier	蒂耶
nhai	咀嚼
người Trung Quốc	漢
Đường sắt quốc gia	国铁
Đính kèm	依附
Tiệc	饗
Xuân	礮
Buồn phiền	惤
Dưới	轄下
hư hại	损
Ông chủ	老闆
Bầu cử trực tiếp	直選
Tiêu chuẩn	标准
khô	幹
Nhóm tiệc	党组
Oh	唎
Hộp số	齒輪
Ghét bỏ	辱
Tinh hoàn	睾
Chính thức	官員
Gốc	产地
Sở thích	愛好
Cây cung	艏
ngủ	眠
Đau khổ	遭
Qi	祺
màu xanh lá	格陵
Ga tàu	駅
Bỏng	伯恩斯
Paula	保加
Khiêm tốn	倽
hình chữ nhật	矩形
Miao	淼
Teng	腾
Lốp xe	泰尔
Cá chình	綱鰻鱺
Tấn công	袭击
Sau đó	爾後
Bạn	猷
Li	苐
giết chết	勠
Ở trên	上文
Alp	阿爾卑
Yi	賨
Biến dần	漸轉
tiếng Nhật	日語
Bis	俾斯
Pu	浦
nồi	壺
Haicheng	海城
Ảnh bìa	旛
hài hước	幽默
Warren	沃伦
Buổi tiệc	晚會
Như	上為
Anh ấy đúng	他對
sự bành trướng	扩充
ngũ cốc	谷物
Phiên âm	誐
Trung Hoa Dân Quốc	中華民國
UAE	阿联酋
đàn ghi ta	吉他
ngày càng	日益
Voss	沃斯
Diễn dịch	诠释
Nevre	涅夫勒
bảo vệ	警備
Jie	卩
Nafa	纳法
Đầu tiên	首架
xóa bỏ	刪
Kẻ ngốc	谼
Niao	垹
Huh	唖
nguyên liệu thô	原料
Tờ báo	該報
mua tín dụng	賒
họp báo	发布会
Đài phát thanh	電台
hỏa tiễn	飛彈
vật nuôi	寵物
Đang chờ đợi	等職
Dựa theo	照
đã phát triển	發達
xúc xắc	骰子
chủ tịch	大总统
Tiệc tùng	黨黨
Lins	林斯
thầm lặng	默默
Ghi công	歸屬
Chũm chọe	镲
Trường học	該校
Meizhou	梅州
Tai và mắt	耳目
Fuxing	福星
giao hưởng	交响曲
Tây An	晄
Hán-Đức	中德
Tòa án quân sự	军事法庭
Shi Jing	石敬
nhấn	印书馆
Amide	酰胺
Iliac	髂
nhận được	领取
Yinwei	銀緯
Miami	迈阿密
đêm khuya	夤
Phương sách	度假村
Máy bơm	泵
Hàng ngàn	萬千
Ít hơn	减
Mang lên	造就
Yamada	山田
Giáo phái	邪教
chỉ có	仅
khu vực	区域性
bộ Tài chính	財政部
Bụng to	大肚
tất cả	皆
Phía trong	圍內
dẫn đường	导航
Ert	爾特
đặt hàng	订购
Trao đổi	交汇处
Tiếp theo hai	下兩
Đàn anh	荏
nhận con nuôi	採納
Cửa màn hình nền tảng	月台幕門
hổ thẹn	恧
pháp luật	法
Bướm đêm	螋
công cộng	公家
Di chúc cũ	舊約
huy chương bạc	銀牌
Phiên bản Trung Quốc	中文版
Phó trưởng phòng	次长
Văn phòng chungcó lẽ	聯辦或许
cung cấp bởi	供电
khí tượng	氣象
theo chiều dọc	竖
Montreal	蒙特利尔
Xiao	擭
Orifice	窍
Khu dân cư	住宅區
Sau giờ học	學後
chủ nhật	星期天
ngoài trời	戶外
Simon	西門
Tiao	滠
Sau khi nhậm chức	任後
Bệnh viện	院的
Dài	隆
cài tóc	髽
Zhang Zhidong	张之洞
Thu nhập và chi tiêu	收支
Người nhận	機匣
trăm	一百
Hàng châu	杭
sấm sét	雷霆
che	掩護
Thành phố	直辖市
Chống lại không khí	對空
Thời gian dòng	線時
bàn thờ	祭坛
Bạch đàn	桉
mạch đập	脈衝
Thị trấn quan trọng	重镇
vinh quang	咺
Reel	辘
dụng cụ	工具
Pru	普魯
từ	离
Tan	粦
Scotland	苏格兰
Bộ phận quân sự	军分区
đánh bại	打敗
âm nhạc	音樂劇
Chặn bản sao	刻本
Quan	銓
Mo	谟
Trên danh nghĩa	名义上
Thứ mười bốn	十四日
Không thay đổi	恆
Mục đích	旨
mong manh	馐
Ku	揆
Ngôi sao điện ảnh	影星
Chủ nghĩa xã hội	會主義
bào ngư	鮑
Tỷ lệ phòng thủ	防禦率
lớp học	类
Người thay thế	替代
Lewis	刘易斯
Phi nước đại	棓
nhà ái quốc	爱国者
cá tầm	鲟
sức mạnh quốc gia	國力
Dowa	多瓦
Gấp đôi	為雙
Eli	埃里
Ngừng việc	停工
Chim ưng	鹞
Nhân Viên	幕僚
Chuyến thăm	探訪
người cầu nguyện	祷
dâu tằm	椹
chuyển khoản	換乘
Ông chủ	老大
phát biểu	演說
Cuộc đua	競逐
Chiếu	俁
Chunghwa Telecom	中華電信
Trên núi	山上
Người Venice	委内
Oh	唡
Dara	达拉
Hoàng đế Tần Thủy Hoàng	秦始皇
Cô đơn	澒
Huh	呣
Chu	蕕
Một phần	偏
phía đông	以東
Pennsylvania	宾夕法
Jordan	约旦
đày ải	放逐
Bất lực	无力
Lưỡng lự	勉
Đường phân chia	分界线
Trong nước	國產
Xinhe	新河
Họp lại	联欢
chứng minh	證明
Mất đi	失落
Thoải mái	自在
Đề cương	大綱
Cuộc đình công	绝食
Thuật sĩ	觋
gỡ lỗi	调试
Vâng	恩
Qi	齊
đàn organ	器官
Ye	晔
Hydroxit	氢氧化
ngoan cường	顽强
Trường thể thao	体校
Bầu không khí khách	賓大氣
thú vật	動物
Du học	留学
hạt	微粒
Đất và đá	土石
bánh crepe	绉
lương hưu	退休金
lái xe	駕
kỷ niệm	紀念
Đi về phía nam	南下
Nói	講述
Zou	邹
Quốc vương	国君
Tỉnh Hiroshima	廣島縣
Giết chết	擊斃
họ	它們
Phản hồi	反馈
gửi	派出
Lam	榄
thư viện	文庫
Quận Kwai Tsing	葵青區
bờm	鬣
cảm thông	同情
độc tố	毒素
nhắc lại	提醒
Quốc gia	全国性
cốc	盃
Bộ Nội vụ	内政部
Thành phố Thanh Đảo	青岛市
vì thế	故在
Sha	鯒
trung tâm	毂
Hiệp hội xúc tiến	促进会
Tấn	磏
đồ sơn mài	漆器
Stadt	施塔特
Luo Ji	羅紀
Shire	夏爾
Guo	郭
Đọc to	宣读
Vội vàng	慓
thuốc uống	药物
Mang	馱
chỉ có	止
Bí mật	暗中
Kentucky	肯塔基州
Nghiền ngẫm	刍
Wan	皖
Jin	晉
hành trình	航程
United Emirates	聯酋
Giang	滛
vật	物体
Mến	花式
Nổ	炸药
Tấn	忷
cáo	狐狸
lên đường	掀起
Đổi	皈
Zhe	蓰
run sợ	顫
Nhân từ	仁親
thịt ức	脡
vật chất	物质
Đàm thoại	谈会
thật	真
tên miền	域名
món thịt hầm	焅
Dễ dàng	易于
chưa kết hôn	未婚
Yan	寉
Quận đặc biệt	特縣
Mới đến	傳入
âm mưu	密谋
Hoa sen	荷花
Peru	秘魯
hủy hoại	摧毁
Yao	瑶
Đi đến	轉到
Zhong	锺
赜	赜
rau thì là	虷
bố	父
Sinh tại	生于
Nghe nhìn	影音
Thế giới	寰宇
Giữ	攥
Ba thế hệ	三世
Khung xe	底盘
Đảng Bảo thủ	保守黨
người ngoài cuộc	外人
Tensor	張量
Yun	郧
vượt qua	交
trẻ	幼
Jian	笕
buổi triển lãm	展览
Tấm	張單
Đại nguyên soái	大元帅
Làm	使到
Giáo dục	育
Miệng khổng lồ	巨口
cây ngưu bàng	蒡
Tân Hoa xã	新华社
Cá trích	鲱
tan chảy	融化
Đây	此处
Colorado	科羅拉多州
Guancun	关村
Năm mươi lăm	五十五
Li	溧
Nhà nước	該州
Hình dạng chi nhánh	形科
Mặt nạ	假面
Của	之
cống	排水
Không đến	不来
Hoa hồng	罗斯
lan can	陴
Lính canh	衛軍
Canh	机翼
Kata	卡塔
Chức vụ	陣地
và cả	也
Hoàng Đà	黃大
airdrop	空投
Bảy trăm	七百
Bờ biển	岸的
Lên	瞭
sự hỗn loạn	混沌
Daegu	大邱
Trang trí	飾
Xấu	阨
Nơi cư trú	居留
Yue	樾
Kèn Trumpet	叭
Phố cổ	老城
sẽ sử dụng	會用
biên giới quốc gia	國界
Tải lên	上傳
Nam việt nam	南越
Meizhou	梅州市
Qi	綡
Hom	坎
carbon	碳
Marin	马林
nhũ hoa	乳房
ma thuật	神功
đi vênh vang	跩
Câu chuyện	物語
Quay phim	攝製
dịch vụ	维修
Huân	寰
miễn là	只要
cực	极端
Agen	阿让
Phiếu mua hàng	券
Sơn	髹
Alaska	阿拉斯加
Trường hợp khẩn cấp	应急
Darwin	達爾文
Chủ nhà và khách mời	主客
Qi	觙
quân đội	軍隊
phản đối	仵
Chân thành	懇
Lãnh thổ	境內
bình thường	平凡
Evans	埃文斯
đến	來到
Rotter	鹿特
sân khấu chương trình	舞台劇
ngoại hôn	婚外
Tập trung vào	瞩
Trang bị	武装
tài giỏi	僬
tòa án	法庭
vận chuyển	運送
Căn cứ	基底
Sâu đục	螟
Một lát sau	後即
Gấp đôi	双人
sự trả thù	報復
cà vạt	紮
Lion Rock	獅子山
Cặp giữa	中對
khí quản	氣管
cho đến khi	迄
Vui lòng	快感
con đom đóm	螢
Con dâu	媳
lãnh chúa	军阀
Frederick	腓特烈
Tháp trắng	白塔
Điều này	這一
Quân đoàn	总队
Sông hồ	江湖
Mìn	地雷
Sinh vật hạt nhân	核生物
Heidegger	海德格尔
âm thanh	音響
Chia thành	分成
xeri	鈰
cấy	移植
Sỏi	石材
Trường đua ngựa	马场
Sở Giáo dục	教育厅
thích hợp	適當
Dấu vết	蹤影
Nơi sinh	生地
Trường Cao đẳng	院校
Thiết lập quan hệ ngoại giao	建交
sinh tại	生在
Tổng hợp thành	编为
Được dùng	被用
đường thẳng	直线
trứng	蛋
Cận nhiệt đới	亚热带
lớp học	班级
tiền vay	借款
Sith	西斯
Pyridine	吡
bức tượng	塑像
Lin	璘
Thành viên cho	員為
Taichung	台中
Trimble	天宝
Chỉ	就是
chiếm lấy	捕獲
nhà hàng	飯店
Yan	慉
sóc	松鼠
bóng	影子
Mái hiên	帱
Luo	箩
đẹp	英俊
Tia cực tím	紫外線
đẹp	俏
con cóc	蟾蜍
sự cắt bỏ	切除
hệ thống	體制
Nội dung	爭奪
họng	嚨
Xie	飉
Ước tính	估算
đốt cháy	焚
halogen	卤素
Chim	鹷
Tin lành	新教
lô hàng	批量
Kiếm	賺取
Và lấy	並得到
Cắn	齧
Không khí	氛圍
Ban thư ký	书记处
Jackie Chan	成龍
bằng thạc sĩ	硕士
chức vô địch	锦标赛
người Anh	英属
Lễ hội Xuân	春節
Biwu	必武
cạnh	稜
Thành phần	組件
Cài lại	重置
Đồn điền	种植园
Trả	餉
Haoran	浩然
nhạc nền	主題曲
trông nom	觑
Âm	謦
tỉ lệ	尺度
Được biết	據報
hộ chiếu	護照
Đến Đài Loan	來臺
Vua chính trị	政王
Dựng lên	豎立
Nai	棷
Thông qua	维亚
Bộ Nội vụ	內政部
Một quận	一個縣
Có trật tự	有序
Shichang	世昌
Trực tiếp dưới	直屬
khúc quanh của một con sông	厔
bão	颶風
Số tự nhiên	自然数
Yi	懿
thích hợp	恰当
Pu	璞
rộng lớn	廣闊
Một ngày nào đó	某日
Sa thạch	沙石
Libby	利比
Trong lăng mộ	墓中
Patrie	帕特里
hàng tiêu dùng	消费品
Quan sát	观测
lãnh chúa	軍閥
Trả	饟
Thực lực	实权
Lu	蒚
Uttar Pradesh	北方邦
Đại khái	大略
kế hoạch	計畫
Phật giáo Tây Tạng	藏傳佛教
Momoyama	桃山
mua	买
Hoàng Gia	皇族
Astatine	砹
từ ngữ	单词
nai	麚
Tintin	丁丁
Val	瓦尔
Sanhe	聖荷
Ở ngoài	外侧
Đứng như	立為
Hung dữ	狋
Khôi phục	恢
Diêm Vương	燕王
Sóng gió	湍
Hà Châu	河州
Phòng ban	學系
Kasahara	笠原
Tianlong	天龍
Lò sưởi	热器
chuông	钟
bàn	表
Quảng trường	平方
Cá sư tử	獅子魚
Cứu trợ	賑
Lanco	兰科
Poch	波希
Thuốc phóng	推进剂
với	跟
Quan thoại	柑
McCarthy	麦卡锡
Sở cứu hỏa	消防局
Jing	荊
rừng đá	石林
Top mười	十佳
Đi dạo	散步
lộ trình	要道
Quốc tế cộng sản	共产国际
thích nghi	容纳
Trông giống như	樣子
Pei	裴
may	绲
xoáy	潆
Kiệu	轎
phổi	肺
Xi	汐
to	薖
tập trung vào	专注于
lạc quan	樂觀
thảo mộc	草本植物
Hạt	县县
riêng tư	私自
phân biệt	區分
Chì	領銜
Trực tuyến	上線
Kinh phật	佛經
cuộc sống biển	海洋生物
Adams	亚当斯
Ooli	鲕
Đối với	以供
Chạy xuyên qua	貫
Mảng	陣列
Nhạc jazz	爵士
ga tàu	车站
Xihe	西和
Trên sân khấu	上台
Provence Alps	普罗旺斯阿尔卑斯
Vui mừng	逍
chưa quyết định	躕
Đến	踠
Đấu thầu	嫩
Và gửi	並派
Vượt qua	傳給
joule	焦耳
Ai	噯
Trung gian	中間
bước đá	磴
Hải cảng	埠
chiếm	佔據
núi mùa xuân	氿
Linh hồn	靈魂
thuốc màu	色素
Jingxi	京西
Âm	釿
chiếu trúc	簟
Bắc bán cầu	北半球
đường bang	國道
Tân sô cao	高频
thầu dầu	膃
Hy vọng	可望
hoạt động tình dục	性行
Tuyền Châu	泉州市
Không cần thiết	不必
Sao biến đổi	變星
nguyên mẫu	原型
Zh	欘
trâu	水牛
bệnh cố chấp	痼
Ngốc nghếch	魓
rủi ro	风险
Liên bang	英联邦
Điểm hẹn	交會
lưỡi liềm	鐮
Zhao	櫂
dịp tốt	時機
Nước đi này	此举
chuyên môn	特产
già chuyện	哝
Tong	莵
Hu	鵠
Quân cách mạng	革命軍
Ying	頴
Sữa	乳
Tốt bụng	是種
Machi	町
Làn đường	車道
Màu nền	底色
không hợp lệ	无效
Toulouse	图卢兹
Đồng ý với	赞同
Gr	鰡
Số Pi	鸀
Chương trình này	本劇
Biết rôi	知悉
bó	束
Đặt	將該
rùa biển	黿
Đổ bộ	落地
chiếm đoạt	劫持
Zhe	柘
Jingzhou	荆州
Chibi	赤壁
Sự phẫn nộ	忾
Người phạm tội	罪人
Lộ trình	潰敗
cưỡi ngựa	騎馬
Ngành công nghiệp	实业
Vạn đò	鈢
Tốc độ	極速
Hiện nay	現已
ức chế	抑制
Trường sa	長沙
bệnh lao	結核
ngắn	短暂
chân tay	肢
Bài hát vàng	金曲
lẫn nhau	互
Ni	倪
Bà ấy	佘
tiền lương	薪水
Âm	龑
Bùi	布宜
Vincent	文森
Không	上沒
Vắt kiệt	抅
mời gọi	邀請
Trường hợp	该案
Làm nhục	諉
còn lại	遗体
Kẹo cao su	龈
Ủy quyền	代理
Mảnh này	這塊
Trên bờ vực của	瀕臨
ête	醚
Hoàng đế	帝王
Dinh thự	府邸
rừng tre	篁
Đàn piano	琴
con trăn	蟒
uống	喝
Từ ngữ	詞語
Những trạng thái	個州
Yuxi	於西
Thủ lĩnh	领军
Fiasco	惨败
Nghệ thuật và Khoa học	文理
Và hơn thế nữa	及於
vì kèo	椽
lòng bàn tay	棕櫚
Yue'e	月娥
Qiu	邱
hạt dẻ nước	薺
sau đó	接着
người Pháp	法属
Phải	只得
Runan	汝南
Nhón chân	踮
phá dỡ	拆毁
trà	茶叶
mài ngọc	礪
cắn	齮
Tiếp theo	下述
Thịt ba rọi	培根
Cho vẻ đẹp	為美
Đã in	印製
tránh xa	逃離
Thu phí	收費
Hội nghị	国会
Cao cấp ba	高三
Tây An	譋
giải thưởng	獎
Nuo	傪
Tần	秦
Gu	虢
Phục hồi	平反
Fu	馥
Thời gian thực địa	場時
Thời thơ ấu	兒時
Từ là	字為
Ngồi về hướng bắc và quay mặt về hướng nam	坐北朝南
Dưới rừng	林下
Sao chổi	彗
Yan	彥
nấu nướng	烹饪
leo lên	攀登
Tham dự	參
Áo giáp	裝甲
con rái cá	獺
trừ khi	除非
Cá mập	鲓
Nhiều con hổ	虎隊
Chan	铏
Mang hành lý	載客
Lễ	典礼
Chỉ	展演
Được lai tạo	孕育
Bụi bặm	掸
Viên thuốc	丸
sự thật	真相
vở ballet	芭蕾舞
viêm phổi	肺炎
Nán lại	縈
Cho cả nước	為全國
Di chuyển	感动
Gặp	會及
Di tích cổ	为古遗址
Napoléon	拿破崙
Hoàng	湟
Sự sụp đổ	溃
Rong	穐
buổi sáng tốt lành	早安
bỏ trốn	逃走
Cờ vua	象棋
Đi lang thang	徨
Hejian	河间
Quận Cao Hùng	高雄縣
tìm	谋求
Bởi	會由
Yazu	雅族
hoang dã	猖
Xiao	霄
Sting	螇
Imine	亚胺
Trái bóng	鲍尔
Mã	代码
Tổng chiều dài	總長
Vấn đề	颁发
hiện đại	現代
tần số	頻
thiền học	禪
Kunio	國雄
Shu	澍
Hướng biển	海景
mu bàn chân	趺
Haizi	海子
Tang	棠
kho báu	珍寶
hướng dẫn	引导
Thính giác	聽覺
Ji Shi	紀時
Bởi	經於
công bằng	等于
Luật	律法
Nhóm	群組
Siheyuan	四合院
duyên hải	沿海
Nhà thờ	聖堂
Yell	啷
Rối	悎
Mập	肪
Yu	瑺
Máy là	機為
mỗi phút	每分钟
Điều này có thể	這可能
Sẽ làm	會令
tuyên bố	说法
Sher	谢尔
phía đông	东部
Trục	辕
Quá đáng	过分
mạnh	浓厚
Ngắt lời	闯入
mỗi tháng	每月
Cú đánh	捋
Vì mục tiêu	為目標
thua	损失
Bạn	妳
Grate	篦
địa điểm	场所
Dân chủ	民進
trên hầu hết	最上
Diễn viên	施放
Tang	衸
cây sồi	橡
Triều đại Bắc Tề	北齐
Thuế	稅收
Ga tàu	口站
Nhà gỗ	木屋
đổ bộ	降落
Nắm lấy	抓捕
Châu Âu và Châu Mỹ	歐美
trước	提前
hoàn thành	畢
Như là	此类
Portland	波特兰
Cú	鮸
Tảo	藻類
Ăn chay	素
Bộ Đường sắt	铁道部
Jeff	傑佛
tai	穟
Li	嘝
Nét chữ	字体
ánh sáng mặt trời	日照
Tỉnh ngày	日省
Giáo xứ	堂区
Erna	爾納
Beiliu	北流
Constantine	君士坦丁
Lực lượng đồng minh	盟軍
Gian lận	詐
Chịu	熊
Phát triển như	长为
Tát	跼
Yu	箦
Dải mềm	軟條
Sân khấu	登台
núi	山体
phía đông	屬東
thời gian	顳
Calton	尔顿
tiếng Ả Rập	阿拉伯文
Sha Tau Kok	沙頭角
Connaught Road	干諾道
Đại liên	大連
Ngắn	矮小
bắc Carolina	北卡罗来纳
thuốc độc	鸩
bắt đầu	开头
Đúng giờ	合拍
dân thường	庶民
thùng	槍管
có hiệu lực	有效
Số Pi	邚
Yao	爻
thể loại	類的
tài giỏi	玅
Liền kề	相邻
Giá cả	耗资
điện	电动
Đêm	晩
Quá lâu	過長
thị trấn	集镇
Sự tận tâm	奉獻
Thư viện	庫
giáo dục thể chất	体育
gói hàng	包
Năm đầu tiên của Trung Hoa Dân Quốc	民国元年
do thám	偵察
tùy chỉnh thực hiện	定制
trang nghiêm	莊嚴
phần nhỏ	分數
kiện tụng	诉讼
Zhongzhou	中州
Tây An	峴
không phải	侌
đời sống	寿命
sự sáng tạo	创作
Giống như	正如
lấy quá phần	豕
Đảng Bảo thủ	保守党
Marguerite	瑪格麗
Bao vây	薟
phút	分鐘
Ăn uống	用餐
khoa học	理科
Đẹp	帅
quyền anh	拳击
ngọc bích	玉石
cung cấp	補給
Nhà pháp lý	法家
cây phong	楓
tham dự	參與
Nghệ thuật	文藝
tuổi tác	龄
Hun	郃
Vợ của anh ấy	其妻
Luân	灤
Hu	浒
Đức phật	菩萨
Góa vợ	寡
Phòng ban	科系
Cho mới	為新
cổ áo	领
Dazhao	大钊
Ying	莹
một chút	一下
Chờ đợi đất nước	等國
Viết	寫道
Prince Consort	駙
Nước Anh	列顛
đã đính hôn	訂婚
Vigie	維吉
Reis	雷斯
cắt giảm	减少
Người lạ	奇人
lạnh	冷
Yaren	雅人
lộ ra	揭發
Mai	媵
Hóa đơn	比尔
Thời gian	時
A	一輛
sản phẩm	產物
Carbine	卡賓
cà chua	番茄
Lil	利尔
Ngăn cản	攤
Lê	梨
Shashi	沙市
Tiangong	天宮
Cột	纵队
insulin	胰岛素
rỉ sét	鏽
Haifeng	海峰
Havana	哈瓦那
Đêm	晼
Đức phật	佛像
Ôm	耱
Ít	小小
báo cáo	报告
Người vẽ tranh minh họa	插畫家
Sông Danshui	淡水河
Dương	暘
Koji	麴
Thiến	阉
Được	考取
bệnh đậu mùa	天花
người Hy Lạp	希臘文
dấu vết	痕迹
Xin Chou	辛丑
London	倫敦
Luật gia	法学家
Ghế ngồi	議席
Phospholipid	磷脂
Su Zhenchang	蘇貞昌
một ngàn	一千
Sát thủ	杀手
Sự khác biệt	差分
Lười biếng	惰
Trộn	混交
锓	鋟
Anny	安尼
Tôi	亻
ngón tay	手指
Đóng quân	驻扎
Khói	熏
Mộc qua	楂
Năm tiếp theo	翌年
ewe đen	羖
trung tâm	轂
Newt	螾
Chiến lược	方略
Flo	弗洛
Và nói	並說
Thành phố tokyo	東京市
Bộ trưởng	部级
Yongping	永平
Chi	馳
Tây tạng	藏人
Người phương tây	西人
Ngọc bích	桷
tuân theo	服从
khéo léo	整齊
Đảng viên	党籍
Âm	癔
trang	專頁
tính cách	性情
Đếm	數來
Bo Xi	薄熙
Bang	嘭
Đã chọn	入選
cơ bản	根本
Cấu trúc nhà ga	車站構
thô lỗ	傖
Khó xử	狷
tinh thần hy sinh	鬯
Tuyến giáp	狀腺
Và	呾
Bruce	布鲁斯
rửa	洗
Jianye	建业
Thanh	大清
Chuyển sang	转向
Nhà kinh doanh chính	主营
Điều chỉnh	调整
Gia trưởng	祖師
Cặp cạnh tranh	競爭對
Sân bay	空港
Cá hồi	鳟
bẩy	阱
Trước pháo đài	堡前
Dài	迌
Có màng	蹼
Sáng tạo	创意
Người mang	承载
Trùng Khánh	重慶
Tiếng Mã Lai	馬來
Điện lực	电能
chặt chẽ	嚴密
Cảng Tolo	吐露港
cáng	格尼
Vui lên	誷
Li	澧
Lãnh thổ	域性
Lên kế hoạch	計劃於
Đi lang thang	罗夫
Jintao	錦濤
trực giác	直觉
Phi tuyến tính	非线性
nhẫn giảCơm	忍者萊斯
Cái cày	普洛
Số lượng	紅雀
Phương pháp giảng dạy	教法
trong thực tế	其實
nhóm	集团
số nhiều	复数
cộng sự	伙伴
đọc hiểu	读书
trái cây	果實
Theo dõi bởi	其後於
Dài	龍
Jiangbei	江北
ytterbium	镱
Nghiên cứu sinh viên	生學
giấy phép	许可
Nói dối	利埃
Càng nhiều càng tốt	尽可能
Gọi	喚
Chết yểu	早逝
người sống sót	幸存者
Lỗ rốn	脐
Ren	仞
Cây cầu	该桥
Sau khi thành phố	城後
Husay	侯赛
Sự kiện cổ xưa	古事記
Pháp luân công	輪功
Làm trầm trọng thêm	加重
Cymbal	蒹
Nắm bắt	奪取
Điều đáng tiếc	憫
Người hầu	侍郎
Hu	斆
Ga cuối	總站
Ulva	蓴
giải tích	微积分
Mini	迷你
Mới	新任
Camera quan sát	央视
Tàu hơi nước	轮船
tuân theo	堅持
magiê	鎂
Sil	西尔
bài hát	曲
Ling	潣
Galicia	加利西亚
Ôm	眜
khỏa thân	裸体
Năng suất	益格
Tokugawa	德川
Tsuna	綱鰻
Quê quán	本籍
Đi ra	面世
mặt trăng	月亮
soi sáng	照亮
Như	身為
Tục tĩu	亵
Tổng hợp hữu cơ	有机合成
đỉnh	顶点
Quận ở	區於
Rất mạnh	很強
Làm xong	做過
Leslie Cheung	張國榮
âm thanh	音
Chia ra	分在
Gle	格萊
Bật	开启
Quảng trường	正方形
Li	栐
bảo vệ	守護
nhà vua	為王
Shangri-La	香格里拉
Paul	保祿
Màu xanh da trời	布魯
giảm	降低
Waka	和歌
tị nạn cho người già	庠
Baltimore	巴尔的摩
Âm	崟
Sau khi độc lập	獨立後
Người ta nói	人說
Đàm phán	交涉
Trong sân	院内
hơi nước	烝
còn lại	遺跡
thái giám	宦官
Yan	橉
Đóng	闔
Cư dân	住户
mụn nhọt	疙
Quái vật	怪兽
Mai táng	安葬
Zhang Jun	張俊
Ringo	林檎
Độc quyền	專屬
Thời gian Jie	時捷
nhìn trộm	闚
Khối	區塊
Xuân	焑
Giải đấu	巡回赛
Thông báo	通報
Takano	高野
Biên tập	輯
Ba vương quốc	三国
đôi khi	有時
kỳ nhông	鲵
Đi nước ngoài	出國
Cho là	說是
Dẫn đến	通向
Chu	楚
họa sĩ	艺人
Tru	特鲁
Nơi ở	去向
động từ	動詞
đạo Hồi	回教
Chim	愨
thay đổi	變遷
tổng thể	總體
Được biết như	號稱
Dựa vào	憑著
đấu tranh	掙扎
Đánh bắt cá	釣
không rõ ràng	怳
sự khôn ngoan	智
ngoại lực	外力
nhóm	糰
Nhện vườn	园蛛
Fu	飥
Người bán hàng giỏi nhất	畅销
cây rum	红花
mụn cơm	瘊
Vì thế	所
làng	庄
Hội nghị	國會
Chùm tia	桁
Tàu chiến	戰艦
ném lên	吐
mong manh	饈
mở rộng	拓展
Ăn cắp	赃
Mar	馬爾
nhỏ	小的
đường chân trời	天界
Hu	滹
Dòng chảy	湧入
chai	缾
Nhỏ hơn	越小
lợi thế	优点
bằng cấp	資格
Kinh tế học	濟學
Trong ngày	日内
nạn nhân hy sinh	餼
Chào	欶
Hồi hương	遣返
Fei	淝
Học	求學
Con nuôi	养子
đấu thầu	殀
sự phối hợp	协调
Dendrobium	閛
trục	樞
khuôn	霉
bất động sản	財物
Tốc độ thay đổi	變速
Cymbal	璹
cầu lông	羽毛球
Đưa cho	予
dấu	标
ăn mừng	慶祝
Thành phố đông quan	东莞市
bị ràng buộc trong một giải đấu	绻
Âm thanh gốc	原声
Las	拉斯
mẫu vật	樣本
Không thể	不可以
Lỗ rò	瘘
mơ	夢想
Phá vỡ	掻
Những năm bảy mươi	七十年代
sinh con	分娩
nổi bật	突出
Sikkim	锡金
Địa chất học	地质
Chất lượng nước	水质
Sting	斯汀
có thể thay đổi	多變
Như sau	如下表
trọng lượng cơ thể	体重
Nắm được tin tức	知情
Được phân loại là	劃為
Niêm phong	璽
Về nhà	回家
Một chín	一九
Trở nên giàu	致富
Cao cấp	高端
Mei Kai	梅開
Tây An	西安
Del	德爾
Đồ chay	素食
uống	饮
Thuật sĩ	巫師
Thong thả	刻意
lấy đi	帶走
Campuchia	柬埔
Dublin	都柏林
Sự thành công	佳績
Heyuan	河源
sâu	深厚
bẻ cong	彎
Lương Châu	涼州
Budapest	布达佩斯
Sabah	沙巴
Sun Wen	孫文
Nam Dakota	南达科他州
Ven sông	河畔
Với Trung Quốc	與中國
ga tàu điện ngầm	地铁站
Sự hy sinh	祭
kế hoạch	策划
Biển Đen	黑海
Tốc biến	閃記
Cũng sẽ	亦會
Hiểu rồi	了這
yêu thích	喜愛
Cái rổ	篓
Dưỡng bệnh	療養
bao quy đầu	包皮
trường học	流派
Xây dựng	樓設
Nữ hoàng nước anh	英女皇
Lên đến	達對
hồi phục	复原
Kỳ hạn	项式
Dông	雷暴
tai họa	瘟疫
Chuyển động	樂章
bay	鏝
cung điện	英殿
Góc trên	上角
Mm	公釐
Zhu	朱
Người Duy Ngô Nhĩ	维吾尔
khoai tây	馬鈴薯
Nộp thuế	纳税
Phân họ rồng	龍亞科
Bộ sưu tập	馆藏
không bao giờ	從來沒
Thần thành phố	城隍
Chongming	崇明
Gọi ra	吁
Diên An	延安
Vấn đề	其事
Thành phố Nagoya	名古屋市
Luận điểm	權主義
Tần	鑓
Buổi tiệc	晚会
Những người lính	將士
Đã học	得悉
Chen's	陳氏
người phát triển	發展商
Chung	共通
kiềm chế	錮
Yangcheng	阳城
cứng	硬
Ruồi Tây Ban Nha	蟊
hình thức	形式
Bay tới	飞往
gỗ	木
Vắt kiệt	挄
Đề cập	提起
bảo vệ	守护
Xuất hiện	顯得
Âm lượng	運量
Nico	尼古
Quạt	藩
từ tính	磁性
Nhà Thương	商朝
Ghế ngồi	议席
thay đổi	改变
Chu	蜾
không gian	空地
Chirac	希拉克
Enlai	恩来
Chanh	檸檬
Bắc Mỹ	北美
rừng	森林
Algeria	阿尔及利亚
bông	棉
Ngoài	而出
Cướp biển	盜
Nhân Viên	参谋
chớp	栓
Poplite	腘
Quán tính	动量
xóa bỏ	删
Zheng	筝
Dell	戴爾
Số fax	法克斯
đời sống	夀
năng suất	屈服
Châu Á	亞洲
Ở giữa	中產
mệt mỏi	駘
Ye	闃
Lu	鸒
Sự thụ tinh	受精
Rình rập	艅
phần tiếp theo	續集
Tỉnh Nagano	長野縣
chiến binh	战士
người nhận	接收器
Sáng tác	作曲
Chức vụ	阵地
Treo	劊
Hu	湻
Thời Đông Hán	東漢
Aru	阿鲁
Bản tin	公报
Bãi đậu xe	車場
Mạng lưới đường bộ	路网
Chỉ	匯演
tiếng rít	吱
Tiếp xúc	来往
Tây An	慂
Mở rộng	扩展
phẫu thuật	手术
Trung niên	中年
Yi	逸
Tàn phá	宭
Yichang	宜昌
Mongoose	鍴
Sách Đường mới	新唐书
Shift	移位
phương châm	标语
Tái tổ chức	整編
Boda	伯达
Mua lại	收购
bạo loạn	骚乱
Nên	應
làn da	皮
Sự hỗn loạn	熵
phân	粪
Shao	諪
thư	邮件
Trạng thái gốc	根州
kích thước	尺寸
quan tâm	興趣
vị thành niên	少年
hồ nước	湖
Mang lên	培養
Khu vực thành thị	城区
Đau khổ	飽受
Tai nạn	事故
St	斯德
Họ	百家姓
Lang băm	戫
Nữ hoàng lớn	大後
Con rắn	鳛
Dòng sông trắng	白河
quyền lực	动力
tiếp tục	發揚
Tin tặc	駭客
chiếm đóng	佔領
sử dụng	運用
Được soạn bởi	編制
vào thứ bảy	周六
Trung gian	中级
Dựa vào	憑藉
báo trước	警告
học nghề	學徒
Cuối cùng	最後
ban nhạc	樂隊
Ba mươi tư	三十四
Keichang	慶長
Quyết định	下定
Bị bỏ rơi	廢棄
Dám nghĩ dám làm	进取
lý luận	盭
Phát âm câu	宣判
Có tính axit	酸性
điền trang	地產
tiết kiệm	保存
Mở rộng	擴
Giữ	挽留
xấu xí	陋
đế chế Ottoman	奥斯曼帝国
ở giữa	當中
Từ	源自
mù	盲
Nói	的說
Không đồng ý	不合
Hình trụ	缸
Chi nhánh	分社
Cuối cùng	楦
Thử vai	試鏡
Zhu	趉
sông Mississippi	密西西比河
Sớm	早期
Chung	大将军
cuốn tiểu thuyết	长篇小说
tốt lành	吉利
cùng với nhau	一起
Hoàng đế	法皇
chư hầu	附庸
Quần đảo Yana	亞納群島
Ví dụ	例如
Đàn ông	嫚
Gado	加多
Burke	伯克
kim loại	錀
Phun	噐
công cộng	公眾
Đột quỵ	中風
Sené	塞內
tiệc	觞
Yi	屹
danh tính	身分
chinh phục	征服
Mùa	球季
Trà	荼
Sự phẫn nộ	愤怒
thủ đô	都城
Những bông hoa	花朵
Có	育有
Bức tượng đồng	铜像
Stoke	斯托克
Xingchi	星馳
đỉnh cao	頂峰
khởi đầu	启
sự sụp đổ	崩潰
Renault	雷諾
Gò	坶
Ava	阿瓦
Thị trường đầu	头市
cà phê	咖
nghiêm trang	惓
hoa sen	莲花
Thủ thuật	花样
Kinh độ đông	東經
trưởng khoa	迪安
Xấu hổ	鋗
Nick	暱
xấu xí	媸
Tân Cương	新疆
mua chuộc	賄賂
vì thế	因此
đấu thầu	夭
chi nhánh	分会
Arsine	胂
Bosnia	波斯尼亚
Michele	密歇
Lauren	勞倫
gửi	派遣
Thương tiếc	哀悼
phi	撺
Dehydrogenase	脱氢酶
Giải thưởng cuộc thi	獎賽
Suy ngẫm	反思
Miami	邁阿密
cánh tay	军火
Thai kỳ	姙
bốn mươi	四十
Tổng lãnh sự	总领事
Chủ nghĩa dân tộc	民族主義
căn bệnh ngoài da	癞
Đa dạng	變化
Độc thân	单一
Quê nhà	家镇
thối rữa	衰变
Quay lại	回到
Tiêu thụ	消耗
Bậc thầy	當主
đổi tên thành	改名為
ấm áp	温暖
tạo nên	創造
Một số	某个
Trên đồng ruộng	場內
thiếc	錫
thứ mười chín	第十九
trụ sở chính	总公司
kinh sợ	憚
Indy	印第
ngày	昼
Chiếm lấy	捕捉
chuột	滑鼠
lưỡi	刄
Thành viên của bữa tiệc	党员
Qamdo	昌都
Điểm nổi bật	突顯
Suiyuan	绥远
Quảng cáo truyền hình	電視廣告
sống động như thật	逼真
hỏa tiễn	導彈
Cướp bóc	劫掠
phân phối	分布
giải thưởng Nobel	诺贝尔奖
Chuyển sang	轉向
Thảo luận cấp huyện	區議
Ria	里亞
Phiền muộn	凹陷
Hai cái đầu tiên	前兩
giải thưởng lớn	大獎
rung chuyển	抖
Cao	髙
Sững sờ	拀
Ngoan đạo	虔
Quen thuộc với	熟悉
tay áo choàng	袂
miền Nam	南部
Tên tuổi lớn	大牌
Du lịch	旅遊業
Thành phố phẳng	平市
thị trấn	镇
Đường	醣
Đa phương thức	联运
phòng thủ	防务
Mar	马尔
Hiện tại	呈现
sợi	紗
Sáng	明亮
Ethiopia	埃塞俄
cây sồi	櫟
khu	地帶
Trong thành phố	城里
Đất sét	克莱
Tâm thần học	精神科
người máy	机器人
bảo vệ	衛
Thành phố sinh đôi	雙城
Mực ống	鱿
Palla	柏拉
lụa dày không thấm nước	缣
Không tệ	不錯
Đi qua	橫貫
binh biến	兵变
lá thư	信
ổn định	稳固
Bắc Âu	北欧
nhảy	躍
Lớp khí	氣層
đếm	计数
Gia Cát	诸葛
đám đông lớn	侁
Kẻ bắn tỉa	狙击
nhân viên	人事
đi vào	輸入
hạn chế	约束
Ga xe lửa phía Tây	西站
Tes	特氏
Yi	弅
Cá mèo	鮎
Đồn cảnh sát	警署
Cùng với	亦以
Đặc trưng	特色
Fetter	镣
Song Zhenzong	宋真宗
Yu	聟
Truyền hình Fuji	富士電視台
Hạt Xi	溪县
Scott	斯科特
ngoại ô	郊區
Hoàn thành	達到
Tên chung	联名
Vàng	金子
đặc biệt	特意
hằng ngày	日報
gia đình hoàng gia	王族
Phi hành đoàn	機員
Kỳ quặc	奧德
Messi	梅西
Nói dối	諰
mặt trời	荪
Bắc Chu	北周
Nhìn qua	覜
Sau sân khấu	台後
Que	阙
Carlos	卡洛斯
Dennis	丹尼斯
Ngành điện ảnh	影業
kê đen	秬
hỏi	詢問
Thành phố Chu Hải	珠海市
chạm tới	河段
Lun	綸
Và học hỏi	與學
hình đại diện	头像
Quận thành phố Cửu Long	九龍城區
Hee	熙
Zhuo	趿
Công	鞏
Nam giới	雄的
Thời gian từ	時從
Epi	埃皮
cá voi	鲸
Nổ tung	炸毀
Liên kết	聯會
Chức năng	职能
Tung và quay	輾轉
Chảo	鑊
Nổi danh	名家
lực lượng lao động	勞動力
người hầu	傒
Danh tính	身份
sự phân chia	师
sạc điện	冲锋
Dư luận	眾議
Huấn luyện viên	教練機
Như là	此類
Dương	楊
một số	幾個
Hoạt động	劢
Lập kế hoạch tổng thể	统筹
bồn tắm	浴
có	有著
thuần hóa	驯
tập thể dục	锻炼
Tang	椢
Cá hồi	鮭
Ge	戈
cấu tạo	构成
Vì sự thống nhất	為統
Gushan	孤山
Chính trị	政
Ting	婷
Kết thúc	越過
Con số	番号
Sâu	蚖
Protactinium	蕤
văn phòng	辦公室
Tê liệt	瘫
cấp	發行
lạnh	冷淡
trang viên	庄园
xưởng	车间
Miệng rộng	大口
con bò cạp	螶
Thời gian chạy	行時
Tinh tế	傜
Sóng âm thanh	音波
Zi Li	子力
Lun	倫
Gibb	吉布
Khai mạc	開幕
Đường dây bên ngoài	外線
khảo sát	勘测
Thông báo	通报
Dawei	大为
Regon	勒岡州
Theo	随之
Thành phố Đài Nam	臺南市
Newton	牛顿
Hải sản	海鮮
Thiên thần	天使
Sẽ ra	會出
Đề cập đến	指代
Sự công bình	義為
nhà hát Opera	術館
Trận đấu	賽
Đền bù	償
Vượt qua	為傳
ở đằng trước	前鋒
Đường sắt	铁路线
Đơn giản	樸
Xua tan	袪
Dư thừa	多余
Chị dâu	婔
Sakai	堺
Ba mươi	第三十
bỏ qua	辭退
Nghiệp	業為
Chòm sao cá	鱼座
Rime	凇
Sự tôn trọng	敬重
kính hiển vi	显微镜
Tôi	一世
kẻ móc túi	掱
Macaque	猕猴
Tần	芀
bass	低音
Biến đổi	变量
bươm bướm	蝴
Sahara	撒哈拉
Đăng ký	簽約
gì	咦
Thông qua	維亞
Kinh phí	经费
Ghi lại	实录
xưởng	作坊
tấn công	攻打
Bang	倓
Kết cấu	构
Đằng sau hậu trường	幕後
kích thước	維
phi tiêu	镳
giống	類似
căng ra	伸
Chìa khóa	键
Mở cổng	開埠
đơn giản	簡單
Hexi	河西
Plantar	蹠
Nói	曰
cao	嶒
Âm	鱇
Lên và	上與
Tổ tiên	祖宗
Nheo mắt	睩
Phân họ	亞科
Nhận thức	感知
cái thước	尺
Nets	涅茨
Một đất nước	一個國
Champions League	歐冠
Bầu trời đêm	夜空
điều chỉnh	萸
Con dấu vàng	金印
thông gió	通风
Gossa	戈萨
Playoff	附加賽
Giá ba chân	腳架
chân trươc	前肢
Con trai của nó	其子
Qian	芊
Thorium	蒍
giàu có	富裕
Frankfurt	法兰克福
Họ	们
Bạn có thể	則可
quân đội	軍
Cổng phía đông	东门
Nhưng khi	但當
lót	衬
Quân đông bắc	东北军
Lựu đạn	榴彈
Tải	載
quan tài	棺
Trong khuôn viên trường	校内
kiến trúc sư	建築師
coban	钴
So	對比
lặn	潛水
Ao	翺
hoặc là	或者
Mọi người	时人
phim ảnh	薄膜
hạn hán	干旱
Phát triển như	長為
Lượng calo	热量
Con gián	蠺
Canon	佳能
Quay lại	後由
Nói dối	坾
bóng bẩy	瀡
đầy	滿
cắt mũi	劓
Bà ấy	晭
Đã kết thúc	完工
chính xác	精确
Nurha	努尔哈
Yu	霬
Marguerite	玛格丽
rất nhiều	很多
Parkin	帕金
Thủy văn	水文
tên nick	暱稱
Đan Đông	丹东
Pal	帕尔
baht	銖
ăn mòn	腐蚀
ngoan cố	婼
xe máy	摩托车
Dora	哆啦
鲠	鯁
Thượng hạng	套房
vỏ trái đất	炗
mệt mỏi	骀
ổn định	櫪
Vladimir	弗拉基米尔
Định Châu	定州
giống	喜歡
Một hớp	圕
Tỉnh	知縣
ao	溏
gầy	薄
Đầu nguồn	流域
Kéo ra	拉脱
Người Duy Ngô Nhĩ	维吾尔族
Nước sông	河水
Lập kế hoạch	規畫
phần lớn	最
Tái cấu trúc	改制
Lin	蕂
Hoàng tử	诸侯
Kéo dài	横跨
Chia	划分
vẽ tranh	绘制
Máy trục	克兰
địa chất học	地质学
Đừng	不要
sở hữu	擁有的
Se chọn	會選
Lanyu	蘭嶼
màu sắc	彩
Trường Xuân	长春
đường kính	直径
dựa theo	依
Mi	彌
Tự học	自修
Thân cây	幹線
Hoa đào	桃花
Vui lên	謋
Alice	翘
Giữ	召開
Xe ô tô	该车
Làm lơ	忽视
Thế kỷ XX	二十世纪
đặc biệt	特製
bí mật	机密
Hai	兩張
Ngứa	瘙
Nắm bắt	掕
không còn nữa	不再
Nhịp tim	心跳
cột	栏
Bài thơ	诗作
Guadi	瓜地
Kuma	鈚
Uzi	乌兹
Xuân	瑨
cá tráp	魴
Chân tay	四肢
Kéo	拽
vạch sọc	條紋
thâm thúy	邈
Học viện	书院
mặt nạ	面具
Xấu hổ	覩
Ả Rập	阿拉伯
Ngoài ra	此外還
Quảng Đông, Trung Quốc	中國廣東
Dính vào	死守
Và khi	而當
suy nghĩ	认为
Lên men	發酵
Chờ đợi	等處
nhà thám hiểm	探险家
Giải thưởng	奖项
Hôm nay	盛期
Ghi chú	诺丁
Lu	盧
Sẽ để cho	會讓
Ainu	阿伊努語
Ngày thứ bảy	初七
Tòa án	閣
cỏ dại	葍
vào buổi sáng	早晨
Perth	伯斯
quá trình	过程
riêng	具体
nhà vua	先王
Lấy	取的
Dâng trào	激增
Ska	斯卡
Rễ cỏ	草根
Jin	璙
thành phố Taichung	臺中市
Khó xử	狦
Diễn dịch	解读
Unicom	联通
Ga tàu	站內
cổ điển	经典
Salzburg	萨尔茨堡
Yan	剭
Xi	埅
Và	與阿
Goring	戈林
Hội họp	场馆
Tây á	西亚
Biển vàng	黄海
nhà thiên văn học	天文学家
để lại lời nhắn	留言
đường	途徑
Xưởng phim	電影製作
sửa đổi	修改
khỏe	精细
Tai Fu	太傅
bốn nghìn	四千
Zurich	苏黎世
Bất lợi	劣勢
Tiết kiệm	俭
Lên đường	出征
Đẹp	靚
Kỹ thuật	手法
nén	压缩
đỏ và trắng	紅白
Loại là	種是
Biệt thự	山莊
Mệnh đề	子句
nhọt độc	癰
Sự chuẩn bị	筹建
Than van	潅
Shichong	世充
Kato	加藤
trăm	百
công ty	公司
Mỗi người	每位
ngọn hải đăng	灯塔
Cùng họ	同姓
gập lại	摺
Gọi cho	號召
Sim	希姆
Gai	苎
Ngã tư	交點
Được gán cho	歸於
di chuyển	迁
Chek Lap Kok	赤鱲角
khu kinh doanh	商务区
Niệu đạo	尿道
Bắt cóc	绑架
Nước tiểu	尿液
Xóa sạch	橏
Xuất hiện	出场
Nhanh	倏
Bộ sưu tập	藏品
thuốc uống	藥品
Liu	劉
Bỏ lỡ	缺陣
đáy biển	海床
Tường thuật	叙
Xuống	而下
Tát	撢
phim hài	喜剧
khá	蛮
lừa	招
Quấy rối	騷擾
công việcYuan Yu	工院於
nhọt độc	痈
Tam Hiệp	三峽
đầu mũi tên	镞
Tàn tật	瘈
trêu chọc	逗
Sự bảo tồn	守恆
Vẫn là nước	澶
nổi danh	闻名
Wu Yingdian	武英殿
Chen Guo	陳國
Tyro	蒂罗
Enzyme	酵素
Phát hiện	检测
Tàu	船艦
Dược phẩm	制药
Khởi xướng	發起
Dia	迪亚
Chống	安提
bụng	腹部
Hookup	聯播
Đột nhiên	驟
Trở về	上還
cá nhân	亲自
Trận đấu đầu tiên	首場
Thế vận hội	奧運
Không tốt như	不如
Mẫu giáo	幼稚園
Yu	騆
Cichlid	麗魚
Cấp dưới	下级
Nội dung dòng	線體
Zhuo	卓
Kéo dài	倎
kính thưa	旳
hoang dã	野生
ngưỡng cửa	槛
hỏi	問
Tianshun	天順
bề mặt	表面
Liêu Ninh	遼寧
máy bay	客機
Riêng tư	民营
Nhân dân tệ	人民幣
Sway	澋
xẻng	鍬
thuốc uống	药品
Vùng dòng chảy	内流区
Hoàng đế	黃帝
choáng ngợp	壓倒
Và có thể	並可
Bán	贩
nguyên vật liệu	物料
Ma Ying	馬英
Leah	利亞
loạt	级数
Tây An	齉
đi kèm với	偕同
Foote	富特
Loggerhead	頵
Okayama	岡山
Bất lực	无奈
Si	姒
xe máy	摩托車
Zhen	轸
Sẽ ở	會於
Vòng loại	预选赛
nổ tung	爆破
Wudu	武都
Ngon ngọt	隽
Hở	誒
Phil	菲尔
columbium	钶
Từ có nghĩa	義詞
Dung nham	熔岩
mực nước biển	海平面
công việc	辦事
Tuyến tính	線的
thành lập ở	始建於
Hai bàn là	兩鐵
Lớn	耤
Kip	硖
Háu ăn	餋
Bo mạch chủ	主板
cửa tiệm	店铺
Rudolph	鲁道夫
Triển khai thực hiện	实行
mùi nước tiểu	臊
Họ hàng gần	近親
Quốc gia	之國
khuôn viên	校園
Sâu	薝
Huyền phù	停賽
Dinh thự	宅第
than đá	煤
Một lát sau	稍後
Xấu hổ	鷭
giật mình	愕
Jiangshi	江市
Tường thuật	记述
ngày hai mươi chín	第二十九
Kéo	摳
nhiệt	熱
ho	咳
đường	路
tầng hầm	地下室
Bệnh đa xơ cứng	女士
sau đó	则
Quay đầu	陀螺
Rouran	柔然
yêu cầu	聲稱
gia vị	虀
Tình hình	处境
Li	銊
Bom tấn	大片
Quebec	魁北克
nguyền rủa	诅咒
Thập phân	十进制
Nhà Thương	商代
Sáng	炯
thừa	贅
Xung quanh	四周
Tuyệt chủng	灭绝
Bao vây	厾
đã đăng ký	註冊
Nhân viên	僱員
Rút lui	退居
bỏ rơi	抛弃
thực hành	實踐
Đi qua	穿過
Yong	镩
Na	吶
trước mặt	前面
Giang hồ	流浪者
truyện ngắn	短篇小说
Không hòa tan	不溶
Nobel	諾貝
Tầng hai	二樓
đủ	彀
Bài hát	崧
Mờ nhạt	澐
Xa lánh	順
khai hoang	開墾
Doanh trại	兵营
Chahar	察哈尔
Vsk	夫斯克
sách	書
Cá cược	押
Tòa nhà	主場
sách	圖書
bên	側面
Năm	數年
Shan	顬
Jiang Sheng	江省
Mũi tên	矢
Tiên phong	前衛
phần thưởng	賞
chiến trường	戰場
dựng lên	剚
Hoảng sợ	戹
Mu	沐
Zhaizhen	寨镇
Con vịt	达克
đưa lên	建造
Pháp sư	法師
Roman	羅門
Lombok	龍目
ruy-băng	綬
biện hộ	倡
Rùa	鳫
Phình to	膨
Bán đảo Ma Cao	澳門半島
Loach	鰒
Ziwu	子午
đời sống	性命
trao	胙
chính trị	政治
Rồng	龍屬
Vắt kiệt	搾
Bóng chày	蛄
Của	斯的
Pháp sư	法师
Chúa tể	之主
Tháng sáu	鈞
hôm nay	今日
Quận	個區
kỷ niệm	纪念
khủng bố	恐怖主义
Gu	袙
Âm mưu	地皮
chính xác	确切
Y	郷
bộ phận sinh dục	生殖器
Một mình	一個獨
Yu	牥
gãy xương	断裂
Chơi	奏
Vui mừng	歡
Nhìn	瞻
màn	筛
thương mại	贸易
đấu kiếm	击剑
Đinh ba	三叉
Kỳ dị	乚
cá mập	鯊
Quân đội Đức	德軍
Album phòng thu	錄音室專輯
Turkestan	突厥斯坦
Toàn bộ	共
Dòng đến	來線
Phố tây	西街
Mất đi	丢失
Dừa	椰
Tình hình chung	大局
Pan	箠
Bi	碧
Changan	長安
Núi Ciyun	慈雲山
Thanh kiếm	寶劍
đưa cho anh ta	給他
Đen	布莱克
Biển quảng cáo	告示牌
quả anh đào	樱
Đối với vòng tròn	為圓
tan chảy	鑠
hoàn toàn	截然
Gram	剋
Tia sáng	射線
đã sẵn sàng	已经
nước Đức	德國
Thacker	撒克
rực lửa	煝
Cũ nhất	最久
vận động	征戰
Teng	騰
Trong khoảng	約佔
Vào chương	成章
Năng lực cạnh tranh	竞争力
Anh trai	哥
Trái	遗
xe tắc xi	出租车
lạnh	感冒
Yonne	约讷省
Đẹp	詑
Gini	基尼
M&A	併購
Đang xảy ra	情況
Kosovo	科索沃
Cho và	為與
Răng nanh	舑
Chăm lo	照顧
Nhện bụng	腹蛛
bụi bặm	尘
Ngốc nghếch	黆
đoàn kết	共识
Tiếp tục sử dụng	沿用
Fucheng	府城
kết thúc	收場
to tiếng	嘂
vào ban đêm	晚上
New Caledonia	新喀里多尼亞
Massachusetts	马萨诸
Nói	說
Danh mục	清單
Có lẽ	也许
Kinh doanh	商界
Thấp	低
Zhong nói	中說
opera	歌劇
Làn sóng	挥
Dược liệu	药材
Lois	卢瓦
Nâng cao	抚养
người Pháp	法文
uy tín	聲望
xúc phạm	谇
Gala lễ hội mùa xuân	春晚
Bệnh dịch	疫
Sinh tại	生於
sợi chỉ	縷
Phía trong	在內
Po	鱙
Nhiều	多种
Madagascar	马达加斯加
Thêu	綉
đóng tàu	造船
cảm tạ	謝
ác quỷ	魔界
Macedonia	馬其頓
Triều đại Đông Chu	东周
phương châm	口號
tàn sát	大屠殺
sự biến hình	變態
giá trị	價值
Thất bại để	負於
căng ra	绷
Bún	馵
Bộ Trưởng Bộ Ngoại Giao	外交大臣
Ye	邺
viết	撰寫
Với	含
bẩm sinh	先天
vai	膊
Eliot	艾略特
xấu hổ	羞
Loại cơ thể	體型
Kiểm tra và cân bằng	制衡
Nhưng vơi	但與
Tập trung vào	著重
Cá đối	鮻
hố	阬
vua rồng	龍王
Rào cản	路障
Đại hội nhân dân	人民代表大会
Nissin	日新
sự chuẩn bị	預備
xin chào	囉
Phong thủy	風水
tại sao	为什么
Chiến đấu	作战
Lu Shi	陸時
Máy gầu	鬥機
bài bạc	賭博
Tử vong	殕
thực ra	其是
Zan	瓒
Cấp bậc quân sự	军衔
Vô vi	贤
hiển nhiên	明顯
Yên tĩnh	蛘
hội,, tổ hợp	集會
Trong thành phố	城內
Âm thanh	音訊
gấp đôi	雙重
Sa thải	撤职
Tian Xin	田信
Khó xử	狢
Nhiều	诸多
dựa theo	依照
chọn ra	整理
tâm trạng	情绪
Kể từ đó	自此
Tiền vệ	中場
Giáo Hội Presbyterian	長老教會
Vấn đề	印发
pháo đài	砲台
Yu	鸜
Disney	特迪士尼
cốc thủy tinh	玻
Ling	廩
Hẻm hai	峽兩
Làm vỡ	殛
Ba	芭
Một người có tên	一個名為
Isle	爾島
cột buồm	桅
Buồn bã	爆冷
Vì vậy và như vậy	某某
tiền boa	尖端
Tang	椼
tiền giấy	鈔票
Cắt	切斷
Trả	饷
Saint Eti	圣艾蒂
một mình	独
cửa sổ	窗
Kiệt sức	儘
Thung lũng	沟谷
Yun	郹
huy chương	奖章
Yiyang	益阳
hiểu biết	學問
Thị trường	市面
Raptor	猛禽
Listang	列当
Năm triều đại và mười	五代十
Tong	伬
quanh co	曲折
Tỉnh sơn tây	山西省
khai thác mỏ	采矿
Bán hàng	銷售
lễ kỷ niệm	庆典
Cảnh báo	警示
Phiên âm	音標
Bóng rổ nam	男篮
dựa theo	根据
Mãn Châu	满洲
Zunyi	遵义
Tins	廷斯
Tỉnh Kumamoto	熊本縣
Nhóm với tư cách	組為
vị trí	所在地
Tương phản	對較
Bỏ qua	解除
có	具備
Ngừng	停产
Đến	侢
lau	拭
Máy bay vận tải	运输机
Bánh	皮耶
Từ đồng nghĩa	異名
Delhi	德里
natri	钠
Epiphysis	誺
Thời cổ đại	古时
Zi	訾
Miu	繆
ăn	喫
Đấu thầu	嫰
Castanopsis	槠
Châu thổ sông Châu Giang	珠三角
buổi tiệc	黨
Hồi sinh	振兴
Trả	支付
trở về	归还
Tang	蟮
Sau đó Jin	后晋
Shi Le	石勒
Nhàn nhã	悠遊
Khách sạn	宾馆
Thời gian sẽ	時將
Đối với hoàng đế	为帝
Dom	多姆
chồi	芽
Xung quanh	周遭
Ying	襍
Kuala Lumpur	吉隆坡
Gạo lớn	大稻
mộc mạc	窶
Ban giám đốc	董事會
Thư ký	书记
Điểm đến	點為
nông trại	农场
Giải thưởng	颁奖
Sự phát triển	演变
nhóm	群體
Hội chứng	症候群
Cossack	哥萨克
cá thu	鲭
thăng bằng	平衡
mệt mỏi	疲劳
Phỏng vấn	面試
Binhai	濱海
Chiếu	俣
Chì	领衔
Trông mong	憧憬
cộng sự	搭檔
Gabriel	加布里
mất kiểm soát	失控
tắt	關
tu sĩ	僧侣
Wuwei	武威
nhà ngoại giao	外交官
mong	望
Thông dịch	詁
gái điếm	妓女
nước mưa	雨水
con rể	女婿
cột cửa	棖
Trước bức màn	幕前
Shuhan	蜀汉
Khen ngợi	赞誉
Dhara	陀羅
Tiệm thuốc	药学
Cho học tập	為學
Luo	泒
Hor	鷎
Nhân viên bán hàng	务员
Bên phải	的對
Metropolitan	都察院
Sơ tán	撤離
Già hơn	榿
Qi	秥
Khuyến mại	升任
thử	設法
Vùng miệng	口区
Đường bên	側線
kéo ra	擢
Thuộc sở hữu nhà nước	國有
nhỏ	微小
Liên doanh	合营
Mẹ chồng	婆婆
Carter	卡特
Rạp hát	戲團
Rhein West	莱茵威斯特
Nắm bắt	查封
Việt Nam	越国
nhà hàng	餐厅
Du kích	遊擊
Xiucai	秀才
Tên Cu	舊稱
tuân theo	听从
Thea	西娅
buộc lại	敿
Đã nói ở trên	前述
Cứng rắn	刻板
gầy	臠
Ryukyu	琉球
Xi	橚
làn sóng	波浪
Lấy được	推导
mô hình	典范
Manche	曼徹
đường hầm	隧
lối đi bộ	阡
Cichlidae	慈鯛科
Mua lại	收購
Khí thải	排放量
Gonghe	公河
cục bướu	坨
rộng rãi	廣為
Adenosine	腺苷
cơm	飯
Thiết lập	設置
thiền học	禅宗
kết thúc	結束
Chim đa đa	駹
Băng	顛
Li Cheng	李承
ấm áp	暖
hợp đồng	协定
tuổi tác	年紀
hỏa tiễn	导弹
tình cờ gặp nhau	逅
tiếng sét	霹雳
Sự hỗn loạn	之亂
con quạ	蠿
Tôi	亖
Gan Ning	甘迺
giấy phép	准许
mơ	梦想
bẩy	弇
bình phục	收復
di cư	迁移
tụ lại	輳
Thử nghiệm	審理
ánh sáng	燈
cuộc đua	赛马
Mỗi hộ gia đình	每户
Yuan Zhang	元璋
Haikou	海口
Băng ghế	板凳
thành phần	元件
lòng tốt	仁慈
dysprosium	镝
Khảo sát	勘查
sợ hãi	吓
ngã	跌
Qi	亓
Nhị phân	二进制
Mẫu xe	車款
Daozi	道子
Florence	佛罗伦萨
mạnh	壯
Đã đến	赶到
Đường núi	山路
đo lường	斠
hành lá	薤
Huaibei	淮北
Đối với giữa	為中
mối quan hệ	關係
Phi tuyến tính	非線性
Giai thoại	轶
bụng	肚子
Băng qua sông	渡江
không nói nên lời	貊
Toàn bộ khu vực	總區
Catherine	凯瑟琳
Thành lập	建制
Dòng là	線是
Hoàn thành	圓滿
con hàu	鮚
Làm sao	咋
Kip	硤
Thời cổ đại	远古
sản xuất	出產
hành trình	旅程
lối đi bộ	蹊
Đường sắt nhẹ	轻轨
bảo vệ	鎮守
thay đổi	轉變
gậy	羅德
Fred	弗雷德
Thở dài	嗂
Kuai	哙
Li	槂
Tran	特兰
Văn phòng	公署
Độc thân	單一
Yan	剣
phụ tá	助手
tham nhũng	腐败
Aquitaine	阿基坦
Tát	秞
cà vạt	紥
Mười triệu	千萬
nghĩa hẹp	狭义
Dồi dào	丰
Học viện Khoa học Trung Quốc	中科院
Làm hết sức mình đi	盡力
Xấu xí	狥
vui vẻ	樂
Âm	鶑
Lòng tốt	善良
Cứu giúp	濟
nhu la	之类
bờ sông	漈
Hút thuốc	吸煙
Lân lượt tưng ngươi một	紛紛
Doanh trại	軍營
Chúa	主
Không bao giờ	未曾
Tài chính	财经
Khi nào	時則
kiểm tra	檢驗
Dự án bảo tồn nước	水利工程
Số Pi	貔
Thoải mái	舒服
bên trong	裡的
Hạt Chuan	川县
Cùng tên	齐名
Enix	艾尼克斯
ngọn hải đăng	燈塔
Quốc gia hùng mạnh	強國
Yi	稾
Abutilon	苘
thay đổi	变革
Lưu trữ	代管
Fluke	侥
Móng chân	蒂
màn	屏風
Bài hát	淽
giấy phép	牌照
Biya	比亞
xích đạo	赤道
gặp	迎接
Min	稔
Ở nước ngoài	境外
Mycin	黴素
thông minh	優
Tam giác	三角
ngớ ngẩn	憨
vẫn	依旧
Quan Vũ	關羽
Họ đỗ quyên	杜鹃花科
Phát sáng	发光
Herbert	赫伯特
liên đoàn	联赛
Bộ	瀬
Rang	穉
Wesley	衛斯理
Thuê	僱
Leary	莱里
Sông tây	西河
Montreux	蒙特勒
Không hiện diện	未在
Ayu	阿育
gò đất	塚
hạt thầu dầu	萆
Macao	澳門
Sỏi	斯通
biện hộ	求情
cháu trai	侄
Mạnh Tử	孟子
Tong	鞀
Trung đông	中东部
Âm	莤
cuộc thi	竞争
Người biểu diễn	演奏家
Huang Wei	黃偉
Sững sờ	怛
Đừng	別是
Cả bộ	整套
con đường	徑
Đổ	斻
Mẫu	纹
Thủ công	工藝
có hại	有害
mãi mãi và luôn luôn	永遠
Tài khoản	账户
sau	以後
mọi tầng lớp xã hội	各界
Milo	米洛
sự hy sinh	禋
không dây	無綫
Choáng	愫
xe tăng	油箱
Tsing Yi	青衣
Đọc tiếp	讀於
Trái	左方
Quy đổi	挽回
Hai	兩位
quả bầu	葫芦
dấu	瘢
thành phố Kaohsiung	高雄市
uốn cong	彎曲
Sting	螖
Bảo vệ quận	郡守
lớn	碩
Chiến trường	战区
Bannerman	旗人
Thay đổi	改採
sự phồn thịnh	繁荣
giới thiệu	推荐
Tin tức không dây	無綫新聞
số liệu thống kê	統計
Chân dung	畫像
lớn lên	长大
Giai đoạn = Stage	期內
Mộ	墓前
Manila	马尼拉
Yi	佻
Liêu Ninh	辽宁
Tai Wai	大圍
Fengyun	风云
công tắc điện	开关
Tuntian	屯田
một chút	一点
Theropod	獸腳亞目
bố trí	布局
Sau ga	站後
phim ảnh	影片
im lặng	默
Không cho	不予
Tên gọi chung	俗称
Yamaguchi	山口
Thêm vào	增修
Đầu độc	中毒
Đã thanh toán	付费
nghèo	貧
Xuantong	宣統
Không có khả năng	无法
Giảm xuống	沦为
cổ phần	股票
Tom	汤姆
Nhạc trưởng	指挥家
từ tính	磁
nhìn lướt qua	瞥
hệ thống	体制
Một trăm ngàn	十萬
mũ sắt của lính	冑
Theo	随
Quân tình nguyện	志愿军
Va chạm	相撞
Hang hốc	伯罗
Desen	德森
bất động sản	财产
khạc nhổ	啐
Kanto	關東
Lạch	拉赫
Đổi lại	改回
Yu Liang	於兩
Tượng đá	石像
Axit cloric	氯酸
thích hợp	妥善
Jian	臇
đối diện	對面
Người hầu	侍講
Tây An	聍
Đội tại	隊於
Noor	诺尔省
hơn	宁
quá trình	進程
Xe ô tô	該車
cơ thể con người	人体
Từ chức	辞
tình trạng vô chính phủ	无政府
Đông cứng	結冰
ống kính	透鏡
Thẻ	咭
tốt	井
nền tảng	基金會
trang sức	瓖
che	覆蓋
hai mươi	二十
Ngày hè	夏日
Cuo	厝
kỹ lưỡng	徹
Yi	亁
tuyến tụy	胰
Gần bằng phẳng	近平
Nhúng	寖
Deng	鄧
đậu	荳
Tỷ lệ trúng	命中率
giảm xuống	驳回
Bulli	布利
Buồn phiền	瞶
Đào	桃
má	頰
Sway	溎
sổ tay	手册
Otto	奥托
Ji	稷
Bỏ tiệc	退黨
Philly	菲利
Tát	輗
tranh luận	辩论
Hồng Kông	港府
Đang chuyển hàng	航运
tối ưu hóa	優化
phòng chờ	休息室
khô héo	凋
Giao hưởng	交響
Ying	蓥
trọng lượng cơ thể	體重
Cống hiến	投身
Gì	呢
Cái khiên	盾牌
Cấp	位居
Đông Tây	东西向
Triều Dương	潮阳
Ngã xuống	脫落
Đẩy	撵
cũng thế	还
Nơi gặp gỡ	会场
Khuôn mặt	臉部
Sự đối lập	对立
móng guốc	蹄
Wentai	聞台
theo	追隨
Nhu la	诸如
Đối xử như	当成
Điểm A	甲級
vector	向量
Tụ họp	集結
Tài liệu chính thức	公文
Yan	盠
mô phỏng	仿真
An District	安区
thiên văn học	天文學
Người cưỡi ngựa	馬術
không khí	空气
Ya	娅
tốc biến	閃
Đến	冾
Quân ủy trung ương	中央军委
Tiền nhiệm	前人
Siêu nhân lực	超人力
Zhongshan	中山
Diễn viên	投出
bố chồng hoặc bố vợ	岳父
Hồ Nhật Nguyệt	日月潭
Bệ hạ	陛
cafein	咖啡因
Wu Song	吴淞
Tin	鈿
Một tỉnh	一個省
Người Đức	日耳曼
Hệ thống bit	位制
Nâng cao	籌
Máy ảnh	相机
Santa Cruz	圣克鲁
Bờ đối diện	對岸
con nhện	蟢
Rhone	罗讷
trở nên	變成
đổi	匯
bắn hạ	击落
Dòng hàng	行線
Triển khai thực hiện	施行
Mật tông	密宗
kiểm tra	測驗
Tuyệt chủng	滅絕
Pan	菫
Sao chép	拷
đá	嵒
Alaba	阿拉巴
Massa	马萨
đơn vị	机组
Hy vọng	預料
Ngớ ngẩn	倕
Chức vụ	职位
bẩy	陷阱
Nan	湳
Ba mươi năm	三十年
Jie	桀
lực hấp dẫn	引力
Trước	從前
Thư viện	书馆
Chuyến tham quan	图尔
cấp độ	級別
ho	欬
Tiền lương hàng tháng	月薪
Đàn ông	作人
Chắc chắn không	定不
Giải thưởng	等奖
ban công	阳台
Vài lần	幾經
nhóm	羣
cần thiết	必要
Khen ngợi	讚賞
Thiểm Tây	陕西
con bò	菟
Min	旼
Tìm thấy	发现
Biên bản chiến tranh	戰記
Người kéo	普勒
Hành sơn	衡山
Nimble	旎
con trỏ	指针
Dài hạn	永久性
Công cộng và tư nhân	公私
Con la	檡
thực tế	真实
Luo	泺
sự sụp đổ	倒闭
Pere	佩雷
Xe tại	車於
Urê	脲
thuổng	铧
Mọi nơi	處處
ô	繖
Quân đội dã chiến	野战军
triển khai thực hiện	落实
Nhiều hơn và nhiều hơn nữa	越来
nước chảy	湓
Tướng	諸將
vay	貰
giảng viên	讲师
Long Môn	龍門
giọng nữ cao	女高音
Ji	佶
chắc chắn	某
Tốt hơn	優於
Tổ chức	立憲
Đúng hay sai	是非
quặng sắt	鐵礦
Xà lan	重子
kiểm tra	考驗
bỏ qua	黜
Gang thép	鉟
Dương	烀
Timur	帖木儿
Thủy sản	水产
Thương hiệu mới	崭
bày tỏ	特急
chủ đầu tư	投资者
nhiệt độ	溫度
đội tuyển quốc gia	國家隊
nhân chứng	证人
Đặt vị trí tại	座落於
lái xe	带动
Tron	特龍
Qiu	湫
con nai	鹿
Larry	拉里
Shiye	什葉
Khóa học	學程
người môi giới	儈
Lượt xem	观
huyết khối	血栓
Quận Yi	义县
Mái hiên	帟
Không thích hợp	不宜
Vượn	鹓
sự chuẩn bị	製備
toàn bộ	共計
Đối với Hồng Kông	為香港
nơi trú ẩn	庇护
Baltic	波罗的
Yan	閻
Cổ vật	古物
giá trị trung bình	平均值
thật	确实
Hai mươi chín	二十九
tia chớp	闪电
Hoa Kỳ	合众国
Ghi chú	註
Sass	萨斯
bò	爬行
hoàn toàn	純粹
Đã được	當過
chất tẩy trắng	洴
Đã chọn	入选
Tàn phá	椂
Thang cuốn	扶梯
Phía trong	內側
Anan	阿南
Uta	宇多
Sức khỏe	健康
cây thông	乔木
Điểm nóng	熱點
ghế đẩu	櫈
Và bây giờ	與現
bất diệt	神仙
Quench	焠
sức mạnh	劲
Luohe	罗河
Hạt giống như	種為
uy tín	譽
tư pháp	司法
Ku	馚
tốt nghiệp	畢業
Bảo vệ	警卫队
giỏ tre	蓧
Nhà Tống	宋代
Đã chọn lại	蝉联
厍	厍
mạng lưới	净
sự đánh giá	賞識
mồ côi	孤兒
thèm muốn	覬
chăn nuôi	畜
diễn viên	演員
Lạc sơn	乐山
Hidebun	秀文
Vội vàng	蔺
Tự do	自由泳
Thang máy	升力
dền	苋
Jamaica	牙买
Đại pháp	大法
Và không	且不
giai đoạn = Stage	期间
Chim	鹴
Học sinh trường	校生
Một nhóm công ty, tập đoàn	集团公司
Cam chịu	注定
Đa dạng	多樣性
Đầu tiên	首台
ma	幻象
hố	孔
Sau chiến tranh	大戰後
lộ trình	衢
Moore	摩尔
Trục	軸心國
Chi	碬
Joseph	約瑟夫
Hư không	不通
Thuộc da	鞣
Quốc gia và	國與
Liên minh Châu Âu	歐盟
Chức vụ	職
Tự cải thiện	自強
Phòng tập thể dục	道館
Triều đại Jin	晋朝
Tầm nhìn	视觉
cắt	削
khả thi	可行
Jia	蒈
suối	涞
kem	奶油
Người	人稱
Có thể được mô tả là	可谓
Đại học Dan	旦大学
nghề nghiệp	专业
hàng tuần	每週
Max	最大值
lãnh thổ	疆土
biến cố	事变
Bang Jin	晋国
Giả mạo	造假
Sự mở rộng	搨
Meke	梅克
ăn năn	懺
Liao	辽
rệp	蚜
gạo nếp	稌
Metyl hóa	甲基化
Hấp	蔄
lái xe	駕車
Trung tâm của lực hấp dẫn	重心
Mingcheng	明成
Ngừng bắn	停火
Ying	魩
cản trở	礙
con cóc	蟾
Xindi	新地
Thiên nhiên	本性
Đinh hương	丁香
Tàn tật	瘛
Điện	的電
trêu chọc	挑釁
Thứ duy nhất	唯一一
Howard	霍华
Ở Đài Loan	於臺灣
Thủ lĩnh	領隊
Hitter	擊手
Pilose	柔毛
tiết tấu	擂
Tốt	唔
Quận Daan	大安區
Xấu	坏
Barna	巴納
lốc xoáy	气旋
Không gian xanh	绿地
Thành Troy	特洛伊
bóng râm	蔀
khi nào	当
gốc	起源
quần chúng	群眾
Papua New	巴布亚新
Phát biểu	言論
cây rìu	斧
hoa sen	蕖
Tiếng Quảng Đông	粵語
Bit	位元
Pule	普列
Labang	拉邦
Sự khác biệt	區別
Ad	阿德
phát sóng	广播
chim ưng	鹫
Âm	騴
Zhuo	涿
lanhung	有沒
Bài đăng	帖
Lu Jun	路軍
Xiaoping	小平
thành phần	作文
Mỏ đá	鰂
Khoa học xã hội	社会科学
kính viễn vọng	望远镜
Sắc bén thịnh vượng	尖旺
Tên	命名
Nhận xét	備註
giống	相仿
Thay đổi chữ cái	改信
Kowloon	九龙
Baylor	貝勒
Buồn phiền	慅
Đại số học	代数
Sữa bột	奶粉
Zong	宗
Những cái đó	那些
Học viện Khoa học xã hội	社会科学院
Tắc nghẽn	堵塞
Chạm tới	达成
Người dơi	蝙蝠俠
chúng tôi	咱
Heng	蘅
Quy mô lớn	大规模
Toàn tiểu bang	全州
Gulou	鼓楼
Tinh vi	饌
Chim ưng	隹
Kéo dài	橫跨
nơi trú ẩn	庇
Cơ khí phụ	子力學
cái cưa	鋸
Nordau	諾道
ôm	搂
mua chuộc	赇
Con Suối	山河
Bay tới	飛往
Hát	俻
triều đại nhà Thanh	清代
Độ sáng	光度
Cơ đốc giáo	基督教
súng	砲
Oda	織田
Shao	猻
bươm bướm	蝴蝶
Kiểm tra	验
Giấy	紙張
Hai cái thì sao	約兩
Muốn	緝
Vỏ rùa	玳瑁
Giữ	持股
Trả lại	回饋
Xuân	煡
Đóng băng	愣
Thế giới	世人
thắng lợi	赢得
mặt trời	太阳
Ami	阿密
Ying	滢
Trong thế giới hoang dã	在野
quyền lực	大權
Có lông	褢
Cam Túc	甘肃
Lexue	樂學
Huyện	區內
nghịch lý	悖论
Cuộc họp chung	联席会议
nguồn sáng	光源
Hoàng Tiểu Long	孝文帝
Sẽ	意願
Tên thật	现名
trong số họ	其中
Tới đây	對此
Phối hợp	驸马
cù lao	沚
Âm	麌
Thời phục hưng	文艺复兴
nấm	蘑
Shueisha	集英社
tu sĩ Phật giáo	闍
Gatehouse	门楼
Mặt biển	海面
ảo	虛擬
giảm giá	折扣
Lớp ngoài	外层
Một khoảnh khắc	一刻
Đáp lại	回复
phần mộ	墳
Đền bù	偿
học sinh cấp 2	中学生
cắt	断绝
Gọi là	簡稱為
Sum họp	重逢
Họ Urticaceae	荨麻科
Zheng Guo	鄭國
Jiao	昻
Chết	殑
vô ích	枉
quỷ hạn hán	魃
Mobei	漠北
cuộc thám hiểm	遠征
Đúng	耶斯
Xing	興
Ven sông	滨江
Queer	陁
Panchen Erde	班禅额尔德
kiềm	堿
Đường Dun	敦道
Số lẻ	單數
Xấu hổ	膮
Ukraine	乌克兰
Gà lôi	鹇
Tỉnh	斯省
Âm	猡
Loach	鳆
tiếng ồn	噪声
Hu	阺
Tình nguyện viên	志愿者
sương	椲
trận chung kết	总决赛
Coi chưng	望台
Duy Nhất	賎
Kali	鉀
Thứ mười ba	十三日
Đồng âm	同音
mặc định	默认
cạnh	棱
vườn	園林
Xing'an	兴安
Tuần tra	巡視
Kanto	关东
Thẳng	平直
Wan	涙
thánh	聖人
Bệnh phấn trắng	白粉菌
Zan	璓
Tòa nhà văn phòng	字樓
tiền lệ	先例
Dính vào	固守
Thế giới trong	世於
mét khối	立方米
Sức khỏe	卫生
tháng Tám	奥古斯特
món thịt hầm	炆
ngân hàng	畔
Wentai	文泰
Nhiều năm sau	年後
cuộc nổi dậy	起义
Trao đổi	交流道
Hoàng đế Wu	武帝
ghi bàn	比分
Mô hình xe hơi	型車
Kyle	凱爾
Với	過與
Làm	作
Nguyên nhân chính	主因
Âm	錤
Gây quỹ	募款
Roman	羅曼
nhân cách	个性
phần thưởng	赏赐
bẻ cong	弯
Đang xảy ra	情况
vu khống	谗
Kim tuyến	橪
Huấn luyện viên	執教
Nhổ ra	吐出
phalanx	方陣
Cả hai giới	两性
Mô hình hóa	建模
Suy nghĩ	思議
Đưa cho	让给
Xiahou	夏侯
Phillips	菲利普斯
tóc	发
nhật thực	蚀
Vason	瓦松
Gia	吉亚
trăng non	新月
Người dàn nhạc	配器
Sau	之後於
đoàn kết	共識
Hualien County	花蓮縣
chắc chắn	一定
Bandai	萬代
Yu	瑀
Nondescript	不伦
Nhanh	迅猛
Giữ lấy	執
diễn viên	演员
Wan	宛
quyền lãnh đạo	霸權
cơn ác mộng	魇
Tuyển tập văn xuôi	散文集
Lou Wei	樓為
Li	蕝
Với tình yêu	與愛
Nhát	悩
gà tây	土耳其
Nông nghiệp	養殖
Northland	諾州
WHO	誰
Đài loan	台湾
động cơ	發動機
từ giờ trở đi	今后
mù sương	缥
Chi nhánh	支部
Anh ấy sẽ	他將
Lý do	为由
Quỷ lùn	绌
Chết trong trận chiến	战死
lý luận	推理
phòng thủ	辯護
đôi khi	有时候
Lưu trữ	牵制
Nanhe	南和
Áo sơ mi	卹
Zhang Guo	張國
Thẩm phán quận	縣令
Ireland	爱尔兰
Daoxiang	稻香
bình thường	正常
Một lát sau	後才
Sâu	蠘
Thượng hải	沪
Chạy	润
Jiquan	極拳
cây khổ sâm	龙胆
Clough	克拉夫
Pokemon	神奇寶貝
cả ngày	全日
Gọi nó đi	称之
Gặp nguy hiểm	危
Đột phá	分场
Khoa học viễn tưởng	科幻小说
Sonata	奏鳴
cá mập	鲛
Luật là	法為
sự sỉ nhục	羞辱
Đột nhập	突入
mương	壕
tăng huyết áp	高血压
tay	手部
Shiwei	氏為
Quân đội và	軍與
Hm	姆
Áp dụng cho	应用于
Penang	槟城
DuPont	杜邦
xuyên qua	透
Và vượt qua	與傳
Cơm	稻米
Gốc	源地
Tỉnh quảng đông	广东省
nạn nhân hy sinh	饩
nhà phê bình	評論家
Buồn	悻
Miếng	件
gecmani	锗
bông hoa	花
Chan	奵
Lối thoát	生路
Tỉ lệ tăng trưởng	長率
Phản ứng	回应
ranh giới	边界
Được khai quật	出土
nhặt lên	拾
Đầu vào	输入法
người đàn ông tốt nhất	傧
thành lập	確立
lên và xuống	上下
ký tên	跡象
xe tăng	坦克
Thành viên Wairo	员外郎
Đài truyền hình	電視台
trục	枢
Công nghệ cao	高新技术
Châu Âu	歐洲
Chạm tới	達至
Yan Guo	燕国
Xương sống	脊椎
Bộ phận quản lý	管理系
Anaconda	蚺
Người Mỹ	美籍
gió	繚
chất lỏng	液體
Zili	子裡
Ji Chu	紀初
Mạnh	雄厚
Quảng trường Thiên An Môn	天安门
Sống sót	存留
mưa liên tục	澬
Istanbul	伊斯坦堡
Tổ tiên	先人
Để so sánh	為較
Cá mèo	綱鯰
Vệ tinh nhân tạo	人造衛星
Thành phố phượng hoàng	鳳凰城
quạt	球迷
Giá trị	重視
Âm	覌
con bò cạp	螜
Âm	諴
mùa xuân	春季
phản ứng	反应
tình hình	局勢
Xe buýt chung	巴士總
Tương đương	等效
bản tình ca	情歌
Bay	飛航
tiếng vang	呼应
chỉ tại	僅在
Thương gia Trung Quốc	招商局
Triển khai thực hiện	實作
uống	歃
Que	骙
Hai chiều	二维
Trì trệ	停滞
Tái bút	跋
Nhân tạo	人工
túi	口袋
dấu	嘜
thân hình	身體
phân đoạn	分割
Công sự	工事
Dai	埭
Yêu cầu bồi thường	債權
Khu vực thành phố	市辖区
trừng phạt	诛
Hệ thống vé	票制
Xinhong	新鴻
Gọi chung	总称
tha lỗi	谅
thắng lợi	赢
Mã quốc gia	國號
Dừng lại	止步
Trong	個在
năm học	學年
Sảnh phụ	配殿
trói buộc	紃
Doyle	道爾
đi xe đạp	周期
Chim bồ câu	鸠
đến	过来
Hội nhập	一体化
xù xì	髟
kết cấu	质地
Om	嵔
Hoa anh đào	樱花
Zhongqing	中情
Lin	楏
rượu	葡萄酒
gửi	派
Pu Yi	溥仪
Ardennes	阿登省
Phòng thương mại	商會
Shao	譪
cái rổ	籃
trường học	学派
Las Vegas	拉斯維加斯
thảm họa	災難
Từ	自于
xoắn ốc	螺旋
Lập trường	表态
Lịch sự	禮於
che	覆
gì	什么
Đại hội	总会
Xi	浱
Tăng lên	崛
bài hát nhịp	唪
phần thưởng	收获
Li	閪
Trong khoảng	的約
Đỏ thẫm	絳
buổi hòa nhạc	音樂會
Tần	駸
nhiều lần	多次
đối lập với	暌
Acyl	酰基
cây bạc hà	薄荷
Kyrgyzstan	吉尔吉斯
ký tên	签
Có nghĩa	表示
Tiền ký quỹ	滸傳
vây quanh	环绕
hầu tước	侯爵
Hỗ trợ lẫn nhau	互助
Lí trí	心智
quyết định	决策
Sierra	塞拉
Thống đốc	巡撫
cái cổ	颈部
Mảnh	該片
Trinh Nữ	維珍
Mác	馬克思
đau	伤
lũ lụt	水災
Xiang Gong	襄公
Epiphysis	檺
Có	有所
văn phòng	辦事處
người triệu tập	召集人
Hậu cung	后宫
Sự phẫn nộ	忭
Thường Châu	長洲
Và để	而於
bất cứ lúc nào	隨時
Gru	格鲁
Quận	各區
Nhìn nhận	認定
Quán quân	状元
Thời gian	時的
hai ngàn	两千
Phí thành viên	會費
spa	温泉
Giao tiếp	相通
Không	並無
Thời Tây Hán	西漢
Kho báu nhà	家宝
Đầm lầy	沼
vật chất	物質
đồng	銅器
Bali	八里
chiếm lấy	生擒
Ling	巎
Quạt	蕃
Quân đội Liên hợp quốc	联合国军
Tây An	冼
Trong nhà tù	狱中
thương	铩
Thở dài	睸
Mồ hôi nhễ nhại	大汗
bán kính	半徑
tắt	关
xuất hiện	模樣
rubidium	銣
con rết	蜈
Roan	獌
Li	藶
Tỉnh Gunma	群馬縣
Pennsylvania	賓夕法
độ ẩm	湿度
Và xã hội	與社會
của tôi	礦
Tiếng Quảng Đông	粤语
Luo	駱
nghệ thuật	艺
Km	公里處
Điện cơ thể	體電
Corso	科索
Người Đài Loan	台商
càu nhàu	嘰
Chấp nhận	受理
Hội đồng Nhà nước	国务院
hộ tống	羑
Phiên dịch	譯
rất	挺
Không đủ	不足以
luôn luôn	总是
đạn	槍彈
học bổng	獎學金
Indre-et-Loire	安德尔卢瓦尔省
sức sống	活力
sự cô lập	隔離
Nếu không thì	除此
xa hoa	侈
Thay đổi	不等
Wan	澓
con nhện	蜘
Đổi lại	中還
câu hỏi	题
ủng hộ	拥护
Tỉnh đài loan	台灣省
Nói	地說
Anime	動漫
Sulaiman	苏莱曼
Sách	成书
Kinh doanh	商务
Galileo	伽利略
Thành phố Tô Châu	苏州市
Định lượng	量化
Yi	亅
Haining	海宁
Vấn Xuyên	汶川
Ling	囇
Làm suy yếu	弱化
Trung Quốc	支那
danh tiếng	名气
cây	柅
Thành lập	創會
Hopkins	霍普金斯
tuyệt vọng	悵
Ling	醿
Nhà thiết kế	设计师
Như Lai	如來
bệnh tim	心脏病
Ngữ nghĩa	语义
Mỗi chỗ ngồi	每座
chân đèn	檠
Hàng tháng	月刊
Tiêu	度过
Mọi người	各位
Bộ giao thông vận tải	交通部
Văn phòng	事务所
Yu	庪
liên quan	眷
Hai cực	二極
tàn lụi	秕
Về mặt thể chất	体上
Danh sách	名單
trại	阵营
tiếng Đức	德國人
Răng cưa	锯齿
Kết hợp với	會同
hối lộ	賄選
Pháo kích	砲擊
Jingguang	京广
Đặt theo tên	名於
lưng gù	僂
Vừa rồi	方才
Ngày thứ ba	其三
Thép	钢
Lời bài hát	詞曲
Khu vực Đại Tây Dương	大西洋區
Học	就读
quyền và lợi ích	权益
Treo	縊
Hei	鹖
dán	膏
mười sáu	十六
Tăng quân	起兵
Đảng bộ	党委
Hu	腧
Viện trợ của Mỹ	美援
Vài lần	數次
Lebanon	黎巴嫩
Câu trả lời	各答
Tên giai đoạn	艺名
rút ngắn	縮短
Được phục vụ như	擔任過
Thành phố tiểu bang	州城
Tòa án	裁判所
mứt	蓣
uy tín	誉
Moldova	摩尔多瓦
cây kéo	翦
Ngoan đạo	虔诚
ổn định	穩固
Nhóm công nghiệp	工团
Phát hiện	探測
Xà gồ	骩
Columbus	哥伦布
Sinici hóa	漢化
giam giữ	拘留
Wei	沩
sử dụng	用途
Sự phẫn nộ	愾
liên quan	牽涉
Lai	賚
ngây thơ	幼稚
hữu nghị	誼賽
Giành được	榮獲
Jianyang	建阳
Erqi	二七
Hakodate	函館
ống khói	囪
Genji	源氏
Buồn bã	蕦
Nam Kinh	南京
khoa học	科学
Pegasus	飛馬
Dưới	於下
lên đường	出发
Sức mạnh chiến đấu	戰力
Tụ điện	電容器
Đặt hàng	咐
Rayleigh	瑞利
Zygomatic	顴
Campuchia	柬埔寨
Cờ vua	棋士
Tỉnh này	本省
Xoay	轉彎
Sự thay đổi	的變化
Hyde	海德
Orton	歐頓
sưng gan	痞
Kinki	近畿
Án Lệnh	法令
Không có gì	毫不
tình trạng	况
Bị trục xuất	被逐
Hàng ngàn	数千
Tấn	荀
Giường	床
Tăng sản	增生
Sau khi thành lập	成立後
cây gai dầu	麻
Kinh phí	資助
nạn đói	饑荒
Thích hợp	小生
Harris	哈里斯
Tuen Mun	屯門
bom	炸彈
không thay đổi	常數
Zolo	佐洛
Dell	戴尔
Vòi sen	淋
Đốt phá	縱火
Giáng sinh	圣诞
Nott	諾特
Lính cứu hỏa	消防員
kinh nghiệm	經驗
Ahma	艾哈邁
Hoa hồng	薔
sập	滿貫
Bất tận	不絕
Argentina	阿根廷
Như	阿斯
Qi	虴
Âm	鞌
vì thế	故
Nhưng vẫn	但還
đê	圩
Dịch cúm gia cầm	禽流感
dự trữ	储
Đặt trước	預設
Giám đốc	處處長
thịt bò	牛肉
không nghi ngờ gì nữa	無疑
Dụng cụ	文書
Dây nhau	和弦
Ming Shenzong	明神宗
Nằm xuống	打下
Pingcheng	平城
quang điện	光电
Sau đó	則為
Tăng lên	升
Gle	格莱
Thây như	看做
nhà chế tạo	生产商
ngoại quốc	國外
Chính kịch	線劇
phía đông	以东
Nhìn chằm chằm	鷃
sảnh chính	正殿
Số năm	伍
bất ngờ	傥
Tỉnh	縣內
thay thế	反而
dây đai	縚
Cảnh báo	儆
thắt lại	戔
cầu trượt	滑行
Corona	日冕
Bắt đầu phát sóng	开播
khí tự nhiên	天然气
Kẹo cao su	齦
tiểu đoàn trưởng	营长
cá chép bạc	鮒
Gangue	矸
Trở về nhà	回国
Yunshan	云山
phần bổ sung	补充
Ghi chú	笺
Dự luật	命题
Nam Tân Cương	南疆
Shi	轘
Tinh ranh	迪克
Máy chém	鍘
đau	傷害
hiên nhà	廡
Shu	譮
Yêu tinh	精灵
Góc đầu	頭角
Khó hơn	哈德
Đội thắng	隊贏
em gái	妹妹
Bắt đầu làm việc	動工
người Trung Quốc	中華民
Dưới nước	水中
Quận Sham Shui Po	深水埗區
Everbright	光大
Tuyệt quá	好
trưởng khoa	院長
Yếu	微弱
Cái đó	那个
con rết	蜈蚣
Kinh khủng	悰
ý định	意图
Oh	噢
Tàn phá	祘
John	若望
Wan	涺
Những người này	這些
Wei	蔚
Động vật ăn thịt	掠食者
đổ	傾
Một lượng nhỏ	少量
vây quanh	環繞
Phối hợp	合組
Vết trầy	攋
ở gần	近乎
San Di	圣迪
Hai phần ba	三分之二
Vách đá	厓
Kỹ thuật	術
Oran	奧蘭
Angola	安哥拉
Ảnh hưởng	影响力
Đinh ốc	螺絲
Fei	菲
lưỡi	舌
Sẽ hai	將兩
Yan	昅
Địa chất học	地質
Bước xuống	卸任
khóc	哭
Làm ra tiền	賺錢
Kéo vào	拉在
đàn bà	女人
Chi	唧
Channa	鳢
Cứu hộ	救護
Aron	阿隆
Chạm khắc gỗ	木雕
chủ tịch	會長
sau đó	當時
Braun	百灵
Quả bom hạt nhân	核弹
ý chính	大意
Jinshi	金石
Tường thành	城牆
Các vị thần	神靈
hình minh họa	插畫
Giết chết	殺戮
Và số	與數
Tương tự với	類似於
Giảm nhẹ	減輕
sự suy luận	推論
Kim Môn	金門
Kế sinh nhai	維生
Thứ sáu	周五
hiểu biết	明白
Thẩm quyền	权限
Hai bên	兩黨
Từ	自於
cây kế	蓟
Sâu	蚍
hình như	似乎
gừng	姜
Điều hành	经营
Khuôn mẫu	定型
Trọng lượng phân tử	分子量
thư pháp	書法
Kính hiển vi	顯微
Văn hóa phụ	次文化
Lai Chi Kok	荔枝角
Quyền hạn	辖
vườn cây ăn quả	果园
con linh dương	羚
Hiện ra	浮現
Vui mừng khôn xiết	大喜
Vũng nước	水坑
Meni	梅尼
Ban giám đốc	董事会
Tuyên bố chung	聯合聲明
Người nói chuyệnTô Châu	說家苏州
Ủng hộ	利于
Thủy quân lục chiến	陸戰隊
Con chuột	拉特
Kinh bạc	銀經
tuabin	渦輪
Treo	紘
Phần lớn	大半
xác định	立志
Triều đại Tây Tấn	西晉
Luật cơ bản	基本法
khu vực đó	該地區
Amsterdam	阿姆斯特丹
Tesla	特斯拉
gọi	通话
Tình hình	情境
Cơ thể chính	主體
sườn đồi	山坡
sau	经过
Bão táp	風波
Thiên niên kỷ	千禧
đóng	緊密
xa xôi	遥远
Dồi dào	豐
nghề thêu	黹
Chiếc phà	渡輪
Frigate	衛艦
Dương	泃
Có thể điều hướng	通航
Biến đổi	转化
Chuyến trở về	回程
Ou	謳
thợ làm bánh	贝克
thông thoáng	明确
màng	膜
dịch	翻譯
Dung	蜣
krypton	氪
không phải	並不
Thời gian trôi đi	时隔
Xảy ra trong	發生於
Làm mờ	調景
Cựu chiến binh	獣
nổi danh	聞名
ấm đun nước	釜
Gen	艮
Xie Changting	謝長廷
Thánh	為聖
Số Pi	邠
Sức mạnh	力於
Tilia	椫
đối kháng	拮
Công việc trước	前作
Quyên góp	捐赠
Chì	率领
trọng tài	仲裁
Làm gián đoạn	中断
Nghiêm nghị	艉
từ	从中
Utricularia	狸藻
Công chức	公务员
Meng	勐
Nước làm mát	水冷
Bao vây	围困
Bang	捜
toàn cảnh	全景
Madrid	马德里
vội vàng	急忙
Đội người	人隊
Deman	德曼
Charles V	查理五世
Hở	欸
Tình trạng khó xử	困境
Thảo luận	議事
Klee	克莉
kế sinh nhai	生計
âm lượng	音量
Họ Leguminosae	豆科
Băng tuyết	冰雪
đơn giản hóa	简化
quá trình của	的過程
Winnie	威尼
gặp	晤
Nhược điểm	弊端
nhưng	可是
Sky Eagle	天鷹
Alex	亞歷
Che	輋
nẹp	梏
Cuộn	羅爾
chung	一般
Đội dự bị	預備隊
Gạo nếp	餈
Gà lôi	雉
Yêu và quý	的愛
Phát triển đến	長及
Nàng tiên	妖精
Ở giữa	舉中
hướng Tây	向西
Qichao	啟超
Nghệ thuật nữ	女藝
Si	譞
Ba vương quốc	三國志
Kang Youwei	康有为
Phòng bên	側室
tương đương	等價
Montpellier	蒙彼
Bang	哐
ấp ủ	孵化
ngư lôi	魚雷
quy ước	公約
Nói lại	重覆
Bart	巴特
đồng hành	侣
nhón	掐
Cháu trai	侄子
có khả năng	能力
dài hạn	常驻
Ordos	鄂尔多斯
Pan	蘩
Cambridge	劍橋
Baghdad	巴格达
Rick	里克
Warsaw	华沙
Phòng ban	学系
Phun	噖
Tâm thần phân liệt	分裂症
Tăng	嗢
Peng	鹏
Trưởng nhóm	隊總
đứa bé	寶貝
Đặc trưng	特点
tầm nhìn	眼光
Thắt nút	結
Fanling	粉嶺
Mỗi	每个
Jizhou	冀州
Hướng ngoaị	传出
Berkelium	锫
nội địa	內陸
Chim săn mồi	鷙
Xing	兴
Kuniko	国子
lấy trộm	窃
Cai trị đất nước	治国
Học	學業
ký tên	籤
Di	迪
Thực hành	修行
Đã qua đời	病逝
Môn học	課題
Higashiyama	东山
Yu Di	於第
Cải tạo	翻修
quận lỵ	县城
mạng che mặt	羃
giờ	小時
Rồng có sừng	角龍
đặc tính	特性
vụ bê bối	醜聞
Đá	踀
Một lưới	一格
âm lượng	體積
Có	經有
Tottori	鳥取
Giải tỏa	通關
đệ tử	弟子
ranh giới	畛
Tóc trong	內發
bệnh trĩ	痔
Mạng internet	網絡
Dài	龙
Bảo vệ	保
Bún	麅
hươu cái	麀
Rosa	羅薩
nổi loạn	造反
Tuman	圖曼
cách	道路
Phá bỏ	脫離
muốn	祝
nâng cao	高級
Tàu	舰船
đỉnh núi	岊
Dài	迖
Khu đông	东段
May chăn	辡
Tám năm	八年
Bản thân	自體
Nhân viên	雇员
thắng lợi	贏得
Góc nhìn cá nhân	视角
Có xu hướng	趋于
báo cáo	匯報
Kiêu ngạo	棈
C	丙
bộ Tài chính	财政部
Thanh	箐
xấu	歹
cửa	大門
xoắn	撚
và	及其
Trưởng	酋长
Yi	镒
Quá cảnh	凌日
Tây tạng	吐蕃
không quân	空军
từ ngữ	话
Patten	彭定康
bởi vì	因為
quá khứ	过去
Ba cái này	這三
Zhu	楘
sa tanh	缎
Phay	铣
Ouyang	歐陽
Được thăng cấp lên	升為
Pete	佩特
Bao	薩克
Bologna	博洛尼亚
Cơ đốc giáo	基督教徒
Sa	颯
Sau	的後
Xấu	壞
Đậu nành	大豆
Lawrence	劳伦斯
cướp bóc	斢
Tỉnh Saitama	埼玉縣
Benzyl	苄
Bang	擓
bất ngờ	不料
nổ	爆裂
tiềm năng	潜在
khía cạnh	方面
thạch tín	砷
Quốc gia đặt hàng	令制國
lịch sử	史
Nổi danh	而聞名
Truyền giáo	福音派
Etylen	乙烯
bằng thạc sĩ	碩士
Du lịch	遊業
porphyrite	玢
Ở ngoài	門外
Wu	梧
Âm	鄞
Trong tâm trí	的記
Gai	苧
ngũ cốc	糧
Liễu Châu	柳州
ngực	胸部
Đã trở thành	化为
sự thất bại	失败
Đề tài	专题
Xiang	驤
Trận đấu ở sân khách	客场
Xing	惺
hủy hoại	毁
Ngôn ngữ tiếng anh	英語
chân	脚
Âm	辤
đầu gấu	欺
tham mưu	咨询
Hàng đầu	巅
Chi nhánh	樹枝
Sau đó	随后
Các vị vua	金氏
trở nên	变成
Zimbabwe	津巴布韦
thở của cá	喁
Tây Âu	西歐
dần dần	逐漸
đồng tiền	钱币
Vội vàng	冲
Tiếng Do Thái	希伯来
Thư giãn	缷
Tai nạn	墜毀
công nghiệp hóa	工业化
Làm lại	翻拍
Người hầu	侍中
Chúng tôi là	們為
béo phì	肥胖
bùng nổ	轰
Kazakhstan	哈薩克
Nanyu	南语
Hãy cẩn thận	眘
Hệ thống hoạt hình	動畫製
Pewter	鑞
Bryan	布萊恩
bộ lọc	滤
cánh tay	軍火
Trước một	進一
Ami	阿美族
rẻ tiền	廉
Có nghĩa	意即
Ký tên	征
bạo kích	臨界
Lớp và	類與
quan tâm	在乎
Rộng nhất	最廣
mục tiêu	客观
Tụng kinh	念佛
Hoảng sợ	撃
lớn lên	成長
Hạt Xing	兴县
vòng ngọc	玔
Bức vẽ	画作
Sâu	蟝
hạn chót	限期
cuộc hội thoại	談話
Ne	讷
Liền kề với	毗鄰與
Chức vụ	位置
trái thạch lựu	榴
phản đối	抗议
Xe hơi mới	新車
Hoàng hôn	滽
tuyệt vọng	絕望
Người tin	信眾
Bọ cánh cứng	蝳
lý do	理性
Pu	濮
Yi	葴
làm vườn	園藝
Ngoại vi	疊紀
Síp	塞浦
Cũng cho	也為
hơi nước	蒸
Xiangfu	祥符
Ban làm việc	工委
Trấn Giang	镇江
Luo	骆
Háu ăn	飤
mặc dù	尽管
Muộn	晚期
Bộ trưởng bộ tài chính	财政部长
Xoáy	漩
Turpan	吐鲁番
Giữ thời gian	舉時
tấn	聲調
dơ bẩn	髒
Châu Úc	澳大利亚
Vượt ra ngoài	超出
Bayu	鮁
Yu	狫
Nai	奈
Bin Laden	拉登
Li	砬
rừng ngập mặn	紅樹林
Trong hàng	行中
Jian	臿
Đông Á	东亚
Huasheng	华盛
Háu ăn	鮆
màn	幕
Chuyển tới	遷往
Li	萞
Chen	郴
Đăng nhập	登陆
Chậm lại	減緩
Vài	這幾
Sun Jian	孫堅
Điểm	點數
ngồi xổm	跱
giết chết	杀
Tira	地拉
Nanshan	南山
Nicholas	尼古拉
Thị trưởng	区长
Mọi điều	萬物
Làm việc trong	職於
Ngoại trưởng	国务卿
cùn	钝
Mông	臀部
Guofeng	國風
Thời gian là	時間為
Giải thưởng hàng nghìn ngôi sao	萬千星輝頒獎
chính trị	政見
Đẩy	攆
trong	之內
Được phân loại là	归为
Tang Zhongzong	唐中宗
Bài hát	淃
Vera	維拉
nguyên chất	纯
Buick	別克
Công ty	該公司
Yu	騪
Bị hạ bệ	废黜
phát lại	重播
Vĩnh Phong	永丰
Công việc quan trọng	要職
Kushiro	钏
Qi	颪
Touyuya	頭魚亞
Hàng chục	數十
hạt giống	種子
Ủy ban quản lý	管委会
mùa thu	鞦
Triển khai thực hiện	實行
Bahai	巴哈伊
Gusta	古斯塔
Ngốc nghếch	螀
Qua eo biển	兩岸
Quỹ	出資
Bộ phận an ninh	安全部
Các nước láng giềng	邻国
Người chơi	選手
Mờ	锍
nằm xuống	躺
Nhân Viên	职工
Xấu hổ	悆
Quận chịu trách nhiệm	區負責
mẫu vật	样品
tàu ngầm	潛艇
cung Song Ngư	双鱼座
Cỏ cói	薹草
Hoàng hậu	后妃
tóm lược	概要
Tàn tật	殘
Cấu trúc gỗ	木结构
Li	儷
Shen Ke	申科
Di chuyển về phía nam	南遷
Trong	身處
cá nhân	人身
Giữa khuya	中后期
Chăn nuôi gia súc	畜牧業
Mặc	穿著
nổi bật	显赫
Anthracen	蒽
đấu sĩ	戰鬥機
người Trung Quốc	华裔
hài lòng	惬
cụm từ	短语
hiện hành	本届
Ander	安得
Sự đóng góp	投稿
Đúng	昰
Kiểm tra	检
hoopoe	鵀
Lịch sử học	学史
Dọn phòng	家政
bờ biển	滨
Viện kiểm sát	检察院
tuần tra	巡逻
Zhao	棹
đá mài	硎
Tấn công chính	主攻
cầu vồng	虹
Jian'an	建安
bia	啤酒
Tro	阿史
Java	爪哇
Khu dân cư	居民区
nhìn chằm chằm	盯
không khí	风气
Đường phía đông	東路
Đông Nam Á	東南亞
hồi ký	自傳
Hube	戶部
máy vi tính	计算机
Cuộc sống hàng ngày	日常生活
khoáng sản	礦產
đóng cửa	閼
Chất oxy hóa	氧化剂
Võ karate	空手道
Chữ ký	签字
tre non	筤
Thấp	低落
cắt	剐
Yer	耶尔
Nhạc phim	配樂
tay	手
Thành lập tại	創立於
Tuyệt quá	莫大
sư tử	猊
Đá lăn	滾石
Xie	訚
chỉ	刚刚
mây	籐
Ping	蓱
quả vải	荔枝
nước Đức	德区
Không	无
Hạt Chang	昌县
Lạc Dương	洛阳
bốn mươi bảy	四十七
Phù hợp	合式
Xi	澫
Pháo	機砲
lực lượng độc ác	祲
Chào	欗
Giờ quốc gia	國時
Còn nợ	拖欠
Đề cập	涵蓋
phương trình	方程式
Xinh đẹp	綺
Tây Thổ Nhĩ Kỳ	西突厥
lẫn nhau	彼此
thật	的确
Thân trên	上身
đau	伤害
theo	跟隨
Gân	觔
ống sáo	笛
cung cấp	供應
vết loét	疡
chai	瓶
Xe điện	電車
không đồng bộ	异步
cuộc nói chuyện	会谈
kiều mạch	荞
bên	边
Mọi người sống	人居住
Âm	饹
Lisbon	里斯本
Mộ	之墓
Thúc giục	催促
tự nhiên	自然
Xuân	禌
Hàn Quốc	麗
Sẽ có nhiều hơn	會較
Gọi nó đi	稱其
Kính thiên văn	遠鏡
nếm thử	啖
gõ cửa	磕
lừa đảo	作弊
Trường học	校校
Coi như	視為
Cắt thành	切成
cổ phần	樴
chất lượng	品质
chuông	鈴
Shu	蜀
Lá trên	上半叶
Sẽ	意愿
Đã ở	已於
Chip	晶片
Tiếng ồn lớn	大噪
Ôm	偨
đùi	大腿
Sự cố	依斯
phía Nam Trung Quốc	华南
Toàn tỉnh	全省
Đội Trung Quốc	中国队
Sola	索拉
Dinh thự	公馆
Changping	昌平
sóc bay	鸓
giao tiếp	通讯
Phạm vi đầy đủ	全方位
Bản văn	文字
Mở	开放式
Mẹ đẻ	生母
quỹ	基金
Xấu hổ	懁
Mongoose	捴
Video điện	電視頻
Boudoir	閨
Lực lượng tăng cường	援軍
Nâng cao	進會
mưa nặng hạt	霪
tiếng Nhật	日本人
quá	過於
Học sinh trung học	高中生
chuyển khoản	换乘
toàn cầu	全球
vi-rút	病毒
Thành phố nổi tiếng	名城
không phải	並非
ô	傘
Vận chuyển hàng hóa	貨運
Một vài ngày	幾天
Mảnh khảnh	細長
thông thường	常規
sâu	深處
người hầu	仆
hoang tàn	惘
người chinh phục	征服者
đốt lửa	爟
Đánh giá cuối cùng	終審
đối đầu	對抗
Đóng	阖
bướng bỉnh	倔
tỉ lệ	比
giao cấu	姤
Duyên dáng	嫿
natri	鈉
Dài hơn	长于
chim đa đa	鷓
Vượt qua	十字
lò lửa	炉
Sáp	臘
Kiêu ngạo	詧
con nhện	蛛
Viết	撰
Đau khổ	饱受
cua	螃蟹
Bầu cử tổng thống	總統選
Cổ sinh vật học	古生物
bệnh tiêu chảy	泻
nổi bật	出色
Paul	保羅
nghiện	瘾
Bởi	者
vẫn	猶
Nak	纳克
Riga	里加
Một chiêc nhân	一環
Tiếp tục	接續
Thêm vào	增添
Quang học	光學
Trở về	歸來
Rinpo	仁波
Định cư	聚居地
Đợt này	這批
Rút lui	退
Khùng	疯狂
hàng	線
bóng bàn	乒乓球
sự hợp tác	合伙
Ở giữa	之中
đơn giản	簡
Jing	璥
tạo nên	创造
Hải đảo	西沙群岛
Đôi chân	英呎
Ming	溚
Numan	努曼
Freud	弗洛伊德
Xô	沎
Ngọt ngào	甜味
Chi nhánh	分館
Trong cuộc hẹn	在約
Ge	媜
Trung Quốc cổ điển	文言文
Quân đội của người dân	人民军
Sawa	沢
Dân làng	鄉民
Erman	爾曼
tinh tế	细腻
bệnh dịch	疫情
Xương bánh chè	髕
Một lát sau	後來發
viên con nhộng	蒴
luồng không khí	气流
Pittsburgh	匹兹堡
nước Hà Lan	荷蘭
Xiangyang	襄陽
Kiểm soát nước	治水
Yi	侸
đổ nát	僨
Và nắm bắt	並奪
Ling	廋
đại học Quốc gia	國大
văn chương	文獻
Ghi bàn	打進
Baoyu	宝玉
Nhỏ nhất	最小
Chứa đựng	內含
Phát sinh	導數
đóng	親密
Than van	峑
Cả ngày dài	整天
Bất hòa	不和
khách hàng	消费者
Raman	拉曼
chũm chọe	铙
Bắn ra	射出
Dạy	授意
Shi	奭
Tòa nhà	主场
chì	帶領
Giống	有如
nghiệp dư	業餘
chống đỡ	搘
Sông Keelung	基隆河
Sói trung quốc	枸
Foss	福斯
Thắng hay thua	胜负
Ling	凅
Đồng nghiệp	同仁
este	酯
thành viên	員
Trung Quốc	华中
Rút ra	划出
xoáy	涡
Yi	橿
thiết lập	設定
Ke	柯
Thùng đựng hàng	集装
kiểm tra	阻击
chỉ có	隻
Zhu	瀦
Thực hành	踐
Thân cây	干线
Sổ tay	筆記型
Mani	馬尼
Chi bộ	党支部
Thiên đường	天國
cấp độ	平
đố kỵ	羨
khai thác	萃取
Độ cao thấp	低空
Shko	什科
Bảo hành	保障
Kobayashi	小林
Punk	龐克
điện lực	電力
Đảo	之島
Ao	潭
Yi	佥
Maeda	前田
Hun	烌
vỏ bọc	鞘
con lươn	鳗
súng lục	銃
bào ngư	鲍
phản bội	背叛
Vòng tròn văn hóa	文化圈
Mã	典
Cửa ve	票口
Trong nước và nước ngoài	国内外
Chân núi	山腳
Thủ môn	守門
Âm	褹
nóng bức	烫
mua sắm	购物
Đại học Kyoto	京大学
Xấu hổ	臸
Ling	廪
Gạo nếp	餄
Phụ kiện	配件
Mazu	媽祖
Vinh quang	光耀
Yu	虪
suy đồi	頽
Tỉnh Thiểm Tây	陕西省
rạng rỡ	泂
Thời gian này	此次
xinh đẹp	美丽
kim loại	金屬
ủ	醞
Dài	長
Đất đai	陸路
Chủ tịch	理事長
Háu ăn	龥
Lên lịch	賽程
Khó xử	聦
Bạn cùng lớp	班人
giống cái	雌
Góc tây bắc	西北角
Tỉnh tự trị	自治省
nhà vua	王
Vắt kiệt	慤
Zuolin	作霖
Ye	吪
Dajia	大甲
Bồn rửa	擊沉
Fukuoka	福岡
Vì điều gì đó	因事
Moji	莫吉
Chiến thuật	诀
bọc lại	裹
Shan	鞔
Xóa luồng	清溪
Zhe	軹
tham nhũng	贪污
Năng suất	產量
Nấu nướng	饪
con quay	筳
chiến binh	勇士
Chúng tôi nghĩ	們認為
Sở hữu	附身
Nhiều	多個
Sau đó với	則與
Khu Tây Tạng	藏区
con bò cạp	蚰
Chai	飗
Nhà ga hành khách	客运站
chì	鉛
Ren	赑
Nhà máy	出廠
Wai	厗
Tản nhiệt	散熱
đầu mũi tên	鏃
công thức	公式
máy vi tính	電腦
Chưa	尚未
Vượt qua biển cả	渡海
Ngừng phục vụ	停运
Dubai	杜拜
Nghèo	欠佳
hoang vu	荒野
Bị bệnh	染病
nếu	倘
Tongtian	通天
Đảo ngôi sao	星島
Rio	里约热内
Con dơi	頞
Purin	普林
Con đẻ	子嗣
Chiến thắng quyết định	決勝
bay	镘
Xuân	県
Quyên góp	捐獻
ngay	馬上
Vội vàng	沖
Tinh thần đoàn kết	聲援
Ẩn dụ	喻
Gần bờ	近岸
mô hình	典範
chuyến đi khứ hồi	往返
thiện xạ	神射手
Nhiệt độ phòng	室温
Cho tóc	為發
Oichi	尾市
Caribe	加勒比
một	一間
Ẩm	濕潤
Một	一体
dơ bẩn	脏
Được sinh ra	生有
Bài hát	淞
Cá cho	魚為
đỉnh cao	顶峰
cải cách	维新
mục lục	指数
Linhai	臨海
không đúng	不当
đồn trú	驻防
toàn bộ	共计
Bất lực	無力
Cá cược	博彩
Cày cấy	垦
bôi nhọ	蔑
Độ hòa tan	溶性
Pháp luật	律令
hiện tượng	現象
mưa	霅
Dài	茇
Hơn	较
Tất cả	全体
Trường quân sự	军校
Đại lộ	大道
Đã đánh giá	評為
Ming	暺
Sau cuộc bầu cử	選後
Khoa Khoa học Chính trị	政治系
Af	阿夫
mang tính lịch sử	历史性
Chạy	鰗
sẽ không	不會
Tòa án	阁
Datang	大唐
giám sát	监控
nhân chứng	證人
Phía trước	前方
Quốc gia	屆全國
Phỏng vấn	访谈
Thung lũng Hạnh Phúc	跑馬地
Lo	擔憂
lớp	一層
Biển	大海
Đức hạnh	美德
Người cải cách	改革派
trung thành	藎
Kei	畮
Anh giáo	聖公會
cử tri	選民
Rút ra	抽出
Nigeria	奈及利亞
Redding	雷丁
Vitamin	維生素
Sau khi hoàn thành	畢後
Trở về	外還
Ôn tập	檢討
Đông cứng	冻结
có nghĩa	意為
Cũng để	也讓
cuộc tổng tuyển cử	普选
Dạy	指使
nhiều	多
Stei	施泰
Bộ phận này	本系
Jia	嘉
Thân hình	車身
Chong	蜑
Điều kiện	條款
tất cả	所有
Có nhẫn	與環
nói dối	诳
Chiba	千葉
trầm tích	滓
Sinh và tử	生卒
câm	瘖
vần	韵
bờ biển	沙滩
xấp xỉ	約
số dặm	里程
Sự nghi ngờ	猜忌
huyền thoại	傳奇
Đặt hàng	下令
Cho đi	泄露
Nộp thuế	納稅
hoa hồi	八角
cười	悝
Băng nhóm	戢
Không có khả năng	無法
Sự đông lại	混凝
Tạo nên	开创
Được gọi là	則稱為
Rider	車手
Gặp gỡ	開會
Hét lên	嘨
đập	堨
con khỉ	猴子
Knots	节度
mộ	窀
Họ	姓氏
Thiết lập một thành phố	設市
Âm	垠
Vượt qua	及格
Surly	敘利
Quận Hải	海县
Giữ	抱著
nội địa	内陆
quần áo	衣服
Hảo	昊
Rất nhiều	不少
phía đông	伊士
Đại hội thể thao châu Á	亞運
tham số	参数
hoa cúc	菊
toàn cầu hóa	国际化
environs	坰
Giấy	纸张
Tình dục	性戀
Daquan	大全
tin đồn	传闻
Một số	數名
Zhang Zhuan	張專
Những năm đầu của Trung Hoa Dân Quốc	民国初年
Buồng trứng	卵巢
TV phát sóng	電視廣播
xưởng đóng tàu	船厂
phát triển	進展
vượt qua	交叉
giật mình	噩
Urn	籙
Máy quốc tế	際機